Downsample[ns],BuildFilTree[ns],SearchFil[ns],DeleteFil[ns],BuildTreeSub[ns],SearchSub[ns],DeleteSub[ns],PreProcTotal[ns],Plane[ns],Total[ns],nx,ny,nz,planeCount
5536,0,0,0,0,1051,275,6862,1760,8622,-0.0229969,0.0363345,-0.999075,0
5350,0,0,0,0,974,265,6589,3715,10304,0.0181987,0.0040433,-0.999826,0
5526,0,0,0,0,1128,254,6908,3593,10501,0.0195292,0.00106446,-0.999809,0
5287,0,0,0,0,925,239,6451,3568,10019,0.021272,0.000981576,-0.999773,0
5095,0,0,0,0,1006,241,6342,3605,9947,0.022001,0.000947015,-0.999757,0
5275,0,0,0,0,922,236,6433,4037,10470,0.0223698,-0.000284396,-0.99975,0
5192,0,0,0,0,1011,269,6472,3711,10183,0.0217552,-0.000254458,-0.999763,0
5169,0,0,0,0,956,241,6366,3725,10091,0.0227144,0.0023674,-0.999739,0
5440,0,0,0,0,905,248,6593,3673,10266,0.021647,0.000713339,-0.999766,0
5237,0,0,0,0,971,290,6498,3757,10255,0.0221454,0.00879804,-0.999716,0
3716,0,0,0,0,666,175,4557,2643,7200,0.02018,0.0104663,-0.999742,0
5335,0,0,0,0,1004,239,6578,3677,10255,0.0200329,0.00771998,-0.999769,0
5291,0,0,0,0,961,259,6511,3791,10302,0.0209455,0.00894528,-0.99974,0
5322,0,0,0,0,897,235,6454,3639,10093,0.0177641,0.0112562,-0.999779,0
6131,0,0,0,0,964,314,7409,3565,10974,0.0205059,0.0112682,-0.999726,0
5187,0,0,0,0,906,233,6326,3585,9911,0.0189602,0.0117863,-0.999751,0
5803,0,0,0,0,1181,277,7261,3886,11147,0.0156764,0.00934047,-0.999834,0
3666,0,0,0,0,655,190,4511,2581,7092,0.0209909,0.0121348,-0.999706,0
5425,0,0,0,0,1116,254,6795,3792,10587,0.0198413,0.0109228,-0.999743,0
5436,0,0,0,0,987,240,6663,3682,10345,0.0209895,0.0113428,-0.999715,0
4314,0,0,0,0,631,172,5117,2006,7123,0.0202677,0.0103928,-0.999741,0
1885,0,0,0,0,331,88,2304,1286,3590,0.021657,0.00848806,-0.99973,0
3429,0,0,0,0,588,176,4193,2402,6595,0.0202811,0.00885125,-0.999755,0
5225,0,0,0,0,916,257,6398,4250,10648,0.0192739,0.00939764,-0.99977,0
5433,0,0,0,0,913,249,6595,3598,10193,0.021096,0.009098,-0.999736,0
4389,0,0,0,0,638,174,5201,2479,7680,0.020031,0.00926277,-0.999757,0
5286,0,0,0,0,1011,248,6545,3566,10111,0.0218721,0.00967713,-0.999714,0
4297,0,0,0,0,659,185,5141,2353,7494,0.0208667,0.010758,-0.999725,0
2789,0,0,0,0,525,138,3452,1963,5415,0.0206989,0.00888291,-0.999746,0
3912,0,0,0,0,735,203,4850,2815,7665,0.0221529,0.00661815,-0.999733,0
5285,0,0,0,0,971,271,6527,4244,10771,0.0195,0.00862641,-0.999773,0
5360,0,0,0,0,940,235,6535,3578,10113,0.0205411,0.00965084,-0.999742,0
5507,0,0,0,0,1316,303,7126,3766,10892,0.0201466,0.0104166,-0.999743,0
5528,0,0,0,0,883,186,6597,2891,9488,0.0206295,0.0106481,-0.99973,0
2316,0,0,0,0,421,114,2851,1586,4437,0.0199011,0.0110597,-0.999741,0
4891,0,0,0,0,859,207,5957,2799,8756,0.0223105,0.00959102,-0.999705,0
5276,0,0,0,0,939,235,6450,3595,10045,0.01994,0.00966055,-0.999754,0
5315,0,0,0,0,891,232,6438,3599,10037,0.0184581,0.0129942,-0.999745,0
5857,0,0,0,0,699,185,6741,2520,9261,0.0192703,0.0112118,-0.999751,0
2521,0,0,0,0,416,113,3050,1542,4592,0.0201234,0.0102774,-0.999745,0
5719,0,0,0,0,905,267,6891,3733,10624,0.0189792,0.0111565,-0.999758,0
3867,0,0,0,0,640,160,4667,2174,6841,0.0195722,0.00939892,-0.999764,0
2249,0,0,0,0,386,110,2745,1568,4313,0.0196027,0.0112404,-0.999745,0
5261,0,0,0,0,892,234,6387,3723,10110,0.0185243,0.0105258,-0.999773,0
5263,0,0,0,0,936,268,6467,3611,10078,0.0182786,0.0106876,-0.999776,0
5277,0,0,0,0,935,271,6483,3593,10076,0.0202369,0.0109086,-0.999736,0
5442,0,0,0,0,933,270,6645,3638,10283,0.018288,0.00908722,-0.999791,0
5215,0,0,0,0,888,244,6347,3813,10160,0.0189177,0.00911862,-0.999779,0
5295,0,0,0,0,897,271,6463,3647,10110,0.0190465,0.012083,-0.999746,0
5282,0,0,0,0,896,281,6459,3731,10190,0.019883,0.0103359,-0.999749,0
5269,0,0,0,0,988,261,6518,3633,10151,0.0193474,0.0124165,-0.999736,0
5264,0,0,0,0,954,233,6451,3803,10254,0.0211626,0.00977645,-0.999728,0
5728,0,0,0,0,952,247,6927,3631,10558,0.018975,0.0129284,-0.999736,0
5422,0,0,0,0,922,287,6631,3740,10371,0.0188646,0.0110912,-0.999761,0
5317,0,0,0,0,997,284,6598,3756,10354,0.0188324,0.0110713,-0.999761,0
5607,0,0,0,0,903,318,6828,3776,10604,0.0191693,0.00962492,-0.99977,0
2748,0,0,0,0,477,121,3346,1929,5275,0.0189906,0.0113168,-0.999756,0
5574,0,0,0,0,991,235,6800,3770,10570,0.0197171,0.0103547,-0.999752,0
3968,0,0,0,0,661,162,4791,2656,7447,0.0205253,0.00994689,-0.99974,0
5324,0,0,0,0,967,265,6556,4270,10826,0.0195314,0.00965775,-0.999763,0
3738,0,0,0,0,656,182,4576,2549,7125,0.0197991,0.00904394,-0.999763,0
3701,0,0,0,0,623,175,4499,2527,7026,0.0180655,0.0102852,-0.999784,0
4823,0,0,0,0,924,238,5985,3358,9343,0.0197132,0.00922587,-0.999763,0
5214,0,0,0,0,872,240,6326,3401,9727,0.0191422,0.0102044,-0.999765,0
4758,0,0,0,0,812,208,5778,2635,8413,0.0180789,0.0107881,-0.999778,0
4248,0,0,0,0,810,190,5248,3089,8337,0.0188995,0.00916539,-0.99978,0
5423,0,0,0,0,944,211,6578,3292,9870,0.0192447,0.0102622,-0.999762,0
5373,0,0,0,0,953,264,6590,3662,10252,0.0192345,0.00997716,-0.999765,0
5583,0,0,0,0,942,302,6827,3753,10580,0.0189126,0.00965127,-0.999775,0
2817,0,0,0,0,478,122,3417,1922,5339,0.0197009,0.00875161,-0.999768,0
5211,0,0,0,0,1008,267,6486,3752,10238,0.0205654,0.0107541,-0.999731,0
5457,0,0,0,0,971,235,6663,3789,10452,0.0194219,0.0085071,-0.999775,0
5717,0,0,0,0,937,237,6891,3515,10406,0.0205396,0.0101286,-0.999738,0
5438,0,0,0,0,901,240,6579,3662,10241,0.0193413,0.010116,-0.999762,0
5320,0,0,0,0,1013,292,6625,3762,10387,0.0178428,0.00869287,-0.999803,0
3621,0,0,0,0,635,182,4438,2567,7005,0.0182572,0.00983066,-0.999785,0
4899,0,0,0,0,889,260,6048,3277,9325,0.0164152,0.0102041,-0.999813,0
4913,0,0,0,0,977,273,6163,3619,9782,0.0186966,0.00990738,-0.999776,0
5474,0,0,0,0,975,264,6713,3665,10378,0.018172,0.00973771,-0.999787,0
3609,0,0,0,0,657,193,4459,2781,7240,0.019398,0.00984608,-0.999763,0
5389,0,0,0,0,904,249,6542,3595,10137,0.0189838,0.00803843,-0.999787,0
5346,0,0,0,0,930,261,6537,3773,10310,0.0185656,0.00653534,-0.999806,0
5383,0,0,0,0,948,250,6581,3641,10222,0.0173513,0.00722712,-0.999823,0
5191,0,0,0,0,1108,257,6556,3627,10183,0.0211553,0.00509895,-0.999763,0
5612,0,0,0,0,1010,240,6862,3614,10476,0.0175312,0.0071255,-0.999821,0
5405,0,0,0,0,965,237,6607,3576,10183,0.0213414,0.00423903,-0.999763,0
5645,0,0,0,0,1000,268,6913,3653,10566,0.0203,0.00503583,-0.999781,0
4738,0,0,0,0,834,211,5783,3239,9022,0.019625,0.00468021,-0.999797,0
5110,0,0,0,0,859,222,6191,3083,9274,0.019663,0.00629863,-0.999787,0
5053,0,0,0,0,836,226,6115,3138,9253,0.0203422,0.00714485,-0.999768,0
5366,0,0,0,0,880,243,6489,3510,9999,0.0205171,0.00550534,-0.999775,0
5354,0,0,0,0,893,244,6491,3764,10255,0.0195004,0.00421954,-0.999801,0
5557,0,0,0,0,890,243,6690,3089,9779,0.0195185,0.00440007,-0.9998,0
3583,0,0,0,0,643,167,4393,2516,6909,0.0203249,0.00368292,-0.999787,0
5544,0,0,0,0,1031,261,6836,3556,10392,0.0202333,0.00432077,-0.999786,0
5263,0,0,0,0,934,248,6445,3610,10055,0.0206425,0.00349789,-0.999781,0
2745,0,0,0,0,391,97,3233,1469,4702,0.0205423,0.00182825,-0.999787,0
3612,0,0,0,0,609,166,4387,2479,6866,0.0202137,0.00377988,-0.999788,0
5092,0,0,0,0,787,217,6096,3247,9343,0.0214488,0.00375136,-0.999763,0
5209,0,0,0,0,890,242,6341,3454,9795,0.0213111,0.00254579,-0.99977,0
4674,0,0,0,0,774,199,5647,3229,8876,0.0216736,0.00142373,-0.999764,0
5403,0,0,0,0,893,256,6552,3545,10097,0.0223868,0.000924832,-0.999749,0
5330,0,0,0,0,1139,319,6788,3587,10375,0.023783,0.000654698,-0.999717,0
4833,0,0,0,0,722,187,5742,3046,8788,0.0207263,0.00320631,-0.99978,0
5234,0,0,0,0,1119,309,6662,3713,10375,0.0241739,-0.000478981,-0.999708,0
5320,0,0,0,0,788,260,6368,4059,10427,0.0222251,-0.00317785,-0.999748,0
5729,0,0,0,0,854,200,6783,3406,10189,0.0208028,0.000732493,-0.999783,0
5453,0,0,0,0,1003,252,6708,3225,9933,0.023724,0.00486703,-0.999707,0
3323,0,0,0,0,645,149,4117,2173,6290,0.0240041,0.00768839,-0.999682,0
3551,0,0,0,0,484,142,4177,2260,6437,0.0237171,0.0183122,-0.999551,0
4624,0,0,0,0,605,157,5386,3141,8527,0.0259024,0.0337207,-0.999095,0
4380,0,0,0,0,604,157,5141,3326,8467,0.0284144,0.0490832,-0.99839,0
6093,0,0,0,0,806,196,7095,308,7403,0.0177987,0.100062,-0.994822,0
5351,0,0,0,0,729,182,6262,699,6961,0.0201221,0.0854163,-0.996142,0
5775,0,0,0,0,768,184,6727,652,7379,0.0240876,0.0788742,-0.996594,0
5757,0,0,0,0,746,181,6684,534,7218,0.0247855,0.0979371,-0.994884,0
5752,0,0,0,0,793,177,6722,721,7443,0.0229207,0.11292,-0.99334,0
5597,0,0,0,0,600,172,6369,695,7064,0.0448018,0.100625,-0.993915,0
5823,0,0,0,0,680,186,6689,719,7408,0.0612048,0.118357,-0.991083,0
4875,0,0,0,0,579,168,5622,769,6391,0.0711712,0.114702,-0.990847,0
5415,0,0,0,0,610,169,6194,945,7139,0.0715574,0.114956,-0.99079,0
5408,0,0,0,0,572,160,6140,1033,7173,0.0669088,0.111243,-0.991538,0
5750,0,0,0,0,529,142,6421,1117,7538,0.0640556,0.126129,-0.989944,0
5349,0,0,0,0,709,173,6231,1222,7453,0.05457,0.128609,-0.990193,0
5284,0,0,0,0,507,129,5920,1014,6934,0.0515736,0.128458,-0.990373,0
5281,0,0,0,0,567,142,5990,1266,7256,0.0606263,0.118062,-0.991154,0
4755,0,0,0,0,575,137,5467,1400,6867,0.0642858,0.135729,-0.988658,0
4540,0,0,0,0,593,141,5274,1352,6626,0.0627187,0.133975,-0.988998,0
4496,0,0,0,0,510,168,5174,1399,6573,0.0595382,0.14932,-0.986995,0
4878,0,0,0,0,507,149,5534,1545,7079,0.0389561,0.186447,-0.981693,0
4231,0,0,0,0,446,131,4808,1667,6475,0.0246509,0.223962,-0.974286,0
4627,0,0,0,0,479,164,5270,1911,7181,0.0235754,0.223814,-0.974347,0
4765,0,0,0,0,509,137,5411,1997,7408,0.0188177,0.200278,-0.979558,0
4603,0,0,0,0,415,125,5143,2440,7583,0.0194792,0.178656,-0.983719,0
4579,0,0,0,0,386,109,5074,2329,7403,0.0245116,0.144744,-0.989165,0
6878,0,0,0,0,568,147,7593,2786,10379,0.0316451,0.134033,-0.990471,0
4662,0,0,0,0,443,117,5222,2856,8078,0.0359233,0.13312,-0.990449,0
4094,0,0,0,0,328,93,4515,2592,7107,0.0405455,0.130537,-0.990614,0
4088,0,0,0,0,358,89,4535,2595,7130,0.0423936,0.141424,-0.989041,0
4480,0,0,0,0,357,104,4941,2991,7932,0.0469618,0.14499,-0.988318,0
4331,0,0,0,0,393,108,4832,2864,7696,0.0421162,0.133266,-0.990185,0
4476,0,0,0,0,445,113,5034,2910,7944,0.0346627,0.130813,-0.990801,0
4674,0,0,0,0,512,124,5310,2788,8098,0.0094489,0.155311,-0.987821,0
4697,0,0,0,0,573,140,5410,2492,7902,0.00299791,0.156776,-0.987629,0
5002,0,0,0,0,572,156,5730,2348,8078,-0.000155894,0.182006,-0.983297,0
4874,0,0,0,0,751,211,5836,2244,8080,0.0134177,0.176192,-0.984264,0
4535,0,0,0,0,925,204,5664,1965,7629,0.0316676,0.182786,-0.982643,0
4448,0,0,0,0,732,188,5368,2056,7424,0.0410008,0.165925,-0.985286,0
5582,0,0,0,0,972,232,6786,2416,9202,0.0301719,0.177259,-0.983702,0
5452,0,0,0,0,1032,270,6754,2600,9354,0.0321964,0.154334,-0.987494,0
5096,0,0,0,0,1114,294,6504,2955,9459,0.0462379,0.146441,-0.988138,0
5325,0,0,0,0,1280,316,6921,3796,10717,0.0549328,0.14029,-0.988585,0
5792,0,0,0,0,1348,346,7486,4313,11799,0.0514214,0.162355,-0.985392,0
5802,0,0,0,0,1665,374,7841,4983,12824,0.0367306,0.225269,-0.973604,0
5406,0,0,0,0,1043,249,6698,3193,9891,0.0267455,0.17187,-0.984757,0
2529,0,0,0,0,530,127,3186,2286,5472,0.0302433,0.119899,-0.992325,0
6244,0,0,0,0,1500,386,8130,7353,15483,0.0218559,0.140351,-0.989861,0
6513,0,0,0,0,1463,344,8320,5932,14252,0.0110732,0.15911,-0.987199,0
6348,0,0,0,0,1431,369,8148,7094,15242,-0.00492987,0.250426,-0.968124,0
3319,0,0,0,0,720,180,4219,3154,7373,0.00318247,0.193815,-0.981033,0
2086,0,0,0,0,429,111,2626,2243,4869,0.0102285,0.132797,-0.991091,0
6294,0,0,0,0,1309,339,7942,6017,13959,-0.0028652,0.160471,-0.987036,0
3135,0,0,0,0,615,163,3913,4267,8180,-0.0101434,0.13424,-0.990897,0
6521,0,0,0,0,1167,301,7989,7998,15987,-0.0167327,0.206664,-0.978269,0
4128,0,0,0,0,626,153,4907,3769,8676,-0.0221855,0.174494,-0.984408,0
2190,0,0,0,0,546,114,2850,2358,5208,-0.0130067,0.116055,-0.993157,0
1550,0,0,0,0,275,68,1893,1533,3426,-0.0156926,0.105195,-0.994328,0
4190,0,0,0,0,754,187,5131,3873,9004,-0.0219175,0.133909,-0.990751,0
5575,0,0,0,0,1018,248,6841,4556,11397,-0.0223066,0.147567,-0.988801,0
5556,0,0,0,0,976,312,6844,4197,11041,-0.0131518,0.130397,-0.991375,0
5573,0,0,0,0,1430,356,7359,4647,12006,0.000118131,0.143981,-0.98958,0
3876,0,0,0,0,625,168,4669,2446,7115,-0.00297287,0.118395,-0.992962,0
3460,0,0,0,0,630,184,4274,2395,6669,-0.00646132,0.10335,-0.994624,0
4574,0,0,0,0,909,235,5718,3193,8911,-0.0178294,0.0969856,-0.995126,0
4792,0,0,0,0,811,236,5839,3455,9294,-0.0248274,0.0970151,-0.994973,0
6874,0,0,0,0,1100,324,8298,3209,11507,-0.0273545,0.108271,-0.993745,0
7233,0,0,0,0,1128,274,8635,2984,11619,-0.0183538,0.11203,-0.993535,0
2336,0,0,0,0,414,99,2849,1430,4279,-0.012876,0.113438,-0.993462,0
4437,0,0,0,0,774,202,5413,2586,7999,0.00514652,0.167842,-0.9858,0
4457,0,0,0,0,809,236,5502,2141,7643,0.00844084,0.196836,-0.9804,0
4822,0,0,0,0,808,211,5841,2000,7841,-0.000657358,0.237909,-0.971288,0
4525,0,0,0,0,964,276,5765,1618,7383,-0.0209824,0.289936,-0.956816,0
4777,0,0,0,0,831,228,5836,1384,7220,-0.0221681,0.309229,-0.950729,0
4733,0,0,0,0,936,260,5929,1354,7283,-0.0138253,0.311894,-0.950016,0
4931,0,0,0,0,997,249,6177,1078,7255,-0.0109902,0.277503,-0.960662,0
4908,0,0,0,0,1114,244,6266,937,7203,-0.00780698,0.225624,-0.974183,0
5062,0,0,0,0,945,243,6250,722,6972,-0.00435742,0.183087,-0.983087,0
4980,0,0,0,0,989,243,6212,409,6621,-0.00585113,0.167203,-0.985905,0
4959,0,0,0,0,1351,266,6576,418,6994,-0.0100873,0.192426,-0.98126,0
5090,0,0,0,0,1235,249,6574,491,7065,-0.00393124,0.218398,-0.975852,0
5330,0,0,0,0,984,246,6560,438,6998,0.00426804,0.216115,-0.976359,0
4635,0,0,0,0,901,280,5816,467,6283,0.000551046,0.201546,-0.979479,0
5076,0,0,0,0,1022,259,6357,1563,7920,-0.0256755,0.165258,-0.985916,0
5111,0,0,0,0,1001,285,6397,1150,7547,-0.0399417,0.181273,-0.982622,0
5150,0,0,0,0,1191,302,6643,1135,7778,-0.0542239,0.173214,-0.98339,0
5710,0,0,0,0,1228,280,7218,1127,8345,-0.0426556,0.182124,-0.98235,0
5304,0,0,0,0,935,281,6520,1081,7601,-0.0225248,0.172361,-0.984777,0
4562,0,0,0,0,821,216,5599,1104,6703,-0.0156843,0.160122,-0.986973,0
5287,0,0,0,0,911,232,6430,295,6725,0.212154,0.433378,-0.875885,0
4886,0,0,0,0,806,200,5892,548,6440,0.158899,0.21665,-0.963231,0
4866,0,0,0,0,797,218,5881,594,6475,0.113215,0.261356,-0.95858,0
4885,0,0,0,0,657,205,5747,632,6379,0.0238826,0.257633,-0.965947,0
5102,0,0,0,0,733,188,6023,1155,7178,-0.0151629,0.251271,-0.967798,0
4488,0,0,0,0,663,183,5334,1734,7068,-0.0472724,0.273954,-0.96058,0
4465,0,0,0,0,725,201,5391,1438,6829,-0.0618704,0.257068,-0.964411,0
5199,0,0,0,0,839,228,6266,919,7185,-0.0908508,0.27161,-0.95811,0
5934,0,0,0,0,960,242,7136,845,7981,-0.0800109,0.215481,-0.973225,0
5108,0,0,0,0,915,227,6250,652,6902,-0.0553097,0.182536,-0.981642,0
5145,0,0,0,0,1066,261,6472,616,7088,-0.0383557,0.204508,-0.978113,0
5086,0,0,0,0,849,215,6150,651,6801,-0.0320544,0.167776,-0.985304,0
5044,0,0,0,0,858,197,6099,632,6731,-0.0263694,0.133351,-0.990718,0
4963,0,0,0,0,656,177,5796,822,6618,-0.0300129,0.0934974,-0.995167,0
5159,0,0,0,0,569,154,5882,1230,7112,-0.0163199,0.0991733,-0.994936,0
4782,0,0,0,0,910,211,5903,1005,6908,-0.017122,0.088782,-0.995904,0
4747,0,0,0,0,727,207,5681,1411,7092,0.0115641,0.156311,-0.98764,0
4721,0,0,0,0,497,139,5357,766,6123,0.0262076,0.155845,-0.987434,0
3297,0,0,0,0,430,111,3838,998,4836,0.0390634,0.182658,-0.9824,0
4902,0,0,0,0,786,173,5861,1781,7642,0.050292,0.171741,-0.983858,0
4792,0,0,0,0,506,137,5435,1591,7026,0.0448619,0.178761,-0.982869,0
4917,0,0,0,0,463,136,5516,1824,7340,0.0324158,0.210759,-0.977,0
4608,0,0,0,0,494,134,5236,2224,7460,0.01637,0.210677,-0.977419,0
4743,0,0,0,0,486,127,5356,2607,7963,0.0170121,0.186502,-0.982307,0
5059,0,0,0,0,473,126,5658,2813,8471,0.0220345,0.167603,-0.985608,0
4925,0,0,0,0,445,121,5491,2732,8223,0.0281578,0.160648,-0.98661,0
4714,0,0,0,0,423,108,5245,2843,8088,0.0311566,0.164512,-0.985883,0
4853,0,0,0,0,389,132,5374,2549,7923,0.0304632,0.154714,-0.98749,0
4582,0,0,0,0,440,120,5142,2483,7625,0.025998,0.143065,-0.989372,0
4411,0,0,0,0,456,135,5002,2746,7748,0.0340254,0.136297,-0.990084,0
4746,0,0,0,0,522,129,5397,2292,7689,0.0440306,0.151354,-0.987499,0
4818,0,0,0,0,516,141,5475,2273,7748,0.0457622,0.15286,-0.987188,0
4887,0,0,0,0,617,154,5658,2289,7947,0.0403107,0.152274,-0.987516,0
5026,0,0,0,0,633,166,5825,2302,8127,-0.01933,0.244093,-0.969559,0
5168,0,0,0,0,742,193,6103,2185,8288,-0.00794655,0.182881,-0.983103,0
3507,0,0,0,0,582,150,4239,1670,5909,-0.00110882,0.136469,-0.990644,0
5126,0,0,0,0,919,230,6275,2442,8717,-0.03211,0.174035,-0.984216,0
5162,0,0,0,0,1094,282,6538,2170,8708,-0.0465422,0.192317,-0.980228,0
5550,0,0,0,0,1217,314,7081,1870,8951,-0.0140783,0.166416,-0.985955,0
5915,0,0,0,0,1354,350,7619,2028,9647,0.0212818,0.171314,-0.984987,0
6294,0,0,0,0,1422,335,8051,2253,10304,0.0239509,0.172751,-0.984675,0
5814,0,0,0,0,1265,332,7411,3237,10648,0.016364,0.165982,-0.985993,0
5782,0,0,0,0,1282,316,7380,3987,11367,-0.000148309,0.155401,-0.987852,0
5725,0,0,0,0,1217,323,7265,4453,11718,-0.0207824,0.143774,-0.989392,0
5434,0,0,0,0,1012,216,6662,3573,10235,-0.0270752,0.128888,-0.99129,0
3036,0,0,0,0,677,158,3871,2989,6860,-0.0176319,0.0889531,-0.99588,0
5204,0,0,0,0,1030,262,6496,6255,12751,-0.0212774,0.103488,-0.994403,0
5263,0,0,0,0,1200,300,6763,6396,13159,-0.0208878,0.108509,-0.993876,0
3540,0,0,0,0,607,151,4298,4079,8377,-0.012937,0.121628,-0.992492,0
4895,0,0,0,0,1257,262,6414,5273,11687,-0.0118567,0.140202,-0.990052,0
5048,0,0,0,0,1242,279,6569,4742,11311,-0.00946037,0.142164,-0.989798,0
5048,0,0,0,0,936,221,6205,4508,10713,-0.0188451,0.131704,-0.99111,0
6632,0,0,0,0,1073,261,7966,4929,12895,-0.0130945,0.132614,-0.991081,0
3956,0,0,0,0,725,181,4862,3202,8064,-0.015324,0.115966,-0.993135,0
6027,0,0,0,0,1072,264,7363,4378,11741,-0.0142235,0.13464,-0.990793,0
5905,0,0,0,0,1013,272,7190,4077,11267,0.00522146,0.223303,-0.974735,0
3765,0,0,0,0,534,147,4446,2018,6464,0.000880822,0.177868,-0.984054,0
2223,0,0,0,0,413,115,2751,1475,4226,-0.00189646,0.145078,-0.989419,0
5081,0,0,0,0,991,292,6364,3797,10161,0.0121267,0.21951,-0.975535,0
4922,0,0,0,0,1280,347,6549,3162,9711,0.00392719,0.257415,-0.966293,0
4844,0,0,0,0,1039,272,6155,2615,8770,-0.00632961,0.28545,-0.958373,0
4918,0,0,0,0,1007,279,6204,2184,8388,-0.00925475,0.308597,-0.951148,0
5024,0,0,0,0,1030,280,6334,1932,8266,-0.0155456,0.364375,-0.931122,0
5002,0,0,0,0,1029,282,6313,1605,7918,-0.0210024,0.345527,-0.938174,0
5005,0,0,0,0,887,249,6141,1197,7338,-0.0172613,0.368541,-0.929451,0
5010,0,0,0,0,978,239,6227,1093,7320,-0.00971605,0.385448,-0.922679,0
5134,0,0,0,0,1073,283,6490,1467,7957,0.0145953,0.339252,-0.940583,0
5088,0,0,0,0,1085,266,6439,1733,8172,0.0313568,0.288923,-0.956839,0
4523,0,0,0,0,950,222,5695,1655,7350,0.0359996,0.257257,-0.965672,0
5152,0,0,0,0,1001,264,6417,1717,8134,0.0264948,0.406989,-0.913049,0
4718,0,0,0,0,875,208,5801,1642,7443,0.00887799,0.356365,-0.934305,0
4690,0,0,0,0,875,234,5799,1645,7444,-0.00823403,0.289232,-0.957224,0
4241,0,0,0,0,819,183,5243,631,5874,-0.0480482,0.337984,-0.939924,0
5175,0,0,0,0,868,211,6254,896,7150,-0.0637421,0.336521,-0.939516,0
5133,0,0,0,0,834,201,6168,852,7020,-0.0507083,0.316705,-0.947168,0
5020,0,0,0,0,752,186,5958,741,6699,-0.0145678,0.295658,-0.955183,0
5544,0,0,0,0,656,190,6390,524,6914,0.0286934,0.251791,-0.967356,0
2206,0,0,0,0,232,51,2489,-1000,-1000,-1,-1,-1,0
1310,0,0,0,0,160,45,1515,325,1840,0.00882231,0.179887,-0.983648,0
1096,0,0,0,0,139,33,1268,177,1445,0.00291904,0.144279,-0.989533,0
4800,0,0,0,0,523,163,5486,1233,6719,0.00798697,0.184966,-0.982712,0
5229,0,0,0,0,523,139,5891,1590,7481,0.0230015,0.221483,-0.974893,0
4497,0,0,0,0,432,114,5043,1864,6907,0.025637,0.213492,-0.976609,0
4299,0,0,0,0,392,104,4795,2157,6952,0.0237798,0.197888,-0.979936,0
4264,0,0,0,0,436,109,4809,2358,7167,0.0200758,0.189309,-0.981712,0
4291,0,0,0,0,404,112,4807,2631,7438,0.0160942,0.174102,-0.984596,0
4815,0,0,0,0,474,125,5414,2868,8282,0.0170821,0.159084,-0.987117,0
4845,0,0,0,0,504,136,5485,2886,8371,0.0211667,0.160129,-0.986869,0
4860,0,0,0,0,575,155,5590,2844,8434,0.0311154,0.161652,-0.986357,0
4884,0,0,0,0,601,168,5653,2637,8290,0.037648,0.155914,-0.987053,0
4965,0,0,0,0,625,178,5768,2529,8297,0.035604,0.143903,-0.988951,0
5056,0,0,0,0,705,178,5939,2227,8166,0.03213,0.152933,-0.987714,0
5597,0,0,0,0,777,224,6598,2196,8794,0.0248938,0.149813,-0.988401,0
5257,0,0,0,0,776,205,6238,2445,8683,0.00552331,0.167888,-0.98579,0
5778,0,0,0,0,872,253,6903,2329,9232,0.00175184,0.145481,-0.989359,0
4658,0,0,0,0,805,230,5693,2516,8209,0.00734376,0.142579,-0.989756,0
5155,0,0,0,0,860,254,6269,2447,8716,0.0167965,0.12793,-0.991641,0
5004,0,0,0,0,958,330,6292,2970,9262,0.0489126,0.180181,-0.982417,0
2668,0,0,0,0,543,144,3355,1346,4701,0.0751623,0.147867,-0.986147,0
2836,0,0,0,0,594,156,3586,1550,5136,0.0666187,0.0985549,-0.992899,0
5576,0,0,0,0,1145,302,7023,2199,9222,0.0862011,0.14283,-0.985987,0
5492,0,0,0,0,1219,304,7015,2841,9856,0.0531423,0.17038,-0.983944,0
5462,0,0,0,0,1162,291,6915,2914,9829,0.0262242,0.18225,-0.982903,0
5439,0,0,0,0,1031,278,6748,3503,10251,0.00632972,0.153998,-0.988051,0
5116,0,0,0,0,900,257,6273,4381,10654,-0.00847303,0.125483,-0.992059,0
5599,0,0,0,0,947,263,6809,5370,12179,-0.00747241,0.0924485,-0.995689,0
4914,0,0,0,0,790,197,5901,4652,10553,-0.00272455,0.0573943,-0.998348,0
5071,0,0,0,0,815,231,6117,4694,10811,0.00321681,0.0422403,-0.999102,0
5000,0,0,0,0,866,244,6110,4435,10545,0.00306456,0.0442482,-0.999016,0
5069,0,0,0,0,900,200,6169,4447,10616,-0.00894881,0.0392378,-0.99919,0
5638,0,0,0,0,926,278,6842,4603,11445,-0.0141287,0.0423308,-0.999004,0
5500,0,0,0,0,889,225,6614,4482,11096,-0.0201662,0.0908532,-0.99566,0
3767,0,0,0,0,470,118,4355,2557,6912,-0.0142604,0.0723904,-0.997275,0
2328,0,0,0,0,383,97,2808,1716,4524,-0.0148581,0.0525412,-0.998508,0
5111,0,0,0,0,836,217,6164,3510,9674,-0.0081987,0.0679633,-0.997654,0
5477,0,0,0,0,953,251,6681,3793,10474,-0.00922466,0.0624565,-0.998005,0
5476,0,0,0,0,914,234,6624,3632,10256,-0.00759848,0.0712395,-0.99743,0
5431,0,0,0,0,938,234,6603,3350,9953,-0.00287448,0.0796465,-0.996819,0
6442,0,0,0,0,925,241,7608,3226,10834,-0.0104737,0.0795922,-0.996773,0
5173,0,0,0,0,970,244,6387,3247,9634,-0.00936662,0.188277,-0.982071,0
5035,0,0,0,0,997,284,6316,2794,9110,-0.00714566,0.178167,-0.983974,0
2661,0,0,0,0,507,129,3297,1343,4640,-0.0106559,0.113049,-0.993532,0
2476,0,0,0,0,502,122,3100,1507,4607,-0.0116351,0.111808,-0.993662,0
5124,0,0,0,0,1041,270,6435,2573,9008,-0.00416645,0.184704,-0.982786,0
4947,0,0,0,0,936,238,6121,2579,8700,0.00422048,0.332505,-0.943092,0
4954,0,0,0,0,967,233,6154,2135,8289,0.00908325,0.33169,-0.943345,0
3597,0,0,0,0,628,166,4391,1382,5773,0.00675846,0.285166,-0.958454,0
2566,0,0,0,0,467,126,3159,922,4081,0.00391265,0.258051,-0.966124,0
4920,0,0,0,0,884,242,6046,1761,7807,0.00245801,0.265454,-0.964121,0
4823,0,0,0,0,858,222,5903,1567,7470,0.0237288,0.261897,-0.964804,0
4889,0,0,0,0,864,234,5987,1438,7425,0.0348926,0.271458,-0.961818,0
4419,0,0,0,0,796,213,5428,1537,6965,0.0319777,0.261675,-0.964626,0
4592,0,0,0,0,905,210,5707,1543,7250,0.0371183,0.255085,-0.966206,0
4660,0,0,0,0,845,214,5719,2184,7903,0.0464799,0.2184,-0.974752,0
4516,0,0,0,0,789,228,5533,2347,7880,0.030731,0.17965,-0.983251,0
4508,0,0,0,0,870,197,5575,2107,7682,0.0125488,0.162205,-0.986677,0
4638,0,0,0,0,1175,278,6091,2487,8578,-0.00664111,0.165401,-0.986204,0
4651,0,0,0,0,787,201,5639,2274,7913,-0.0168094,0.173105,-0.98476,0
5122,0,0,0,0,1118,250,6490,3387,9877,0.0056532,0.170619,-0.985321,0
5215,0,0,0,0,964,248,6427,3058,9485,0.0330272,0.164531,-0.985819,0
5082,0,0,0,0,1001,249,6332,2939,9271,0.043363,0.149365,-0.987831,0
4833,0,0,0,0,903,214,5950,2134,8084,0.0399443,0.137202,-0.989737,0
4627,0,0,0,0,843,209,5679,1617,7296,0.0391387,0.128366,-0.990954,0
5397,0,0,0,0,1090,265,6752,1662,8414,0.0370822,0.123316,-0.991674,0
5333,0,0,0,0,959,280,6572,1393,7965,0.0431638,0.116701,-0.992229,0
5156,0,0,0,0,951,236,6343,1091,7434,0.0525221,0.108019,-0.992761,0
4749,0,0,0,0,829,207,5785,716,6501,0.0564785,0.107403,-0.99261,0
5129,0,0,0,0,976,239,6344,756,7100,0.0546583,0.117291,-0.991592,0
4522,0,0,0,0,836,209,5567,1084,6651,0.0559379,0.124256,-0.990672,0
5119,0,0,0,0,1008,239,6366,1525,7891,0.0553037,0.121282,-0.991076,0
5210,0,0,0,0,1225,256,6691,1611,8302,0.0620717,0.121627,-0.990633,0
4721,0,0,0,0,832,202,5755,1341,7096,0.0602415,0.121085,-0.990812,0
4737,0,0,0,0,831,201,5769,1612,7381,0.0499638,0.12126,-0.991363,0
5264,0,0,0,0,985,262,6511,1570,8081,0.0529855,0.124934,-0.990749,0
5314,0,0,0,0,978,269,6561,1715,8276,0.0522424,0.118663,-0.991559,0
5023,0,0,0,0,861,229,6113,1862,7975,0.0577488,0.110067,-0.992245,0
5212,0,0,0,0,909,245,6366,1515,7881,0.0562781,0.101842,-0.993207,0
5286,0,0,0,0,896,236,6418,1205,7623,0.051065,0.0852665,-0.995049,0
5551,0,0,0,0,902,247,6700,401,7101,0.0422264,0.063552,-0.997085,0
5273,0,0,0,0,940,265,6478,4868,11346,0.0193861,-0.00657144,-0.999791,0
5221,0,0,0,0,877,219,6317,5126,11443,0.0218618,-0.00196911,-0.999759,0
5077,0,0,0,0,900,231,6208,5330,11538,0.0253965,0.0092028,-0.999635,0
4961,0,0,0,0,927,271,6159,5528,11687,0.0307239,0.0235856,-0.99925,0
5056,0,0,0,0,845,217,6118,4911,11029,0.0363582,0.0223139,-0.99909,0
5646,0,0,0,0,979,257,6882,5286,12168,0.036788,0.0243654,-0.999026,0
5300,0,0,0,0,904,226,6430,5033,11463,0.03534,0.0235902,-0.999097,0
3305,0,0,0,0,586,156,4047,3365,7412,0.0356645,0.0149817,-0.999252,0
4245,0,0,0,0,699,183,5127,4067,9194,0.0320755,0.0127659,-0.999404,0
5188,0,0,0,0,850,257,6295,5228,11523,0.031259,0.00937876,-0.999467,0
5147,0,0,0,0,1265,330,6742,5549,12291,0.0333942,0.0131033,-0.999357,0
4650,0,0,0,0,699,194,5543,4335,9878,0.0322438,0.0112871,-0.999416,0
5360,0,0,0,0,772,202,6334,4749,11083,0.031342,0.0123439,-0.999433,0
4733,0,0,0,0,773,198,5704,4539,10243,0.0315104,0.0113535,-0.999439,0
4701,0,0,0,0,794,203,5698,4693,10391,0.0313079,0.0121597,-0.999436,0
4900,0,0,0,0,774,200,5874,3915,9789,0.0308839,0.0104286,-0.999469,0
2548,0,0,0,0,465,132,3145,2554,5699,0.0365364,0.012522,-0.999254,0
4754,0,0,0,0,864,266,5884,4954,10838,0.0341024,0.0141449,-0.999318,0
5816,0,0,0,0,913,218,6947,3949,10896,0.0281062,0.0227225,-0.999347,0
2656,0,0,0,0,360,93,3109,2122,5231,0.0295745,0.0122176,-0.999488,0
1788,0,0,0,0,336,90,2214,1775,3989,0.031413,0.0152217,-0.999391,0
5170,0,0,0,0,1044,253,6467,4994,11461,0.032706,0.0112702,-0.999402,0
4706,0,0,0,0,798,239,5743,4409,10152,0.0328999,0.0112853,-0.999395,0
5289,0,0,0,0,1000,262,6551,4725,11276,0.0296139,0.0104381,-0.999507,0
3515,0,0,0,0,610,172,4297,3900,8197,0.0303732,0.00909378,-0.999497,0
4603,0,0,0,0,801,248,5652,4517,10169,0.0287745,0.0106269,-0.99953,0
4537,0,0,0,0,802,235,5574,4511,10085,0.0332249,0.0134487,-0.999358,0
4846,0,0,0,0,799,225,5870,4398,10268,0.0300757,0.0136038,-0.999455,0
4632,0,0,0,0,822,232,5686,4288,9974,0.0367635,0.0188053,-0.999147,0
5283,0,0,0,0,851,218,6352,4931,11283,0.0342799,0.0174788,-0.99926,0
5623,0,0,0,0,870,257,6750,4992,11742,0.0364864,0.0165382,-0.999197,0
4161,0,0,0,0,747,206,5114,4103,9217,0.0336325,0.0144119,-0.99933,0
4578,0,0,0,0,827,198,5603,4373,9976,0.0329434,0.017111,-0.999311,0
5398,0,0,0,0,824,232,6454,4327,10781,0.0343,0.0165704,-0.999274,0
4574,0,0,0,0,773,199,5546,4224,9770,0.0371572,0.0187463,-0.999134,0
5095,0,0,0,0,937,222,6254,4812,11066,0.0372363,0.0194775,-0.999117,0
4886,0,0,0,0,813,198,5897,4328,10225,0.0370966,0.0171854,-0.999164,0
5443,0,0,0,0,814,243,6500,4432,10932,0.0337839,0.0195536,-0.999237,0
4549,0,0,0,0,813,212,5574,4192,9766,0.0361621,0.0179884,-0.999184,0
5433,0,0,0,0,853,200,6486,4292,10778,0.0350245,0.0172116,-0.999238,0
5277,0,0,0,0,889,250,6416,5265,11681,0.0336828,0.0186365,-0.999259,0
5365,0,0,0,0,800,202,6367,4337,10704,0.0336027,0.0171514,-0.999288,0
4661,0,0,0,0,850,256,5767,4783,10550,0.0339214,0.0194262,-0.999235,0
4718,0,0,0,0,811,250,5779,4367,10146,0.0327797,0.0192277,-0.999277,0
4414,0,0,0,0,944,211,5569,3836,9405,0.0337922,0.0192805,-0.999243,0
4608,0,0,0,0,791,227,5626,4238,9864,0.0348937,0.0165717,-0.999254,0
4997,0,0,0,0,886,222,6105,4818,10923,0.034806,0.018419,-0.999225,0
3751,0,0,0,0,652,179,4582,2712,7294,0.03372,0.0165591,-0.999294,0
2165,0,0,0,0,386,107,2658,2046,4704,0.0337285,0.0176337,-0.999276,0
4562,0,0,0,0,873,256,5691,4193,9884,0.0350222,0.020844,-0.999169,0
5106,0,0,0,0,891,249,6246,4677,10923,0.0336413,0.0198246,-0.999237,0
4707,0,0,0,0,791,234,5732,4084,9816,0.0358527,0.0161109,-0.999227,0
4541,0,0,0,0,801,198,5540,4346,9886,0.0336947,0.0134246,-0.999342,0
4741,0,0,0,0,774,225,5740,4462,10202,0.0321729,0.0124192,-0.999405,0
4659,0,0,0,0,781,228,5668,4542,10210,0.0318942,0.0153997,-0.999372,0
3295,0,0,0,0,597,161,4053,3161,7214,0.0321892,0.0144984,-0.999377,0
4750,0,0,0,0,884,269,5903,5504,11407,0.0322985,0.015872,-0.999352,0
5142,0,0,0,0,946,282,6370,4874,11244,0.0320468,0.0142284,-0.999385,0
5135,0,0,0,0,933,264,6332,4757,11089,0.0311069,0.0175104,-0.999362,0
3442,0,0,0,0,613,176,4231,3670,7901,0.0320746,0.0180196,-0.999323,0
4535,0,0,0,0,795,243,5573,4498,10071,0.032088,0.0153295,-0.999367,0
4586,0,0,0,0,776,213,5575,4428,10003,0.0321696,0.0162093,-0.999351,0
5177,0,0,0,0,974,223,6374,5044,11418,0.0315979,0.0160501,-0.999372,0
5300,0,0,0,0,852,234,6386,5072,11458,0.0298449,0.0146584,-0.999447,0
3510,0,0,0,0,595,195,4300,3388,7688,0.0317878,0.0117532,-0.999426,0
6241,0,0,0,0,887,236,7364,4960,12324,0.0350239,0.014466,-0.999282,0
5022,0,0,0,0,874,232,6128,4966,11094,0.036176,0.0154507,-0.999226,0
5180,0,0,0,0,855,244,6279,4991,11270,0.0346759,0.0152058,-0.999283,0
5096,0,0,0,0,916,269,6281,5137,11418,0.0340467,0.0114285,-0.999355,0
3566,0,0,0,0,603,174,4343,3439,7782,0.0328153,0.0136456,-0.999368,0
5815,0,0,0,0,867,253,6935,4929,11864,0.0349154,0.0160399,-0.999262,0
4751,0,0,0,0,590,150,5491,3284,8775,0.0325971,0.0131763,-0.999382,0
2649,0,0,0,0,453,121,3223,2587,5810,0.0330873,0.012854,-0.99937,0
4543,0,0,0,0,807,222,5572,4892,10464,0.0325949,0.0119842,-0.999397,0
5036,0,0,0,0,859,220,6115,4839,10954,0.0314561,0.00998506,-0.999455,0
4859,0,0,0,0,810,219,5888,4543,10431,0.0302983,0.00998458,-0.999491,0
5349,0,0,0,0,857,219,6425,3884,10309,0.0308545,0.0123065,-0.999448,0
2638,0,0,0,0,456,115,3209,2626,5835,0.0330551,0.0158733,-0.999327,0
4597,0,0,0,0,782,195,5574,4246,9820,0.0322893,0.0156136,-0.999357,0
6073,0,0,0,0,804,229,7106,4312,11418,0.0336668,0.0189293,-0.999254,0
4573,0,0,0,0,823,198,5594,4326,9920,0.0331916,0.0182579,-0.999282,0
4810,0,0,0,0,808,242,5860,4468,10328,0.0337154,0.0169963,-0.999287,0
4658,0,0,0,0,826,227,5711,4350,10061,0.0311415,0.0144695,-0.99941,0
4651,0,0,0,0,910,225,5786,4441,10227,0.0313177,0.0161373,-0.999379,0
5492,0,0,0,0,1195,262,6949,4505,11454,0.031018,0.0158337,-0.999393,0
5157,0,0,0,0,771,214,6142,3824,9966,0.0303998,0.0157099,-0.999415,0
3277,0,0,0,0,568,175,4020,4022,8042,0.0305948,0.0154297,-0.999413,0
4048,0,0,0,0,799,190,5037,3934,8971,0.0294152,0.0154014,-0.999449,0
5279,0,0,0,0,850,218,6347,4778,11125,0.0303077,0.0132057,-0.999454,0
4928,0,0,0,0,880,237,6045,4788,10833,0.0302674,0.0144246,-0.999437,0
4824,0,0,0,0,769,211,5804,4486,10290,0.0311731,0.0139673,-0.999416,0
3329,0,0,0,0,559,162,4050,3078,7128,0.0301684,0.0146919,-0.999437,0
5319,0,0,0,0,855,234,6408,4773,11181,0.0287221,0.0139317,-0.99949,0
5512,0,0,0,0,872,187,6571,3362,9933,0.032721,0.0137643,-0.99937,0
5123,0,0,0,0,867,234,6224,3708,9932,0.033197,0.0133423,-0.99936,0
3904,0,0,0,0,588,161,4653,3439,8092,0.0327187,0.010898,-0.999405,0
5216,0,0,0,0,850,258,6324,4409,10733,0.0325668,0.0134685,-0.999379,1
5183,0,0,0,0,858,239,6280,4779,11059,0.0313206,0.0163811,-0.999375,1
5097,0,0,0,0,873,220,6190,4795,10985,0.0325345,0.0149323,-0.999359,1
5215,0,0,0,0,925,259,6399,5183,11582,0.0292798,0.0147528,-0.999463,1
5067,0,0,0,0,874,236,6177,4912,11089,0.0303108,0.0128567,-0.999458,1
5006,0,0,0,0,1083,249,6338,4895,11233,0.0297924,0.0126883,-0.999476,1
5398,0,0,0,0,858,276,6532,5036,11568,0.0308405,0.0129184,-0.999441,1
5010,0,0,0,0,846,219,6075,4741,10816,0.0296943,0.0149497,-0.999447,1
4801,0,0,0,0,810,207,5818,4140,9958,0.0321736,0.014691,-0.999374,1
4744,0,0,0,0,763,209,5716,4257,9973,0.0292026,0.0168084,-0.999432,1
5267,0,0,0,0,945,232,6444,4649,11093,0.0291994,0.0160203,-0.999445,1
4622,0,0,0,0,765,206,5593,4287,9880,0.0310911,0.0149296,-0.999405,1
4507,0,0,0,0,798,209,5514,4253,9767,0.032255,0.0157444,-0.999356,1
4522,0,0,0,0,766,200,5488,4278,9766,0.0329597,0.00931711,-0.999413,1
4715,0,0,0,0,808,227,5750,4354,10104,0.0314301,0.00990493,-0.999457,1
4786,0,0,0,0,810,233,5829,4364,10193,0.031727,0.00930698,-0.999453,1
4825,0,0,0,0,765,207,5797,4304,10101,0.031241,0.00804369,-0.999479,1
5367,0,0,0,0,867,235,6469,4946,11415,0.030705,0.00910466,-0.999487,1
5205,0,0,0,0,1134,260,6599,4003,10602,0.0301005,0.00904997,-0.999506,1
4165,0,0,0,0,696,219,5080,4013,9093,0.031253,0.00684443,-0.999488,1
4572,0,0,0,0,767,198,5537,5008,10545,0.0308592,0.00805359,-0.999491,1
4783,0,0,0,0,830,202,5815,4327,10142,0.0321419,0.00703752,-0.999459,1
5365,0,0,0,0,769,208,6342,4028,10370,0.0325683,0.0024065,-0.999467,1
3318,0,0,0,0,578,149,4045,3133,7178,0.0338961,0.00343804,-0.999419,1
4870,0,0,0,0,811,251,5932,4378,10310,0.0330187,0.00377313,-0.999448,1
4721,0,0,0,0,850,285,5856,5524,11380,0.032216,0.00442718,-0.999471,1
3351,0,0,0,0,545,161,4057,3189,7246,0.0302516,0.00150061,-0.999541,1
6284,0,0,0,0,986,262,7532,4685,12217,0.0327179,0.00463475,-0.999454,1
4692,0,0,0,0,849,228,5769,4406,10175,0.0313158,0.00383565,-0.999502,1
4754,0,0,0,0,858,255,5867,4233,10100,0.0327403,0.00478268,-0.999453,1
3310,0,0,0,0,598,142,4050,3132,7182,0.0310823,0.0025648,-0.999514,1
4693,0,0,0,0,841,239,5773,4467,10240,0.0313867,0.00442469,-0.999498,1
5900,0,0,0,0,987,223,7110,5103,12213,0.0294335,0.00444967,-0.999557,1
5298,0,0,0,0,911,221,6430,4590,11020,0.0305942,0.00256081,-0.999529,1
3616,0,0,0,0,627,152,4395,3573,7968,0.0341255,0.00178241,-0.999416,1
5202,0,0,0,0,864,202,6268,4637,10905,0.0286479,0.00147572,-0.999588,1
4673,0,0,0,0,793,198,5664,4466,10130,0.0309082,0.00320127,-0.999517,1
4645,0,0,0,0,773,199,5617,4334,9951,0.0311614,0.00243794,-0.999512,1
4768,0,0,0,0,854,199,5821,4436,10257,0.0292909,0.00389277,-0.999563,1
4716,0,0,0,0,798,224,5738,4514,10252,0.027235,0.00071597,-0.999629,1
4660,0,0,0,0,1140,251,6051,4641,10692,0.0273145,-0.00174214,-0.999626,1
6021,0,0,0,0,850,228,7099,4836,11935,0.0298728,0.000658303,-0.999553,1
5254,0,0,0,0,939,249,6442,4356,10798,0.03262,0.0043088,-0.999458,1
5150,0,0,0,0,838,212,6200,4268,10468,0.0329726,0.00762451,-0.999427,1
3333,0,0,0,0,543,159,4035,3213,7248,0.0292047,0.00270171,-0.99957,1
4269,0,0,0,0,705,201,5175,4296,9471,0.0304758,0.000202019,-0.999535,1
4320,0,0,0,0,730,205,5255,4846,10101,0.0303247,-0.000909387,-0.99954,1
4118,0,0,0,0,650,187,4955,3803,8758,0.0317152,-0.000766347,-0.999497,1
3754,0,0,0,0,634,162,4550,3589,8139,0.0292727,0.00204962,-0.999569,1
5095,0,0,0,0,891,271,6257,4758,11015,0.0286238,0.0059582,-0.999573,1
4518,0,0,0,0,796,240,5554,4630,10184,0.02705,0.00784115,-0.999603,1
5185,0,0,0,0,887,243,6315,5811,12126,0.0331672,0.00897327,-0.99941,1
5068,0,0,0,0,853,234,6155,4897,11052,0.0339716,0.00499532,-0.99941,1
4867,0,0,0,0,802,201,5870,3782,9652,0.0310107,0.00501178,-0.999507,1
4567,0,0,0,0,867,243,5677,4597,10274,0.0323493,-0.00370581,-0.99947,1
5204,0,0,0,0,907,265,6376,4812,11188,0.0285929,-0.00270169,-0.999587,1
5077,0,0,0,0,1053,279,6409,5343,11752,0.0257141,0.00323993,-0.999664,1
5224,0,0,0,0,988,210,6422,3458,9880,0.0264837,0.00709258,-0.999624,1
5130,0,0,0,0,914,230,6274,4966,11240,0.0311963,0.0100732,-0.999462,1
4722,0,0,0,0,1086,226,6034,4491,10525,0.0362797,0.0132284,-0.999254,1
4728,0,0,0,0,849,244,5821,4319,10140,0.0334609,0.0100554,-0.99939,1
4742,0,0,0,0,871,248,5861,4618,10479,0.0338907,0.00673473,-0.999403,1
4681,0,0,0,0,865,209,5755,4113,9868,0.0302644,0.0112546,-0.999479,1
2065,0,0,0,0,410,108,2583,1981,4564,0.0294166,0.0149,-0.999456,1
5164,0,0,0,0,912,211,6287,4391,10678,0.0308393,0.0143146,-0.999422,1
5073,0,0,0,0,963,235,6271,5115,11386,0.0332855,0.0163398,-0.999313,1
5456,0,0,0,0,925,236,6617,5112,11729,0.0335801,0.031625,-0.998935,1
5425,0,0,0,0,1012,274,6711,4907,11618,0.0370726,0.0474871,-0.998184,1
5640,0,0,0,0,1027,276,6943,4758,11701,0.0372021,0.0571744,-0.997671,1
5196,0,0,0,0,1068,312,6576,5292,11868,0.0419993,0.0773886,-0.996116,1
4865,0,0,0,0,964,263,6092,333,6425,0.0601929,0.130898,-0.989567,1
5980,0,0,0,0,1083,287,7350,2642,9992,0.0584454,0.201578,-0.977727,1
5435,0,0,0,0,1079,318,6832,2106,8938,0.064714,0.195679,-0.97853,1
3876,0,0,0,0,849,197,4922,1061,5983,0.0611717,0.174907,-0.982683,1
4810,0,0,0,0,860,223,5893,1223,7116,0.0556986,0.174408,-0.983097,1
5394,0,0,0,0,982,272,6648,1285,7933,0.0383701,0.160567,-0.986279,1
5150,0,0,0,0,994,244,6388,1425,7813,0.0358428,0.120877,-0.99202,1
5619,0,0,0,0,1027,283,6929,1447,8376,0.0472528,0.0959746,-0.994262,1
7087,0,0,0,0,1049,245,8381,1600,9981,0.0507009,0.0806281,-0.995454,1
4983,0,0,0,0,920,217,6120,1472,7592,0.0502923,0.0659897,-0.996552,1
5032,0,0,0,0,890,216,6138,1584,7722,0.0390347,0.0752061,-0.996404,1
4660,0,0,0,0,886,215,5761,1583,7344,0.0323548,0.0696172,-0.997049,1
5498,0,0,0,0,919,252,6669,1948,8617,0.0260931,0.0776806,-0.996637,1
5177,0,0,0,0,674,183,6034,1492,7526,0.0347255,0.0743898,-0.996624,1
4714,0,0,0,0,902,243,5859,2530,8389,0.0353354,0.107631,-0.993563,1
4581,0,0,0,0,815,217,5613,2506,8119,0.042723,0.0950302,-0.994557,1
5146,0,0,0,0,874,235,6255,2940,9195,0.0464347,0.140778,-0.988952,1
5480,0,0,0,0,833,222,6535,2862,9397,0.0442047,0.126482,-0.990984,1
5299,0,0,0,0,722,181,6202,2937,9139,0.0464269,0.115121,-0.992266,1
5388,0,0,0,0,664,171,6223,3167,9390,0.0466476,0.13035,-0.99037,1
6072,0,0,0,0,613,192,6877,3191,10068,0.0439586,0.127047,-0.990922,1
5152,0,0,0,0,628,192,5972,3320,9292,0.0396445,0.112341,-0.992879,1
5208,0,0,0,0,850,189,6247,3491,9738,0.0412121,0.139974,-0.989297,1
4706,0,0,0,0,673,186,5565,2663,8228,0.0363106,0.121834,-0.991886,1
4697,0,0,0,0,694,196,5587,2290,7877,0.0284709,0.137851,-0.990044,1
5075,0,0,0,0,738,198,6011,2018,8029,0.0186828,0.123607,-0.992155,1
4633,0,0,0,0,754,181,5568,2225,7793,0.0128666,0.133125,-0.991016,1
4952,0,0,0,0,1032,208,6192,1547,7739,0.0102329,0.148041,-0.988928,1
5171,0,0,0,0,986,288,6445,956,7401,0.0262346,0.153956,-0.98773,1
5612,0,0,0,0,937,269,6818,1081,7899,0.0824854,0.0441914,-0.995612,1
5408,0,0,0,0,995,239,6642,2094,8736,0.0800977,-0.00211036,-0.996785,1
5872,0,0,0,0,869,228,6969,2254,9223,0.0538734,-0.0147511,-0.998439,1
5152,0,0,0,0,924,297,6373,2479,8852,0.0378176,-0.00813154,-0.999252,1
5490,0,0,0,0,967,268,6725,2261,8986,0.054347,0.00777575,-0.998492,1
5251,0,0,0,0,974,256,6481,2027,8508,0.0949032,0.058409,-0.993772,1
5106,0,0,0,0,908,226,6240,1489,7729,0.106278,0.0394526,-0.993554,1
4484,0,0,0,0,672,174,5330,1355,6685,0.0955232,0.0316704,-0.994923,1
4035,0,0,0,0,814,209,5058,1713,6771,0.0937637,0.0335219,-0.99503,1
5346,0,0,0,0,1002,249,6597,2283,8880,0.0797678,0.0557451,-0.995254,1
5286,0,0,0,0,1039,265,6590,1757,8347,0.0956319,0.0626434,-0.993443,1
6057,0,0,0,0,1252,322,7631,2098,9729,0.0828061,0.0621697,-0.994625,1
5535,0,0,0,0,1183,313,7031,2508,9539,0.0578972,0.0651053,-0.996198,1
5900,0,0,0,0,1257,311,7468,3171,10639,0.026717,0.0432589,-0.998707,1
6011,0,0,0,0,1153,288,7452,3531,10983,0.00236468,0.0407239,-0.999168,1
5699,0,0,0,0,1287,436,7422,4828,12250,-0.0175697,0.0266765,-0.99949,1
5170,0,0,0,0,1149,276,6595,3909,10504,-0.0120586,-0.023256,-0.999657,1
5510,0,0,0,0,1184,314,7008,5475,12483,-0.00612764,-0.0209623,-0.999762,1
4496,0,0,0,0,790,215,5501,3957,9458,0.00663271,-0.0821834,-0.996595,1
6423,0,0,0,0,967,236,7626,4765,12391,0.00615669,-0.0962671,-0.995337,1
4691,0,0,0,0,966,225,5882,4178,10060,-0.00618536,-0.0874315,-0.996151,1
6400,0,0,0,0,1053,267,7720,4435,12155,-0.0168383,-0.0715412,-0.997295,1
5291,0,0,0,0,1002,261,6554,4119,10673,-0.0226612,-0.0572727,-0.998101,1
6015,0,0,0,0,1021,247,7283,4001,11284,-0.0293345,-0.028604,-0.99916,1
4310,0,0,0,0,660,172,5142,2055,7197,-0.0333072,-0.0180569,-0.999282,1
2364,0,0,0,0,407,100,2871,1577,4448,-0.0178275,-0.0419076,-0.998962,1
5756,0,0,0,0,938,238,6932,3062,9994,-0.000860596,-0.0117066,-0.999931,1
5068,0,0,0,0,855,214,6137,2722,8859,0.00790589,0.0209879,-0.999749,1
5963,0,0,0,0,959,251,7173,2621,9794,0.0190965,0.0158705,-0.999692,1
4805,0,0,0,0,876,220,5901,2530,8431,0.0146422,0.00589344,-0.999875,1
5576,0,0,0,0,970,233,6779,2401,9180,-0.00923008,-0.00468942,-0.999946,1
4562,0,0,0,0,881,223,5666,2312,7978,-0.0190246,-0.0177057,-0.999662,1
5397,0,0,0,0,1030,258,6685,2619,9304,-0.0234376,-0.0100076,-0.999675,1
4624,0,0,0,0,1231,275,6130,2363,8493,-0.0187142,-0.000196631,-0.999825,1
5383,0,0,0,0,862,220,6465,2147,8612,-0.00791702,-0.00713528,-0.999943,1
5086,0,0,0,0,962,222,6270,2146,8416,-0.00708352,-0.0126313,-0.999895,1
4978,0,0,0,0,949,245,6172,2175,8347,-0.00718294,0.00685052,-0.999951,1
5221,0,0,0,0,916,277,6414,2466,8880,-0.0285177,0.174318,-0.984276,1
4906,0,0,0,0,660,165,5731,1475,7206,-0.021351,0.113475,-0.993312,1
2671,0,0,0,0,501,146,3318,1066,4384,-0.0173696,0.0590227,-0.998106,1
3100,0,0,0,0,634,167,3901,1225,5126,-0.0160985,0.0729618,-0.997205,1
4902,0,0,0,0,1050,300,6252,2054,8306,-0.00564664,0.0881823,-0.996089,1
5046,0,0,0,0,1001,238,6285,1970,8255,0.015968,0.0782811,-0.996804,1
4769,0,0,0,0,1262,302,6333,2130,8463,0.0179981,0.0713696,-0.997288,1
5410,0,0,0,0,1140,272,6822,2646,9468,0.0147927,0.0604915,-0.998059,1
5079,0,0,0,0,1139,271,6489,2756,9245,0.00229509,0.053871,-0.998545,1
5354,0,0,0,0,1110,275,6739,3198,9937,-0.00337771,0.0442973,-0.999013,1
4693,0,0,0,0,1303,349,6345,3248,9593,0.00393988,0.0419722,-0.999111,1
4728,0,0,0,0,1097,253,6078,3442,9520,0.00857709,0.0446753,-0.998965,1
5032,0,0,0,0,1160,258,6450,3907,10357,0.00886735,0.064131,-0.997902,1
4767,0,0,0,0,1083,285,6135,4147,10282,0.00602586,0.0908673,-0.995845,1
5555,0,0,0,0,1188,288,7031,4606,11637,0.00165596,0.113498,-0.993537,1
4997,0,0,0,0,1128,279,6404,4405,10809,-0.0014571,0.109426,-0.993994,1
5453,0,0,0,0,1170,327,6950,4357,11307,0.00813063,0.105774,-0.994357,1
4944,0,0,0,0,1054,256,6254,3687,9941,0.0129827,0.0970605,-0.995194,1
5722,0,0,0,0,1171,281,7174,4176,11350,0.015545,0.101969,-0.994666,1
5719,0,0,0,0,1171,287,7177,4604,11781,0.00270367,0.0935679,-0.995609,1
5590,0,0,0,0,1241,340,7171,3217,10388,0.0048929,0.103583,-0.994609,1
5292,0,0,0,0,1319,311,6922,1778,8700,-0.00921446,0.0499476,-0.998709,1
4832,0,0,0,0,1081,284,6197,1490,7687,-0.00565863,0.0118052,-0.999915,1
5616,0,0,0,0,1159,317,7092,1341,8433,-0.00589002,0.0188488,-0.999805,1
6099,0,0,0,0,1384,358,7841,1519,9360,0.00256401,0.0094274,-0.999952,1
5492,0,0,0,0,898,242,6632,1407,8039,0.00843319,0.0190122,-0.999784,1
5327,0,0,0,0,851,202,6380,1710,8090,0.0100515,0.0366694,-0.999277,1
6720,0,0,0,0,749,195,7664,2053,9717,0.00304448,0.0319702,-0.999484,1
5264,0,0,0,0,626,163,6053,2154,8207,0.0126568,0.0473785,-0.998797,1
6244,0,0,0,0,543,145,6932,2146,9078,0.0239126,0.0324853,-0.999186,1
4425,0,0,0,0,383,107,4915,1790,6705,0.0490062,-0.0441807,-0.997821,1
4875,0,0,0,0,478,107,5460,1894,7354,0.0770408,-0.069964,-0.99457,1
4799,0,0,0,0,405,115,5319,1444,6763,0.0857561,-0.0463304,-0.995239,1
5732,0,0,0,0,445,127,6304,1287,7591,0.0814566,-0.0707227,-0.994165,1
4759,0,0,0,0,446,137,5342,1090,6432,0.0688761,-0.11014,-0.991527,1
5056,0,0,0,0,485,146,5687,1425,7112,0.0427405,-0.102959,-0.993767,1
4644,0,0,0,0,535,145,5324,1425,6749,0.0452608,-0.0840116,-0.995436,1
4797,0,0,0,0,624,176,5597,1500,7097,0.0544094,-0.0699616,-0.996065,1
4741,0,0,0,0,633,181,5555,1441,6996,0.0443357,-0.0700885,-0.996555,1
4795,0,0,0,0,757,196,5748,1561,7309,0.0500791,-0.0329006,-0.998203,1
4884,0,0,0,0,752,228,5864,1634,7498,0.0642223,0.0120821,-0.997862,1
5169,0,0,0,0,814,222,6205,998,7203,0.110823,-0.0223403,-0.993589,1
5188,0,0,0,0,924,336,6448,2939,9387,0.0621972,0.00445219,-0.998054,1
5111,0,0,0,0,918,240,6269,1205,7474,0.0378699,0.0260914,-0.998942,1
5632,0,0,0,0,1063,281,6976,1173,8149,-0.0124775,0.108114,-0.99406,1
5469,0,0,0,0,1337,244,7050,1596,8646,-0.0177743,0.148922,-0.988689,1
5651,0,0,0,0,1066,269,6986,1568,8554,-0.00579415,0.140473,-0.990068,1
5526,0,0,0,0,1068,298,6892,1813,8705,0.00537575,0.14435,-0.989512,1
5389,0,0,0,0,1183,277,6849,1606,8455,-0.00336278,0.205882,-0.978571,1
5880,0,0,0,0,1338,295,7513,1907,9420,-0.00438684,0.178634,-0.983906,1
3624,0,0,0,0,656,158,4438,1264,5702,0.00406118,0.0649888,-0.997878,1
3851,0,0,0,0,773,189,4813,2176,6989,-0.0069068,0.0323024,-0.999454,1
5627,0,0,0,0,1158,279,7064,3884,10948,-0.0123397,0.0494961,-0.998698,1
5506,0,0,0,0,1143,301,6950,4390,11340,-0.0205418,0.0145724,-0.999683,1
3924,0,0,0,0,715,175,4814,3963,8777,-0.0141882,-0.0432958,-0.998962,1
5906,0,0,0,0,1158,304,7368,4876,12244,-0.0201424,-0.0327203,-0.999262,1
5774,0,0,0,0,1243,332,7349,4385,11734,-0.0262881,-0.0383864,-0.998917,1
5688,0,0,0,0,1075,255,7018,3898,10916,-0.0236822,-0.040691,-0.998891,1
5133,0,0,0,0,974,230,6337,3335,9672,-0.0162984,-0.0362771,-0.999209,1
5026,0,0,0,0,1175,297,6498,2808,9306,-0.012034,-0.0532417,-0.998509,1
4950,0,0,0,0,859,215,6024,2563,8587,-0.0121861,-0.0375292,-0.999221,1
6571,0,0,0,0,972,247,7790,2828,10618,0.0115847,0.0152626,-0.999817,1
5457,0,0,0,0,1046,255,6758,2441,9199,0.010637,0.00148364,-0.999943,1
5579,0,0,0,0,1078,256,6913,2350,9263,0.00807588,-0.025612,-0.999639,1
5338,0,0,0,0,1164,349,6851,2152,9003,0.00527657,-0.0285625,-0.999578,1
5804,0,0,0,0,1089,255,7148,2153,9301,-0.0245355,0.065451,-0.997554,1
5602,0,0,0,0,977,306,6885,1562,8447,-0.0375157,0.0456522,-0.998253,1
3587,0,0,0,0,565,152,4304,1066,5370,-0.0321754,-0.0141394,-0.999382,1
2533,0,0,0,0,483,136,3152,913,4065,-0.0348398,-0.0255026,-0.999068,1
5013,0,0,0,0,909,234,6156,1841,7997,-0.044524,-0.00875837,-0.99897,1
4987,0,0,0,0,891,227,6105,1723,7828,-0.0489062,0.0773656,-0.995802,1
5015,0,0,0,0,934,255,6204,1490,7694,-0.0481189,0.0521093,-0.997481,1
3925,0,0,0,0,796,164,4885,1165,6050,-0.0404502,0.00880625,-0.999143,1
3976,0,0,0,0,765,218,4959,1387,6346,-0.0338315,2.76417e-05,-0.999427,1
4981,0,0,0,0,938,269,6188,1589,7777,-0.0209861,0.0122345,-0.999705,1
5053,0,0,0,0,983,276,6312,1382,7694,-0.00584972,0.00688385,-0.999959,1
5239,0,0,0,0,985,278,6502,1320,7822,-0.00621693,0.000267992,-0.999981,1
5083,0,0,0,0,997,282,6362,1298,7660,0.00414911,0.00836072,-0.999956,1
5106,0,0,0,0,945,243,6294,1139,7433,0.00490096,0.0352952,-0.999365,1
5669,0,0,0,0,1076,245,6990,1043,8033,0.00911437,0.0473136,-0.998839,1
5095,0,0,0,0,957,291,6343,805,7148,-0.00729148,0.0256394,-0.999645,1
4785,0,0,0,0,830,237,5852,482,6334,-0.0281072,0.0317438,-0.999101,1
4471,0,0,0,0,815,248,5534,390,5924,-0.0484544,-0.0125462,-0.998747,1
5290,0,0,0,0,919,261,6470,330,6800,-0.079031,0.0579738,-0.995185,1
4980,0,0,0,0,1246,332,6558,803,7361,-0.0375808,-0.0047533,-0.999282,1
5500,0,0,0,0,929,236,6665,673,7338,-0.0205902,-0.00928994,-0.999745,1
5416,0,0,0,0,995,329,6740,1055,7795,-0.0167017,0.00102453,-0.99986,1
5167,0,0,0,0,1028,246,6441,1106,7547,-0.00986555,0.0170763,-0.999806,1
5427,0,0,0,0,1007,288,6722,1305,8027,-0.00472056,0.00990107,-0.99994,1
5308,0,0,0,0,1061,275,6644,1878,8522,-0.0144141,0.0129621,-0.999812,1
5558,0,0,0,0,1072,271,6901,1741,8642,-0.0123931,0.0111216,-0.999862,1
5420,0,0,0,0,1131,287,6838,902,7740,-0.0182218,0.0360729,-0.999183,1
5359,0,0,0,0,1065,265,6689,660,7349,-0.0239965,0.0701716,-0.997247,1
6335,0,0,0,0,959,248,7542,778,8320,-0.0296996,0.0910998,-0.995399,1
5035,0,0,0,0,917,229,6181,797,6978,-0.0274688,0.0657217,-0.99746,1
5158,0,0,0,0,835,220,6213,960,7173,-0.0239072,0.0613974,-0.997827,1
5090,0,0,0,0,822,213,6125,1116,7241,-0.00731817,0.021847,-0.999735,1
5198,0,0,0,0,797,203,6198,1495,7693,0.00697901,0.0155194,-0.999855,1
5331,0,0,0,0,716,187,6234,1592,7826,0.0182296,0.0194099,-0.999645,1
5294,0,0,0,0,641,182,6117,1693,7810,0.0112046,0.0484206,-0.998764,1
5198,0,0,0,0,616,159,5973,1861,7834,-0.000894176,0.0380875,-0.999274,1
5053,0,0,0,0,517,138,5708,1883,7591,9.64535e-05,0.0265967,-0.999646,1
4891,0,0,0,0,399,110,5400,1811,7211,0.00703063,-0.00789835,-0.999944,1
4743,0,0,0,0,408,105,5256,1592,6848,0.013908,-0.00494876,-0.999891,1
5027,0,0,0,0,391,106,5524,1599,7123,0.0190982,-0.0211653,-0.999594,1
4664,0,0,0,0,406,127,5197,1578,6775,0.0224449,-0.0166215,-0.99961,1
5036,0,0,0,0,506,129,5671,1615,7286,0.00566384,-0.0119464,-0.999913,1
4192,0,0,0,0,569,150,4911,1464,6375,-0.0108697,-0.00949815,-0.999896,1
1733,0,0,0,0,222,66,2021,536,2557,-0.0175712,-0.0347855,-0.99924,1
5383,0,0,0,0,766,209,6358,1394,7752,0.00290547,-0.0262343,-0.999652,1
5051,0,0,0,0,735,198,5984,1236,7220,0.0236885,-0.0046283,-0.999709,1
5391,0,0,0,0,816,240,6447,1133,7580,0.0707446,-0.0165462,-0.997357,1
5180,0,0,0,0,985,230,6395,1521,7916,0.124107,-0.0505411,-0.990981,1
5387,0,0,0,0,1044,254,6685,1753,8438,0.132979,-0.00957931,-0.991073,1
6272,0,0,0,0,1276,347,7895,1974,9869,0.0808491,0.0742973,-0.993953,1
4308,0,0,0,0,1015,233,5556,1760,7316,0.0688077,0.139445,-0.987836,1
6627,0,0,0,0,1453,418,8498,2510,11008,0.0568289,0.192567,-0.979637,1
6591,0,0,0,0,1514,371,8476,2688,11164,0.0567386,0.179242,-0.982168,1
4572,0,0,0,0,991,252,5815,1998,7813,0.0432717,0.130987,-0.990439,1
6246,0,0,0,0,2037,486,8769,4029,12798,0.0126326,0.072939,-0.997257,1
5962,0,0,0,0,1308,337,7607,4125,11732,-0.0179871,-0.0383774,-0.999102,1
5976,0,0,0,0,1235,301,7512,5222,12734,-0.0360994,-0.0381876,-0.998618,1
5156,0,0,0,0,1089,293,6538,3871,10409,-0.0471949,-0.0254196,-0.998563,1
6183,0,0,0,0,1055,278,7516,3333,10849,-0.0482678,-0.0235845,-0.998556,1
3658,0,0,0,0,725,194,4577,2189,6766,-0.0558135,-0.00233871,-0.998439,1
4856,0,0,0,0,909,251,6016,2409,8425,-0.0547508,-0.0116073,-0.998433,1
4720,0,0,0,0,853,240,5813,2223,8036,-0.0551049,-0.021546,-0.998248,1
5707,0,0,0,0,1095,299,7101,2766,9867,-0.0435746,-0.0338262,-0.998478,1
6592,0,0,0,0,1118,293,8003,2461,10464,-0.0351113,-0.0372208,-0.99869,1
5632,0,0,0,0,999,311,6942,2356,9298,-0.0152176,0.0868459,-0.996106,1
5499,0,0,0,0,920,173,6592,1854,8446,-0.0192945,0.0305517,-0.999347,1
2251,0,0,0,0,408,102,2761,825,3586,-0.0323296,-0.0275208,-0.999098,1
3065,0,0,0,0,765,163,3993,1061,5054,-0.0253574,-0.017753,-0.999521,1
5121,0,0,0,0,903,230,6254,1675,7929,-0.02452,0.0343285,-0.99911,1
5010,0,0,0,0,887,226,6123,1625,7748,-0.036063,0.0560367,-0.997777,1
5198,0,0,0,0,850,260,6308,1666,7974,-0.0334739,0.0638389,-0.997399,1
4982,0,0,0,0,855,220,6057,1373,7430,-0.0203479,0.0957056,-0.995202,1
4837,0,0,0,0,896,221,5954,1237,7191,-0.012952,0.0801237,-0.996701,1
5033,0,0,0,0,813,236,6082,936,7018,-0.00363012,0.0932497,-0.995636,1
4496,0,0,0,0,787,193,5476,637,6113,-0.00453231,0.0653006,-0.997855,1
4891,0,0,0,0,810,250,5951,552,6503,-0.0147893,0.105822,-0.994275,1
4817,0,0,0,0,772,214,5803,421,6224,0.00334472,0.0817247,-0.996649,1
4738,0,0,0,0,738,193,5669,415,6084,-0.00971285,0.0465246,-0.99887,1
4956,0,0,0,0,726,204,5886,389,6275,-0.0336175,0.0857589,-0.995749,1
4807,0,0,0,0,742,238,5787,963,6750,-0.0269005,0.0863626,-0.995901,1
4890,0,0,0,0,809,210,5909,963,6872,-0.0176782,0.0651459,-0.997719,1
5552,0,0,0,0,876,247,6675,1018,7693,-0.000899883,0.0456111,-0.998959,1
5108,0,0,0,0,694,180,5982,741,6723,0.00193891,0.0340901,-0.999417,1
5067,0,0,0,0,863,226,6156,1084,7240,0.0043796,0.0488769,-0.998795,1
4928,0,0,0,0,826,215,5969,947,6916,0.00285374,0.0538996,-0.998542,1
5503,0,0,0,0,1036,275,6814,1224,8038,-0.0168337,0.0660679,-0.997673,1
5534,0,0,0,0,952,270,6756,815,7571,-0.0364417,0.0968914,-0.994628,1
5651,0,0,0,0,1084,283,7018,527,7545,-0.0320573,0.103082,-0.994156,1
4783,0,0,0,0,1303,234,6320,540,6860,-0.0259664,0.087091,-0.995862,1
4679,0,0,0,0,818,215,5712,505,6217,-0.0244255,0.0599978,-0.9979,1
5119,0,0,0,0,790,218,6127,555,6682,-0.017299,0.036399,-0.999188,1
5116,0,0,0,0,772,216,6104,556,6660,-0.0114485,0.0145475,-0.999829,1
4823,0,0,0,0,729,188,5740,591,6331,-0.00490673,-0.0102868,-0.999935,1
4920,0,0,0,0,796,220,5936,828,6764,-0.00213031,-0.0303499,-0.999537,1
4866,0,0,0,0,710,186,5762,775,6537,0.00415148,-0.0284448,-0.999587,1
5778,0,0,0,0,758,214,6750,898,7648,0.0119403,-0.0373744,-0.99923,1
5095,0,0,0,0,743,216,6054,932,6986,0.0190574,-0.0348341,-0.999212,1
3609,0,0,0,0,470,124,4203,783,4986,0.0174261,-0.035414,-0.999221,1
4942,0,0,0,0,674,175,5791,1170,6961,0.0218356,-0.0235027,-0.999485,1
5064,0,0,0,0,664,173,5901,1206,7107,0.0238518,-0.0140769,-0.999617,1
5154,0,0,0,0,661,173,5988,1399,7387,0.0270999,-0.0066183,-0.999611,1
5362,0,0,0,0,514,132,6008,955,6963,0.0241619,-0.0115673,-0.999641,1
4539,0,0,0,0,509,139,5187,981,6168,0.0151257,-0.0148496,-0.999776,1
5482,0,0,0,0,678,187,6347,1550,7897,0.00373057,0.00760233,-0.999964,1
5468,0,0,0,0,653,152,6273,1568,7841,-0.00738075,0.00754993,-0.999944,1
5378,0,0,0,0,596,144,6118,1557,7675,-0.00272877,-0.0149887,-0.999884,1
5221,0,0,0,0,540,147,5908,1583,7491,-0.00207001,-0.0365177,-0.999331,1
5347,0,0,0,0,516,131,5994,1549,7543,-0.00426806,-0.0525586,-0.998609,1
4888,0,0,0,0,518,139,5545,1595,7140,-0.0050763,-0.0749164,-0.997177,1
5640,0,0,0,0,488,136,6264,1513,7777,0.000443232,-0.0782036,-0.996937,1
4814,0,0,0,0,456,135,5405,1654,7059,-0.00111358,-0.0888349,-0.996046,1
5121,0,0,0,0,508,136,5765,1608,7373,0.00551345,-0.0704416,-0.997501,1
4789,0,0,0,0,481,133,5403,1207,6610,0.00641453,-0.113049,-0.993569,1
4813,0,0,0,0,394,130,5337,1058,6395,0.00442899,-0.229948,-0.973193,1
5152,0,0,0,0,491,115,5758,1013,6771,0.00457916,-0.260186,-0.965548,1
4638,0,0,0,0,431,123,5192,1003,6195,0.00943029,-0.136423,-0.990606,1
5427,0,0,0,0,562,145,6134,1244,7378,0.0144708,-0.141345,-0.989855,1
4864,0,0,0,0,611,154,5629,1285,6914,0.00711873,-0.103942,-0.994558,1
4692,0,0,0,0,609,160,5461,1406,6867,-0.00338219,-0.131479,-0.991313,1
4691,0,0,0,0,627,193,5511,1574,7085,-0.0104538,-0.0936079,-0.995554,1
4930,0,0,0,0,703,192,5825,1725,7550,-0.0199183,-0.061159,-0.997929,1
4728,0,0,0,0,735,184,5647,1795,7442,-0.0251906,-0.0305853,-0.999215,1
5233,0,0,0,0,760,220,6213,1783,7996,-0.0331077,-0.0194899,-0.999262,1
4901,0,0,0,0,540,153,5594,1246,6840,-0.0325276,-0.0170388,-0.999326,1
4867,0,0,0,0,846,231,5944,1284,7228,-0.0282661,0.106064,-0.993958,1
5600,0,0,0,0,992,229,6821,980,7801,0.036895,0.198769,-0.979352,1
5364,0,0,0,0,1084,266,6714,1093,7807,0.108093,0.163656,-0.980578,1
5409,0,0,0,0,1216,294,6919,1126,8045,0.202051,0.0590796,-0.977592,1
5721,0,0,0,0,1254,310,7285,1182,8467,0.194193,0.0727894,-0.978259,1
5852,0,0,0,0,1406,315,7573,1720,9293,0.147137,0.0971569,-0.984333,1
6112,0,0,0,0,1333,336,7781,2374,10155,0.0893706,0.10411,-0.990543,1
6315,0,0,0,0,1389,351,8055,2710,10765,0.0424764,0.0923344,-0.994822,1
6369,0,0,0,0,1420,370,8159,2727,10886,0.00560416,0.082386,-0.996585,1
5596,0,0,0,0,1279,308,7183,2950,10133,0.00400296,0.0499344,-0.998745,1
6228,0,0,0,0,1492,343,8063,3717,11780,0.00802821,0.0211955,-0.999744,1
6156,0,0,0,0,1325,336,7817,3642,11459,-0.015458,-0.0612126,-0.998005,1
5120,0,0,0,0,1053,250,6423,4655,11078,-0.0214787,-0.0594135,-0.998002,1
5044,0,0,0,0,969,233,6246,3745,9991,-0.0466315,-0.00726843,-0.998886,1
5656,0,0,0,0,1009,243,6908,3404,10312,-0.0619146,-0.00224862,-0.998079,1
5560,0,0,0,0,971,240,6771,2989,9760,-0.0674737,-0.00426406,-0.997712,1
5526,0,0,0,0,968,234,6728,2729,9457,-0.0615406,-0.00414742,-0.998096,1
5649,0,0,0,0,992,276,6917,2568,9485,-0.0538922,0.00765001,-0.998518,1
5734,0,0,0,0,988,236,6958,2466,9424,-0.0441967,-0.00550678,-0.999008,1
5512,0,0,0,0,994,236,6742,2192,8934,-0.0412785,-0.0200009,-0.998948,1
5423,0,0,0,0,979,237,6639,2000,8639,-0.0381104,0.00562908,-0.999258,1
5237,0,0,0,0,974,235,6446,1889,8335,-0.0396101,0.0175008,-0.999062,1
5087,0,0,0,0,902,229,6218,1753,7971,-0.0431937,0.0475728,-0.997933,1
5055,0,0,0,0,933,262,6250,1535,7785,-0.0387271,0.0638831,-0.997206,1
5952,0,0,0,0,855,252,7059,1593,8652,-0.0418262,0.100128,-0.994095,1
5037,0,0,0,0,858,247,6142,1514,7656,-0.0403506,0.0980882,-0.994359,1
5076,0,0,0,0,830,244,6150,1395,7545,-0.0447969,0.080477,-0.99575,1
4889,0,0,0,0,825,237,5951,1026,6977,-0.0462822,0.070062,-0.996469,1
4628,0,0,0,0,809,232,5669,819,6488,-0.0606015,0.0887991,-0.994204,1
4657,0,0,0,0,1079,292,6028,661,6689,-0.0695183,0.126622,-0.989512,1
4839,0,0,0,0,738,213,5790,457,6247,-0.0803064,0.17006,-0.982156,1
4605,0,0,0,0,708,211,5524,507,6031,-0.049104,0.116097,-0.992023,1
4809,0,0,0,0,692,176,5677,425,6102,-0.0525623,0.15644,-0.986288,1
4829,0,0,0,0,737,178,5744,560,6304,-0.0825038,0.149712,-0.985282,1
4909,0,0,0,0,962,218,6089,420,6509,-0.0670029,0.143275,-0.987412,1
5177,0,0,0,0,865,247,6289,587,6876,-0.0494378,0.0697603,-0.996338,1
5329,0,0,0,0,880,224,6433,640,7073,-0.024797,0.0128623,-0.99961,1
5188,0,0,0,0,905,235,6328,724,7052,-0.0269014,-0.00638966,-0.999618,1
5182,0,0,0,0,1020,246,6448,401,6849,-0.0271786,-0.0189503,-0.999451,1
5325,0,0,0,0,842,174,6341,592,6933,0.033821,0.465134,-0.884595,1
3580,0,0,0,0,764,223,4567,338,4905,0.069327,0.456322,-0.88711,1
5341,0,0,0,0,918,282,6541,668,7209,0.0545031,0.496672,-0.866226,1
5268,0,0,0,0,844,220,6332,684,7016,0.0686931,0.549347,-0.832766,1
5231,0,0,0,0,878,240,6349,667,7016,0.00728529,0.500459,-0.86573,1
5057,0,0,0,0,718,216,5991,660,6651,-0.0512117,0.0171581,-0.998541,1
5406,0,0,0,0,944,251,6601,491,7092,-0.0804055,-0.0461131,-0.995695,1
5304,0,0,0,0,703,192,6199,486,6685,-0.0763816,-0.054661,-0.99558,1
4809,0,0,0,0,537,156,5502,425,5927,-0.057404,-0.0958066,-0.993743,1
5223,0,0,0,0,614,164,6001,937,6938,-0.0359653,-0.0385013,-0.998611,1
5423,0,0,0,0,485,124,6032,1127,7159,-0.0319538,-0.032809,-0.998951,1
5169,0,0,0,0,440,116,5725,849,6574,-0.0453733,-0.0992464,-0.994028,1
4882,0,0,0,0,358,116,5356,1218,6574,-0.0466746,-0.0438847,-0.997946,1
4796,0,0,0,0,362,87,5245,1158,6403,-0.0510015,-0.0241174,-0.998407,1
4879,0,0,0,0,328,86,5293,1239,6532,-0.048295,-0.0278419,-0.998445,1
4945,0,0,0,0,357,95,5397,1250,6647,-0.0444915,-0.0280536,-0.998616,1
4671,0,0,0,0,394,103,5168,1219,6387,-0.0358169,-0.0202729,-0.999153,1
4700,0,0,0,0,425,109,5234,1215,6449,-0.0472326,-0.0459654,-0.997826,1
4768,0,0,0,0,471,120,5359,1397,6756,-0.0618401,-0.0189665,-0.997906,1
4870,0,0,0,0,558,139,5567,1474,7041,-0.0726757,-0.0121279,-0.997282,1
4740,0,0,0,0,543,147,5430,1358,6788,-0.0777071,-0.0111271,-0.996914,1
4918,0,0,0,0,609,156,5683,1295,6978,-0.0621755,-0.0272871,-0.997692,1
4672,0,0,0,0,631,188,5491,1266,6757,-0.0613376,-0.0376555,-0.997406,1
5117,0,0,0,0,558,152,5827,1427,7254,-0.0680309,-0.0453038,-0.996654,1
4626,0,0,0,0,619,157,5402,1811,7213,-0.0603785,-0.0314179,-0.997681,1
4521,0,0,0,0,697,198,5416,1573,6989,-0.0515858,-0.0175027,-0.998515,1
4682,0,0,0,0,803,209,5694,1040,6734,-0.0245067,0.0126051,-0.99962,1
4925,0,0,0,0,819,226,5970,973,6943,0.0285582,0.00520932,-0.999579,1
5111,0,0,0,0,894,228,6233,1200,7433,0.0919,-0.0209225,-0.995548,1
5376,0,0,0,0,1263,408,7047,2060,9107,0.0544833,0.0205913,-0.998303,1
4018,0,0,0,0,875,220,5113,1490,6603,0.00964955,0.0795787,-0.996782,1
6306,0,0,0,0,1150,320,7776,2195,9971,-0.0142165,0.10742,-0.994112,1
5670,0,0,0,0,1273,295,7238,1880,9118,-0.00590583,0.125606,-0.992063,1
5227,0,0,0,0,1111,266,6604,2050,8654,0.0152822,0.144076,-0.989449,1
6163,0,0,0,0,1336,335,7834,2421,10255,0.02663,0.166675,-0.985652,1
5865,0,0,0,0,1272,291,7428,2524,9952,0.0054123,0.163201,-0.986578,1
5786,0,0,0,0,1103,258,7147,2463,9610,-0.04156,-0.0565817,-0.997532,1
5600,0,0,0,0,1012,274,6886,4418,11304,-0.0671632,-0.0713106,-0.99519,1
5578,0,0,0,0,960,250,6788,3019,9807,-0.0679444,-0.0804324,-0.994442,1
2926,0,0,0,0,506,150,3582,1707,5289,-0.0642442,-0.089121,-0.993947,1
4494,0,0,0,0,1077,190,5761,2401,8162,-0.0615516,-0.0704224,-0.995617,1
5576,0,0,0,0,995,256,6827,2829,9656,-0.0526313,-0.0548208,-0.997108,1
5792,0,0,0,0,998,248,7038,2532,9570,-0.0430247,-0.0615836,-0.997174,1
5511,0,0,0,0,935,250,6696,2410,9106,-0.0320969,-0.0620263,-0.997558,1
5905,0,0,0,0,965,271,7141,2301,9442,-0.0333522,-0.0675235,-0.99716,1
5531,0,0,0,0,1000,280,6811,2165,8976,-0.04116,-0.0663636,-0.996946,1
5584,0,0,0,0,966,275,6825,2027,8852,-0.0352298,0.0890883,-0.995401,1
5733,0,0,0,0,925,246,6904,1999,8903,-0.0551326,0.0706437,-0.995977,1
3592,0,0,0,0,591,119,4302,867,5169,-0.0597403,-0.00729551,-0.998187,1
2432,0,0,0,0,415,106,2953,797,3750,-0.0669052,-0.0181985,-0.997594,1
4842,0,0,0,0,890,221,5953,1410,7363,-0.0724801,0.0111914,-0.997307,1
4720,0,0,0,0,755,241,5716,1323,7039,-0.0778947,0.0443925,-0.995973,1
4654,0,0,0,0,695,197,5546,1284,6830,-0.0658385,0.0407475,-0.996998,1
4572,0,0,0,0,681,194,5447,1118,6565,-0.0671523,0.0289855,-0.997322,1
4494,0,0,0,0,661,188,5343,907,6250,-0.051824,0.0380919,-0.997929,1
4653,0,0,0,0,657,181,5491,739,6230,-0.0450189,0.0577151,-0.997318,1
4381,0,0,0,0,579,169,5129,435,5564,-0.0691081,0.0642609,-0.995538,1
4645,0,0,0,0,573,162,5380,557,5937,-0.0485643,0.0135916,-0.998728,1
4430,0,0,0,0,516,144,5090,401,5491,-0.067739,0.0272249,-0.997332,1
4672,0,0,0,0,481,151,5304,394,5698,0.0895443,0.217023,-0.972051,1
6561,0,0,0,0,660,168,7389,360,7749,0.0505835,0.239752,-0.969516,1
3323,0,0,0,0,331,100,3754,339,4093,0.0686832,0.143564,-0.987255,1
3394,0,0,0,0,463,115,3972,288,4260,0.136305,0.22518,-0.964735,1
5304,0,0,0,0,707,194,6205,487,6692,0.0658297,0.0620726,-0.995898,1
5218,0,0,0,0,740,205,6163,522,6685,0.0725017,0.0311281,-0.996883,1
5260,0,0,0,0,813,224,6297,413,6710,0.154418,0.019229,-0.987818,1
5177,0,0,0,0,925,238,6340,281,6621,-0.12284,-0.112436,-0.986037,1
5215,0,0,0,0,898,224,6337,-1000,-1000,-1,-1,-1,1
5085,0,0,0,0,796,208,6089,339,6428,-0.0511891,0.120256,-0.991422,1
5132,0,0,0,0,755,198,6085,335,6420,-0.0683395,-0.0199671,-0.997462,1
4922,0,0,0,0,687,188,5797,-1000,-1000,-1,-1,-1,1
4988,0,0,0,0,657,201,5846,646,6492,-0.0356239,-0.0606422,-0.997524,1
5168,0,0,0,0,635,179,5982,709,6691,-0.0237398,-0.0315901,-0.999219,1
5335,0,0,0,0,580,155,6070,924,6994,-0.0197584,-0.0144568,-0.9997,1
5592,0,0,0,0,640,185,6417,1010,7427,-0.0204703,-0.00635788,-0.99977,1
6062,0,0,0,0,581,186,6829,1201,8030,-0.0277961,-0.0417944,-0.998739,1
5479,0,0,0,0,624,186,6289,1381,7670,-0.0271223,-0.0596802,-0.997849,1
5174,0,0,0,0,620,154,5948,1445,7393,-0.0193606,-0.0715738,-0.997248,1
3440,0,0,0,0,392,104,3936,1014,4950,0.00396755,-0.0870076,-0.9962,1
7973,0,0,0,0,842,225,9040,1974,11014,0.00522851,-0.0855362,-0.996321,1
3340,0,0,0,0,365,98,3803,1003,4806,-0.0121003,-0.0786008,-0.996833,1
4852,0,0,0,0,503,138,5493,1624,7117,-0.0273312,-0.0655356,-0.997476,1
4664,0,0,0,0,468,164,5296,1504,6800,-0.0326524,-0.0491441,-0.998258,1
4279,0,0,0,0,408,112,4799,1405,6204,-0.0409871,-0.036335,-0.998499,1
4655,0,0,0,0,464,148,5267,1669,6936,-0.0383165,-0.0367111,-0.998591,1
4486,0,0,0,0,416,115,5017,1588,6605,-0.0300161,-0.025411,-0.999226,1
4238,0,0,0,0,379,133,4750,1672,6422,-0.0308409,-0.00384207,-0.999517,1
4381,0,0,0,0,396,109,4886,1751,6637,-0.0137953,-0.0321695,-0.999387,1
4413,0,0,0,0,399,113,4925,1781,6706,-0.00813063,-0.023879,-0.999682,1
4260,0,0,0,0,476,127,4863,1949,6812,-0.0527596,0.0734464,-0.995903,1
4490,0,0,0,0,570,147,5207,1959,7166,-0.0593866,0.0182027,-0.998069,1
3104,0,0,0,0,389,92,3585,1095,4680,-0.059026,-0.0422485,-0.997362,1
4936,0,0,0,0,869,208,6013,1952,7965,-0.0875731,-0.047558,-0.995022,1
5081,0,0,0,0,1031,273,6385,2607,8992,-0.0885777,-0.0615707,-0.994164,1
5981,0,0,0,0,1243,278,7502,2973,10475,-0.0773403,-0.0608762,-0.995145,1
5535,0,0,0,0,1464,324,7323,2710,10033,-0.0891069,-0.0619724,-0.994092,1
5316,0,0,0,0,1328,355,6999,3193,10192,-0.0706853,-0.0450555,-0.996481,1
6354,0,0,0,0,1627,407,8388,3857,12245,-0.0432938,-0.0427847,-0.998146,1
4293,0,0,0,0,1065,318,5676,2724,8400,-0.035731,-0.0492352,-0.998148,1
6961,0,0,0,0,1539,397,8897,4050,12947,-0.0319461,-0.0572783,-0.997847,1
6716,0,0,0,0,1554,431,8701,4589,13290,-0.026858,-0.0813047,-0.996327,1
6094,0,0,0,0,1326,344,7764,4583,12347,-0.0363029,-0.10756,-0.993535,1
4676,0,0,0,0,832,229,5737,2780,8517,-0.0457189,-0.0890308,-0.994979,1
5245,0,0,0,0,1012,294,6551,3011,9562,-0.0447304,-0.0712425,-0.996456,1
6704,0,0,0,0,1161,265,8130,2845,10975,-0.0360887,-0.0523912,-0.997975,1
5881,0,0,0,0,1059,269,7209,2588,9797,-0.0316458,-0.0406427,-0.998673,1
5920,0,0,0,0,1090,315,7325,1614,8939,-0.0244042,-0.0410694,-0.998858,1
4108,0,0,0,0,706,198,5012,1839,6851,-0.0363337,-0.079482,-0.996174,1
3977,0,0,0,0,706,174,4857,1509,6366,-0.0430661,-0.0825905,-0.995653,1
6124,0,0,0,0,891,228,7243,1930,9173,-0.0481208,-0.059448,-0.997071,1
4811,0,0,0,0,870,215,5896,1695,7591,-0.0559462,-0.0288244,-0.998018,1
5841,0,0,0,0,938,274,7053,1716,8769,-0.0582979,-0.0136817,-0.998206,1
4978,0,0,0,0,829,242,6049,1461,7510,-0.0685138,-0.0135394,-0.997558,1
4914,0,0,0,0,707,216,5837,1456,7293,-0.057704,0.011342,-0.998269,1
4370,0,0,0,0,668,175,5213,1355,6568,-0.045283,0.03178,-0.998469,1
4288,0,0,0,0,637,162,5087,868,5955,-0.0303722,0.102318,-0.994288,1
4217,0,0,0,0,606,175,4998,631,5629,-0.0313314,0.115528,-0.99281,1
4302,0,0,0,0,560,165,5027,593,5620,-0.0316942,0.110785,-0.993339,1
4406,0,0,0,0,544,198,5148,514,5662,-0.0363394,0.241848,-0.969634,1
4274,0,0,0,0,543,159,4976,410,5386,-0.0479568,0.232695,-0.971367,1
4596,0,0,0,0,555,152,5303,279,5582,-0.0762082,0.247022,-0.966009,1
4529,0,0,0,0,635,165,5329,1024,6353,-0.0615852,0.062444,-0.996147,1
4776,0,0,0,0,781,213,5770,1119,6889,-0.0395398,0.106651,-0.99351,1
4980,0,0,0,0,947,269,6196,563,6759,-0.0169078,0.188753,-0.981879,1
5391,0,0,0,0,1075,297,6763,780,7543,0.0194104,0.196499,-0.980312,1
5430,0,0,0,0,1170,324,6924,975,7899,0.0298251,0.17613,-0.983915,1
5554,0,0,0,0,1207,345,7106,997,8103,0.006782,0.169911,-0.985436,1
5537,0,0,0,0,1189,343,7069,611,7680,-0.0252212,0.125968,-0.991713,1
5365,0,0,0,0,1065,313,6743,583,7326,0.0442843,0.100209,-0.99398,1
5289,0,0,0,0,986,250,6525,603,7128,0.0413446,-0.0169447,-0.999001,1
5194,0,0,0,0,1000,241,6435,600,7035,0.0203442,-0.061087,-0.997925,1
5530,0,0,0,0,912,258,6700,680,7380,0.00952394,-0.0763833,-0.997033,1
4820,0,0,0,0,878,245,5943,525,6468,-0.00927325,-0.0606807,-0.998114,1
5511,0,0,0,0,969,228,6708,685,7393,-0.0279564,0.00352947,-0.999603,1
5338,0,0,0,0,895,261,6494,690,7184,-0.0363649,0.0122191,-0.999264,1
5230,0,0,0,0,827,213,6270,693,6963,-0.0385875,-0.027908,-0.998866,1
5358,0,0,0,0,801,229,6388,1029,7417,-0.0286922,-0.030456,-0.999124,1
5396,0,0,0,0,794,201,6391,1225,7616,-0.01991,-0.0500438,-0.998549,1
5720,0,0,0,0,776,223,6719,1359,8078,-0.0140306,-0.0549495,-0.99839,1
6323,0,0,0,0,825,258,7406,1591,8997,-0.00846627,-0.0522407,-0.998599,1
5334,0,0,0,0,610,171,6115,1402,7517,-0.00817836,-0.0498053,-0.998725,1
4870,0,0,0,0,498,125,5493,1443,6936,0.000320262,0.0428807,-0.99908,1
4158,0,0,0,0,302,82,4542,1312,5854,-0.00125866,0.0066,-0.999977,1
3901,0,0,0,0,197,62,4160,849,5009,-0.00389826,-0.0736375,-0.997277,1
3195,0,0,0,0,242,79,3516,922,4438,-0.0182094,-0.0755492,-0.996976,1
4185,0,0,0,0,331,87,4603,1291,5894,-0.0308469,-0.0397807,-0.998732,1
4099,0,0,0,0,324,99,4522,1236,5758,-0.0193599,-0.0651059,-0.997691,1
4098,0,0,0,0,291,111,4500,1282,5782,-0.0226843,-0.0642822,-0.997674,1
4164,0,0,0,0,345,112,4621,1481,6102,-0.0202828,-0.0318659,-0.999286,1
4241,0,0,0,0,410,104,4755,1546,6301,-0.0295855,-0.0134558,-0.999472,1
4269,0,0,0,0,451,117,4837,1528,6365,-0.0487413,-0.0310986,-0.998327,1
4247,0,0,0,0,486,126,4859,1725,6584,-0.0484607,-0.0298979,-0.998378,1
4317,0,0,0,0,553,145,5015,916,5931,-0.033039,0.0347032,-0.998851,1
3996,0,0,0,0,550,155,4701,656,5357,0.0112256,0.135948,-0.990653,1
4539,0,0,0,0,744,189,5472,737,6209,0.04595,0.248151,-0.967631,1
4832,0,0,0,0,888,248,5968,914,6882,0.0389544,0.31936,-0.946833,1
5242,0,0,0,0,1166,316,6724,1227,7951,0.0223895,0.365788,-0.930429,1
5817,0,0,0,0,1324,358,7499,1283,8782,0.0176134,0.396563,-0.917839,1
5663,0,0,0,0,1493,448,7604,1419,9023,0.0237121,0.451112,-0.892153,1
4062,0,0,0,0,1012,259,5333,810,6143,0.0254299,0.467632,-0.883558,1
4080,0,0,0,0,1408,263,5751,849,6600,0.0289403,0.543118,-0.839158,1
3922,0,0,0,0,1000,255,5177,932,6109,0.0476984,0.641004,-0.766054,1
5818,0,0,0,0,1298,350,7466,-1000,-1000,-1,-1,-1,1
5345,0,0,0,0,1240,290,6875,3318,10193,-0.0095385,-0.0495117,-0.998728,1
5618,0,0,0,0,1085,271,6974,3153,10127,-0.0094517,-0.0580922,-0.998267,1
5316,0,0,0,0,1168,268,6752,2797,9549,-0.0225867,-0.0726345,-0.997103,1
5173,0,0,0,0,1071,282,6526,2617,9143,-0.0387412,-0.0764069,-0.996324,1
5503,0,0,0,0,1063,258,6824,2543,9367,-0.040188,-0.0809163,-0.99591,1
5715,0,0,0,0,1203,280,7198,2559,9757,-0.0431467,-0.0928029,-0.994749,1
5404,0,0,0,0,1118,247,6769,2171,8940,-0.044162,-0.0870924,-0.995221,1
5534,0,0,0,0,1116,270,6920,2252,9172,-0.0404703,-0.0867876,-0.995405,1
4384,0,0,0,0,734,183,5301,1480,6781,-0.0396161,-0.102309,-0.993964,1
5357,0,0,0,0,1094,249,6700,1835,8535,-0.024288,-0.096957,-0.994992,1
5377,0,0,0,0,959,246,6582,1815,8397,-0.0375329,-0.106652,-0.993588,1
5082,0,0,0,0,878,235,6195,1679,7874,-0.0480423,-0.0696716,-0.996412,1
4948,0,0,0,0,900,223,6071,1535,7606,-0.0561136,-0.0460836,-0.99736,1
4329,0,0,0,0,770,171,5270,1404,6674,-0.0695831,-0.0444115,-0.996587,1
4463,0,0,0,0,741,196,5400,1224,6624,-0.0589151,-0.0229433,-0.997999,1
4308,0,0,0,0,690,199,5197,1269,6466,-0.0425579,-0.018184,-0.998928,1
4435,0,0,0,0,734,236,5405,1140,6545,-0.0260242,0.0267852,-0.999302,1
5268,0,0,0,0,598,170,6036,996,7032,-0.0282788,0.0217927,-0.999363,1
4195,0,0,0,0,577,168,4940,839,5779,-0.0210577,0.0569616,-0.998154,1
4169,0,0,0,0,523,144,4836,646,5482,-0.0142985,0.147486,-0.988961,1
4166,0,0,0,0,572,156,4894,605,5499,-0.00894415,0.163683,-0.986472,1
4048,0,0,0,0,556,138,4742,337,5079,-0.0294594,0.0358379,-0.998923,1
3717,0,0,0,0,508,150,4375,377,4752,-0.00461642,0.112785,-0.993609,1
4183,0,0,0,0,574,186,4943,442,5385,-0.00164549,0.0979629,-0.995189,1
4755,0,0,0,0,613,171,5539,454,5993,0.0193284,0.213704,-0.976707,1
4806,0,0,0,0,804,213,5823,662,6485,-0.0204583,0.202282,-0.979114,1
5184,0,0,0,0,969,279,6432,674,7106,-0.0736329,0.143426,-0.986918,1
5412,0,0,0,0,1071,267,6750,708,7458,-0.0816005,0.0791329,-0.993519,1
5596,0,0,0,0,1143,288,7027,472,7499,-0.023843,0.0584429,-0.998006,1
5623,0,0,0,0,1114,293,7030,419,7449,-0.0184185,0.0791519,-0.996693,1
5543,0,0,0,0,1055,272,6870,395,7265,-0.00799072,0.0747116,-0.997173,1
5647,0,0,0,0,995,263,6905,435,7340,-0.0116592,0.0656093,-0.997777,1
6459,0,0,0,0,923,229,7611,680,8291,-0.0196182,0.0478,-0.998664,1
5494,0,0,0,0,720,187,6401,668,7069,0.000992064,0.045129,-0.998981,1
5491,0,0,0,0,566,158,6215,893,7108,0.00262639,0.0235692,-0.999719,1
4786,0,0,0,0,467,176,5429,1123,6552,0.0103816,0.000518046,-0.999946,1
5264,0,0,0,0,433,113,5810,1255,7065,0.0129011,-0.00193541,-0.999915,1
3454,0,0,0,0,299,84,3837,876,4713,-0.00139916,-0.031838,-0.999492,1
4459,0,0,0,0,447,115,5021,1283,6304,-0.00383687,-0.0532416,-0.998574,1
4598,0,0,0,0,445,113,5156,1239,6395,-0.00130746,-0.0563874,-0.998408,1
4537,0,0,0,0,636,137,5310,1151,6461,0.00679118,-0.0774723,-0.996971,1
4310,0,0,0,0,364,103,4777,1158,5935,0.00987781,-0.0697422,-0.997516,1
4260,0,0,0,0,343,99,4702,1096,5798,0.0101563,-0.0830683,-0.996492,1
4171,0,0,0,0,316,94,4581,886,5467,0.009019,-0.103286,-0.994611,1
4127,0,0,0,0,302,89,4518,816,5334,0.00559741,-0.127995,-0.991759,1
4731,0,0,0,0,280,84,5095,776,5871,0.00555273,-0.139808,-0.990163,1
4049,0,0,0,0,253,78,4380,694,5074,0.0265887,-0.228206,-0.97325,1
4167,0,0,0,0,232,77,4476,655,5131,0.0288842,-0.206201,-0.978084,1
3939,0,0,0,0,222,70,4231,703,4934,0.0452307,-0.268587,-0.962193,1
4161,0,0,0,0,211,69,4441,612,5053,0.0515181,-0.347789,-0.936156,1
3819,0,0,0,0,242,74,4135,544,4679,0.0387267,-0.434839,-0.899675,1
3871,0,0,0,0,381,87,4339,664,5003,0.0699736,-0.37117,-0.925925,1
3915,0,0,0,0,396,132,4443,776,5219,0.0184255,-0.463359,-0.885979,1
3938,0,0,0,0,454,122,4514,1177,5691,0.00578811,-0.323487,-0.946215,1
5069,0,0,0,0,467,133,5669,1869,7538,0.0127087,-0.202234,-0.979255,1
3959,0,0,0,0,426,113,4498,1587,6085,0.017011,-0.0956024,-0.995274,1
4054,0,0,0,0,436,124,4614,1208,5822,0.00994967,-0.0683601,-0.997611,1
4035,0,0,0,0,402,151,4588,1077,5665,0.00766234,-0.0302121,-0.999514,1
4089,0,0,0,0,452,136,4677,1071,5748,0.00132845,-0.0132271,-0.999911,1
4129,0,0,0,0,519,165,4813,881,5694,0.0726475,-0.00209339,-0.997356,1
4254,0,0,0,0,703,169,5126,1031,6157,0.141626,0.0377623,-0.9892,1
4315,0,0,0,0,767,206,5288,1485,6773,0.187494,-0.0239391,-0.981974,1
4441,0,0,0,0,857,201,5499,1984,7483,0.201665,-0.0773477,-0.976396,1
4616,0,0,0,0,973,225,5814,2388,8202,0.221182,-0.084721,-0.971545,1
4772,0,0,0,0,1054,242,6068,2700,8768,0.215678,-0.0686093,-0.974051,1
4982,0,0,0,0,1153,276,6411,2860,9271,0.221924,-0.0492873,-0.973817,1
5159,0,0,0,0,1311,307,6777,2822,9599,0.213084,-0.0212735,-0.976802,1
5544,0,0,0,0,1464,382,7390,3526,10916,0.179512,0.0412408,-0.982891,1
5686,0,0,0,0,1641,424,7751,3548,11299,0.160782,0.0822733,-0.983555,1
5957,0,0,0,0,1674,438,8069,3363,11432,0.13173,0.0988955,-0.98634,1
5435,0,0,0,0,1387,441,7263,2969,10232,0.109199,0.106687,-0.988278,1
6711,0,0,0,0,1638,446,8795,3284,12079,0.0813384,0.105845,-0.99105,1
6141,0,0,0,0,1594,442,8177,3171,11348,0.0613749,0.107026,-0.99236,1
5699,0,0,0,0,1430,372,7501,3020,10521,0.0445653,0.108651,-0.99308,1
6241,0,0,0,0,1509,363,8113,3240,11353,0.0290103,0.0888761,-0.99562,1
6504,0,0,0,0,1463,384,8351,3574,11925,0.025161,0.0789875,-0.996558,1
6036,0,0,0,0,1509,388,7933,3828,11761,0.0343556,0.0768069,-0.996454,1
6170,0,0,0,0,1292,334,7796,3838,11634,0.0177684,0.0100438,-0.999792,1
4290,0,0,0,0,858,227,5375,3025,8400,0.00171038,-0.0102738,-0.999946,1
6045,0,0,0,0,790,202,7037,2404,9441,-0.00910532,-0.0046187,-0.999948,1
2505,0,0,0,0,467,135,3107,1219,4326,-0.00868787,-0.00719318,-0.999936,1
5619,0,0,0,0,1099,306,7024,2464,9488,0.00535425,0.0234081,-0.999712,1
6007,0,0,0,0,1090,321,7418,2099,9517,0.00576423,0.0683522,-0.997645,1
5460,0,0,0,0,1079,311,6850,1804,8654,-0.0153862,0.0339665,-0.999305,1
5438,0,0,0,0,1048,298,6784,1785,8569,-0.0292031,-0.0231334,-0.999306,1
5291,0,0,0,0,918,247,6456,1603,8059,-0.04136,-0.0334135,-0.998585,1
4995,0,0,0,0,859,256,6110,1779,7889,-0.04288,-0.030624,-0.998611,1
4924,0,0,0,0,818,207,5949,1337,7286,-0.0409245,-0.0354595,-0.998533,1
5038,0,0,0,0,758,213,6009,1326,7335,-0.0281231,-0.0168189,-0.999463,1
4754,0,0,0,0,691,198,5643,1191,6834,-0.0223996,-0.0426821,-0.998838,1
4487,0,0,0,0,909,158,5554,890,6444,-0.0273873,-0.0655557,-0.997473,1
3045,0,0,0,0,432,109,3586,825,4411,-0.0269721,-0.0813551,-0.99632,1
4365,0,0,0,0,590,203,5158,1187,6345,-0.0201215,-0.114957,-0.993167,1
4370,0,0,0,0,537,176,5083,1309,6392,-0.0195576,-0.101724,-0.994621,1
4152,0,0,0,0,523,142,4817,1401,6218,-0.0155981,-0.107516,-0.994081,1
4167,0,0,0,0,499,138,4804,1320,6124,-0.0133508,-0.0965445,-0.995239,1
4070,0,0,0,0,541,161,4772,1166,5938,-0.0280199,-0.0961176,-0.994976,1
4238,0,0,0,0,535,161,4934,1126,6060,-0.031401,-0.063589,-0.997482,1
4609,0,0,0,0,474,159,5242,959,6201,-0.0349283,-0.0031553,-0.999385,1
4149,0,0,0,0,469,132,4750,1079,5829,-0.0408729,0.0251158,-0.998849,1
4443,0,0,0,0,473,131,5047,811,5858,-0.0431319,0.0216548,-0.998834,1
4269,0,0,0,0,514,129,4912,471,5383,-0.0296372,0.052326,-0.99819,1
4226,0,0,0,0,541,149,4916,309,5225,-0.0138568,0.071589,-0.997338,1
4178,0,0,0,0,536,136,4850,598,5448,-0.0138518,0.111318,-0.993688,1
4403,0,0,0,0,592,178,5173,369,5542,0.0503809,0.186882,-0.98109,1
4502,0,0,0,0,659,176,5337,561,5898,0.0338715,0.248088,-0.968146,1
4709,0,0,0,0,728,194,5631,612,6243,-0.0630298,0.406426,-0.911507,1
5074,0,0,0,0,917,259,6250,679,6929,-0.153604,0.578323,-0.801217,1
5354,0,0,0,0,1046,284,6684,-1000,-1000,-1,-1,-1,1
5589,0,0,0,0,1200,328,7117,1014,8131,0.356736,0.0775648,-0.93098,1
5569,0,0,0,0,1160,321,7050,446,7496,-0.221943,0.181197,-0.958076,1
5522,0,0,0,0,1183,309,7014,383,7397,-0.290949,0.248964,-0.923778,1
5584,0,0,0,0,1111,304,6999,1392,8391,-0.146371,0.662972,-0.734196,1
5467,0,0,0,0,1135,296,6898,823,7721,-0.180269,0.608381,-0.772901,1
5565,0,0,0,0,1123,295,6983,689,7672,-0.15068,0.673182,-0.723962,1
5374,0,0,0,0,1097,304,6775,685,7460,-0.145306,0.666516,-0.731193,1
5375,0,0,0,0,1062,263,6700,-1000,-1000,-1,-1,-1,1
4357,0,0,0,0,680,173,5210,569,5779,0.0422371,0.0119235,-0.999036,1
4196,0,0,0,0,713,181,5090,779,5869,0.0357586,0.0541354,-0.997893,1
5861,0,0,0,0,894,245,7000,1162,8162,0.0160042,0.0494566,-0.998648,1
5293,0,0,0,0,810,191,6294,1145,7439,-0.000620173,0.104742,-0.994499,1
4884,0,0,0,0,637,155,5676,1224,6900,-0.0121035,0.116616,-0.993103,1
5174,0,0,0,0,573,142,5889,1178,7067,0.000882595,0.107025,-0.994256,1
3923,0,0,0,0,276,89,4288,860,5148,0.0138958,0.0362778,-0.999245,1
3591,0,0,0,0,233,81,3905,1083,4988,0.024131,0.0732944,-0.997018,1
4224,0,0,0,0,199,63,4486,1319,5805,0.0143078,0.0161416,-0.999768,1
4142,0,0,0,0,169,55,4366,1293,5659,0.0167887,-0.00460511,-0.999849,1
4295,0,0,0,0,144,52,4491,1363,5854,0.0280016,-0.0074565,-0.99958,1
4020,0,0,0,0,137,49,4206,1175,5381,0.0430139,0.0167446,-0.998934,1
3947,0,0,0,0,192,50,4189,1263,5452,0.0221776,-0.0198727,-0.999557,1
4226,0,0,0,0,163,52,4441,1336,5777,0.0221047,-0.0257165,-0.999425,1
3966,0,0,0,0,145,48,4159,1397,5556,0.021067,-0.036709,-0.999104,1
3877,0,0,0,0,162,55,4094,1415,5509,0.00967431,-0.0438305,-0.998992,1
3828,0,0,0,0,183,59,4070,1521,5591,-0.0100495,-0.0243123,-0.999654,1
4314,0,0,0,0,242,74,4630,1678,6308,-0.0180334,-0.0428721,-0.998918,1
4071,0,0,0,0,323,92,4486,2006,6492,-0.0425713,-0.0190944,-0.998911,1
2297,0,0,0,0,211,58,2566,1237,3803,-0.0546859,-0.0314586,-0.998008,1
4388,0,0,0,0,558,144,5090,2229,7319,-0.0649384,-0.00708155,-0.997864,1
4605,0,0,0,0,718,203,5526,1638,7164,-0.0577133,-0.00602715,-0.998315,1
4909,0,0,0,0,1028,257,6194,1017,7211,-0.0654624,0.115389,-0.991161,1
5170,0,0,0,0,1223,328,6721,561,7282,0.0340122,0.210526,-0.976997,1
5557,0,0,0,0,1419,337,7313,855,8168,0.0693213,0.314892,-0.946593,1
5944,0,0,0,0,1570,378,7892,1359,9251,0.114876,0.333649,-0.935672,1
6000,0,0,0,0,1633,421,8054,1660,9714,0.136617,0.35929,-0.923172,1
6113,0,0,0,0,2251,450,8814,1578,10392,0.145032,0.38749,-0.910394,1
4171,0,0,0,0,1115,268,5554,1240,6794,0.141075,0.393956,-0.908238,1
6198,0,0,0,0,1531,368,8097,1802,9899,0.12717,0.415456,-0.90068,1
6890,0,0,0,0,1415,362,8667,2015,10682,0.104536,0.41202,-0.905159,1
4226,0,0,0,0,905,222,5353,1340,6693,0.0857951,0.400936,-0.91208,1
6156,0,0,0,0,1588,299,8043,2019,10062,0.0825376,0.416446,-0.905406,1
5944,0,0,0,0,1108,273,7325,2010,9335,0.0934889,0.488953,-0.867286,1
5761,0,0,0,0,1089,271,7121,1838,8959,0.101408,0.566947,-0.817489,1
5802,0,0,0,0,1004,244,7050,1839,8889,0.131403,0.669365,-0.731221,1
5620,0,0,0,0,998,236,6854,-1000,-1000,-1,-1,-1,1
4578,0,0,0,0,641,152,5371,1447,6818,-0.0118412,0.0478664,-0.998784,1
4417,0,0,0,0,763,168,5348,1808,7156,-0.00672359,0.0602068,-0.998163,1
5470,0,0,0,0,790,236,6496,1950,8446,0.00692287,0.0905131,-0.995871,1
4956,0,0,0,0,728,233,5917,1729,7646,-0.006094,0.0730985,-0.997306,1
4609,0,0,0,0,671,193,5473,1620,7093,-0.0146125,0.104357,-0.994433,1
4218,0,0,0,0,615,172,5005,1343,6348,-0.0177433,0.108862,-0.993899,1
4270,0,0,0,0,598,150,5018,1291,6309,-0.0180424,0.120298,-0.992574,1
4081,0,0,0,0,578,145,4804,1370,6174,-0.00429437,0.189288,-0.981912,1
4125,0,0,0,0,589,143,4857,1136,5993,-0.00771124,0.165966,-0.986101,1
4201,0,0,0,0,543,137,4881,978,5859,0.00844605,0.202833,-0.979177,1
4129,0,0,0,0,521,137,4787,732,5519,-0.00672016,0.177992,-0.984009,1
4690,0,0,0,0,515,139,5344,632,5976,0.0153733,0.213646,-0.97679,1
4134,0,0,0,0,522,141,4797,554,5351,0.0144443,0.211124,-0.977353,1
4266,0,0,0,0,561,152,4979,505,5484,0.0111326,0.214297,-0.976705,1
4249,0,0,0,0,640,158,5047,442,5489,0.00885286,0.201993,-0.979347,1
4346,0,0,0,0,665,201,5212,477,5689,0.000820729,0.170266,-0.985398,1
4508,0,0,0,0,817,194,5519,477,5996,0.0119203,0.150335,-0.988564,1
4332,0,0,0,0,660,183,5175,420,5595,0.0621736,0.177628,-0.982132,1
4859,0,0,0,0,700,208,5767,485,6252,0.0430573,0.143444,-0.988721,1
4518,0,0,0,0,707,177,5402,400,5802,0.0300009,0.109494,-0.993535,1
4478,0,0,0,0,663,174,5315,779,6094,0.00323073,0.0724836,-0.997364,1
4346,0,0,0,0,702,173,5221,910,6131,0.0120488,0.0772567,-0.996938,1
4435,0,0,0,0,701,174,5310,877,6187,0.00685911,0.0801561,-0.996759,1
4414,0,0,0,0,708,183,5305,852,6157,0.0135962,0.099642,-0.99493,1
4441,0,0,0,0,756,223,5420,861,6281,0.0236889,0.114624,-0.993126,1
4516,0,0,0,0,665,192,5373,810,6183,0.0217087,0.142343,-0.989579,1
4658,0,0,0,0,709,235,5602,384,5986,0.0912253,0.30493,-0.947996,1
4661,0,0,0,0,817,219,5697,735,6432,0.0400905,0.158334,-0.986571,1
4619,0,0,0,0,920,245,5784,671,6455,0.0604712,0.167841,-0.983958,1
4756,0,0,0,0,1044,259,6059,796,6855,0.0720988,0.144272,-0.986908,1
4628,0,0,0,0,1053,295,5976,749,6725,0.0763536,0.148569,-0.98595,1
4571,0,0,0,0,954,273,5798,585,6383,0.0733544,0.131317,-0.988623,1
4929,0,0,0,0,1019,264,6212,663,6875,0.0777308,0.148488,-0.985855,1
4822,0,0,0,0,1130,266,6218,858,7076,0.0649142,0.143592,-0.987506,1
4808,0,0,0,0,1129,263,6200,822,7022,0.0440303,0.107588,-0.99322,1
4879,0,0,0,0,1079,276,6234,707,6941,0.011335,0.056489,-0.998339,1
4947,0,0,0,0,1111,280,6338,309,6647,-0.0216575,-0.0114117,-0.9997,1
5126,0,0,0,0,1080,281,6487,492,6979,0.00643595,0.023124,-0.999712,1
5034,0,0,0,0,1059,299,6392,1688,8080,0.0214489,0.0575723,-0.998111,1
4937,0,0,0,0,1068,329,6334,468,6802,-0.0100226,-0.000364063,-0.99995,1
4932,0,0,0,0,1170,310,6412,350,6762,0.0337613,0.0965418,-0.994756,1
4939,0,0,0,0,1057,298,6294,707,7001,0.00528332,0.021548,-0.999754,1
4989,0,0,0,0,1066,287,6342,1760,8102,0.0271603,0.049379,-0.998411,1
7434,0,0,0,0,1151,318,8903,408,9311,0.00815586,0.0180713,-0.999804,1
4860,0,0,0,0,1344,279,6483,1557,8040,0.0239736,0.0540557,-0.99825,1
4929,0,0,0,0,1001,261,6191,290,6481,-0.00963599,0.0734669,-0.997251,1
5213,0,0,0,0,1114,269,6596,381,6977,-0.00603739,0.047934,-0.998832,1
4987,0,0,0,0,1016,293,6296,1649,7945,0.0316911,0.053472,-0.998067,1
5162,0,0,0,0,1108,274,6544,395,6939,-0.0158805,-0.00018822,-0.999874,1
4940,0,0,0,0,1087,258,6285,-1000,-1000,-1,-1,-1,1
4805,0,0,0,0,1133,297,6235,1589,7824,0.0179893,0.0696615,-0.997408,1
4862,0,0,0,0,1010,280,6152,401,6553,0.00801451,0.0327724,-0.999431,1
5185,0,0,0,0,1048,276,6509,1686,8195,0.0181159,0.0689309,-0.997457,1
4981,0,0,0,0,1006,270,6257,426,6683,0.00555032,0.030196,-0.999529,1
5054,0,0,0,0,1091,376,6521,1692,8213,0.0143829,0.06341,-0.997884,1
4927,0,0,0,0,1038,274,6239,371,6610,0.0296199,0.0558566,-0.998,1
4575,0,0,0,0,1194,273,6042,339,6381,0.00457744,0.0300713,-0.999537,1
4351,0,0,0,0,988,237,5576,1473,7049,0.0152225,0.0622334,-0.997946,1
4374,0,0,0,0,1018,235,5627,370,5997,0.0234113,0.0637496,-0.997691,1
4938,0,0,0,0,1058,262,6258,463,6721,0.00642308,0.0385467,-0.999236,1
4841,0,0,0,0,1194,240,6275,1458,7733,0.0200372,0.073045,-0.997128,1
4436,0,0,0,0,910,274,5620,335,5955,-0.00209269,0.0286685,-0.999587,1
4740,0,0,0,0,1040,239,6019,1660,7679,0.0171047,0.0652378,-0.997723,1
4395,0,0,0,0,1055,236,5686,334,6020,0.0248875,0.0532939,-0.998269,1
4445,0,0,0,0,1003,240,5688,381,6069,0.0262063,0.0540651,-0.998194,1
4351,0,0,0,0,967,260,5578,431,6009,0.0267413,0.0546803,-0.998146,1
4867,0,0,0,0,1138,296,6301,471,6772,0.0246818,0.050742,-0.998407,1
4420,0,0,0,0,944,236,5600,367,5967,0.0245836,0.048894,-0.998502,1
4508,0,0,0,0,1018,255,5781,294,6075,-0.0364757,-0.00538235,-0.99932,1
4482,0,0,0,0,959,264,5705,378,6083,-0.00803352,0.0257718,-0.999636,1
4390,0,0,0,0,982,295,5667,1487,7154,0.0174123,0.0587723,-0.99812,1
4537,0,0,0,0,927,271,5735,349,6084,0.0299284,0.0599769,-0.997751,1
4530,0,0,0,0,941,262,5733,370,6103,0.00382093,0.0314682,-0.999497,1
5045,0,0,0,0,1021,318,6384,1619,8003,0.014674,0.0605268,-0.998059,1
4429,0,0,0,0,950,261,5640,358,5998,0.0205033,0.0488845,-0.998594,1
4938,0,0,0,0,996,257,6191,279,6470,-0.0825394,-0.0168141,-0.996446,1
4825,0,0,0,0,1081,291,6197,545,6742,-0.0202482,0.0134453,-0.999705,1
4501,0,0,0,0,910,245,5656,302,5958,-0.0119735,0.0159108,-0.999802,1
4869,0,0,0,0,1120,272,6261,335,6596,-0.275385,-0.0125665,-0.961252,1
4934,0,0,0,0,983,274,6191,686,6877,0.0228129,0.0210496,-0.999518,1
5400,0,0,0,0,1063,300,6763,1781,8544,0.0160872,0.0620583,-0.997943,1
4593,0,0,0,0,962,239,5794,345,6139,0.0173825,0.0548084,-0.998346,1
4530,0,0,0,0,966,285,5781,249,6030,0.00920528,0.0443436,-0.998974,1
4863,0,0,0,0,1044,261,6168,1712,7880,0.00816885,0.0887735,-0.996019,1
4960,0,0,0,0,1112,260,6332,503,6835,0.00340519,0.0312407,-0.999506,1
4846,0,0,0,0,1039,278,6163,1588,7751,0.0111841,0.0761408,-0.997034,1
4968,0,0,0,0,1073,297,6338,450,6788,0.0206841,0.0532946,-0.998365,1
4861,0,0,0,0,1017,255,6133,336,6469,0.0267904,0.061857,-0.997725,1
4843,0,0,0,0,1417,258,6518,394,6912,0.00854463,0.0378136,-0.999249,1
4949,0,0,0,0,998,262,6209,1689,7898,0.0169882,0.0646798,-0.997761,1
4777,0,0,0,0,914,234,5925,311,6236,0.00556299,0.0339813,-0.999406,1
4963,0,0,0,0,1015,272,6250,1762,8012,0.0118792,0.0753834,-0.997084,1
4887,0,0,0,0,1009,258,6154,474,6628,0.0303842,0.0608647,-0.997683,1
4965,0,0,0,0,1067,260,6292,463,6755,0.0284996,0.052224,-0.998229,1
5308,0,0,0,0,1062,258,6628,457,7085,0.0259062,0.0508081,-0.998372,1
4931,0,0,0,0,1059,269,6259,410,6669,0.0270052,0.0492675,-0.99842,1
4830,0,0,0,0,1121,298,6249,397,6646,0.0256457,0.0494749,-0.998446,1
4877,0,0,0,0,1005,256,6138,431,6569,0.0194798,0.0469117,-0.998709,1
4933,0,0,0,0,1205,288,6426,368,6794,0.0223866,0.0422198,-0.998858,1
4741,0,0,0,0,919,278,5938,293,6231,0.0272842,0.0480501,-0.998472,1
4606,0,0,0,0,913,260,5779,339,6118,0.0320551,0.0469601,-0.998382,1
4528,0,0,0,0,908,240,5676,385,6061,0.00018599,0.0308641,-0.999524,1
4373,0,0,0,0,976,258,5607,1734,7341,0.0125559,0.0797445,-0.996736,1
4888,0,0,0,0,1049,302,6239,450,6689,0.00390229,0.0374892,-0.999289,1
5449,0,0,0,0,1083,304,6836,1687,8523,0.0166876,0.0696088,-0.997435,1
4956,0,0,0,0,1030,276,6262,391,6653,0.00796803,0.0363877,-0.999306,1
5206,0,0,0,0,1073,273,6552,1724,8276,0.0126025,0.0759934,-0.997029,1
4921,0,0,0,0,1076,297,6294,457,6751,0.00447943,0.0439923,-0.999022,1
5119,0,0,0,0,1054,299,6472,1633,8105,0.00788252,0.0695057,-0.997551,1
4608,0,0,0,0,963,259,5830,325,6155,0.00277918,0.0376272,-0.999288,1
4935,0,0,0,0,1044,298,6277,1632,7909,0.0149256,0.0710882,-0.997358,1
4576,0,0,0,0,943,230,5749,402,6151,0.0129956,0.0434338,-0.998972,1
5026,0,0,0,0,1049,292,6367,1562,7929,0.0164516,0.0732026,-0.997182,1
5307,0,0,0,0,992,269,6568,410,6978,-0.00361177,0.0229587,-0.99973,1
5050,0,0,0,0,1068,267,6385,1708,8093,0.0119755,0.073669,-0.997211,1
4542,0,0,0,0,990,265,5797,373,6170,0.00772651,0.0286735,-0.999559,1
4413,0,0,0,0,1023,267,5703,1510,7213,0.0113254,0.0794177,-0.996777,1
4395,0,0,0,0,1015,312,5722,446,6168,0.00110738,0.0321835,-0.999481,2
4494,0,0,0,0,998,265,5757,1597,7354,0.0173121,0.0587506,-0.998122,2
4336,0,0,0,0,992,230,5558,346,5904,0.0249084,0.060317,-0.997868,2
4399,0,0,0,0,984,270,5653,461,6114,0.0168763,0.0462661,-0.998787,2
4374,0,0,0,0,923,242,5539,1521,7060,0.012122,0.0793109,-0.996777,2
4883,0,0,0,0,1023,300,6206,512,6718,0.0216329,0.0556701,-0.998215,2
5971,0,0,0,0,1057,260,7288,324,7612,0.0289193,0.056232,-0.997999,2
1368,0,0,0,0,265,69,1702,108,1810,0.0277195,0.0556435,-0.998066,2
2524,0,0,0,0,548,136,3208,239,3447,0.0142344,0.0386452,-0.999152,2
4459,0,0,0,0,1110,235,5804,1579,7383,0.0153255,0.072707,-0.997236,2
5415,0,0,0,0,1113,261,6789,482,7271,0.024501,0.0471656,-0.998586,2
4395,0,0,0,0,998,233,5626,349,5975,0.0243419,0.0450224,-0.99869,2
4420,0,0,0,0,936,256,5612,287,5899,-0.0117117,0.0108412,-0.999873,2
4801,0,0,0,0,1049,271,6121,318,6439,0.0532923,0.020951,-0.998359,2
4359,0,0,0,0,945,244,5548,359,5907,0.00165859,0.016503,-0.999863,2
4994,0,0,0,0,1082,268,6344,1697,8041,0.0120942,0.0750546,-0.997106,2
4892,0,0,0,0,1012,268,6172,432,6604,0.00537816,0.04273,-0.999072,2
4925,0,0,0,0,1045,298,6268,1673,7941,0.0147332,0.0782324,-0.996826,2
4871,0,0,0,0,1040,281,6192,488,6680,0.0247772,0.0588049,-0.997962,2
4975,0,0,0,0,1061,296,6332,454,6786,-0.000455971,0.0243487,-0.999703,2
5025,0,0,0,0,1118,264,6407,1660,8067,0.0125603,0.0684822,-0.997573,2
5064,0,0,0,0,1009,320,6393,413,6806,0.00374619,0.0319899,-0.999481,2
4957,0,0,0,0,1074,274,6305,1751,8056,0.0163808,0.067939,-0.997555,2
4923,0,0,0,0,1029,302,6254,454,6708,-0.00142941,0.0248215,-0.999691,2
4928,0,0,0,0,1029,264,6221,1693,7914,0.0115236,0.0713003,-0.997388,2
4996,0,0,0,0,1011,260,6267,460,6727,0.0210118,0.044982,-0.998767,2
5171,0,0,0,0,1050,296,6517,368,6885,0.02483,0.0413397,-0.998837,2
5019,0,0,0,0,1009,316,6344,363,6707,0.0309937,0.0481016,-0.998361,2
5973,0,0,0,0,1073,292,7338,426,7764,0.0278616,0.0454537,-0.998578,2
5750,0,0,0,0,734,197,6681,355,7036,-0.0134992,0.00608325,-0.99989,2
3672,0,0,0,0,701,188,4561,197,4758,-0.0867035,0.00544354,-0.99622,2
5284,0,0,0,0,1049,299,6632,596,7228,-0.0130057,0.00538789,-0.999901,2
4941,0,0,0,0,1068,326,6335,304,6639,-0.119878,0.00768011,-0.992759,2
5134,0,0,0,0,1041,276,6451,641,7092,-0.0209752,0.0113329,-0.999716,2
4516,0,0,0,0,951,232,5699,346,6045,-0.0991064,0.00576035,-0.99506,2
4680,0,0,0,0,984,232,5896,639,6535,-0.0162144,0.0018747,-0.999867,2
4816,0,0,0,0,905,231,5952,258,6210,-0.104534,0.00889418,-0.994482,2
5072,0,0,0,0,915,258,6245,637,6882,-0.016329,0.0107498,-0.999809,2
5039,0,0,0,0,1019,276,6334,303,6637,-0.284923,-0.0136912,-0.958453,2
4995,0,0,0,0,1033,285,6313,573,6886,0.0136204,0.0119563,-0.999836,2
5034,0,0,0,0,1065,265,6364,1791,8155,0.0132148,0.0606546,-0.998071,2
5335,0,0,0,0,1226,318,6879,431,7310,-0.00207118,0.0134625,-0.999907,2
4895,0,0,0,0,1076,285,6256,1771,8027,0.0132118,0.0674331,-0.997636,2
5011,0,0,0,0,1094,263,6368,430,6798,0.00843778,0.0263172,-0.999618,2
5757,0,0,0,0,1102,300,7159,1874,9033,0.0116101,0.0680734,-0.997613,2
5006,0,0,0,0,1073,297,6376,431,6807,0.0226721,0.0388537,-0.998988,2
5468,0,0,0,0,1070,279,6817,338,7155,0.00975725,0.0231873,-0.999683,2
5047,0,0,0,0,1080,301,6428,1700,8128,0.0172243,0.0574053,-0.998202,2
4984,0,0,0,0,1021,322,6327,408,6735,0.024535,0.040975,-0.998859,2
5003,0,0,0,0,1086,280,6369,384,6753,0.0277805,0.0382666,-0.998881,2
4945,0,0,0,0,1072,276,6293,386,6679,0.00310196,0.0139235,-0.999898,2
4904,0,0,0,0,1159,310,6373,1696,8069,0.0171223,0.060506,-0.998021,2
4896,0,0,0,0,991,253,6140,373,6513,0.0237753,0.0434117,-0.998774,2
5068,0,0,0,0,1022,275,6365,495,6860,0.00143603,0.0117063,-0.99993,2
5008,0,0,0,0,1099,282,6389,1751,8140,0.0114137,0.0698551,-0.997492,2
5093,0,0,0,0,1082,280,6455,451,6906,0.0203087,0.0326638,-0.99926,2
5148,0,0,0,0,1101,294,6543,1778,8321,0.00853974,0.072124,-0.997359,2
5144,0,0,0,0,1071,285,6500,562,7062,0.00349616,0.0207825,-0.999778,2
5043,0,0,0,0,1161,298,6502,1735,8237,0.0102729,0.0696925,-0.997515,2
5098,0,0,0,0,1068,275,6441,484,6925,0.00228453,0.0218447,-0.999759,2
5106,0,0,0,0,1076,317,6499,1818,8317,0.0156025,0.0510512,-0.998574,2
5003,0,0,0,0,1181,336,6520,397,6917,0.024028,0.0363296,-0.999051,2
4991,0,0,0,0,1095,261,6347,361,6708,0.0385476,0.0286606,-0.998846,2
4948,0,0,0,0,1185,272,6405,398,6803,0.0119527,0.00982514,-0.99988,2
5016,0,0,0,0,1059,299,6374,1762,8136,0.0155884,0.0580613,-0.998191,2
4957,0,0,0,0,1079,301,6337,399,6736,0.0230611,0.0365606,-0.999065,2
4964,0,0,0,0,1170,300,6434,337,6771,0.0284286,0.0144264,-0.999492,2
4490,0,0,0,0,953,270,5713,1704,7417,0.0211671,0.0564888,-0.998179,2
4995,0,0,0,0,1100,300,6395,438,6833,0.00355307,0.0174741,-0.999841,2
5067,0,0,0,0,1089,302,6458,1804,8262,0.0173135,0.0542417,-0.998378,2
5048,0,0,0,0,1091,274,6413,375,6788,0.00519629,0.019165,-0.999803,2
4996,0,0,0,0,1079,300,6375,2114,8489,0.00834896,0.0724046,-0.997341,2
5058,0,0,0,0,1134,273,6465,573,7038,-0.00109694,0.0153157,-0.999882,2
5153,0,0,0,0,1058,302,6513,1767,8280,0.0113817,0.0605738,-0.998099,2
5146,0,0,0,0,1451,317,6914,399,7313,0.00409291,0.0259174,-0.999656,2
5274,0,0,0,0,1059,290,6623,1740,8363,0.0136923,0.0664084,-0.997698,2
5055,0,0,0,0,1097,313,6465,591,7056,0.0186177,0.0459591,-0.99877,2
5097,0,0,0,0,1070,274,6441,376,6817,-0.0173598,-0.000342336,-0.999849,2
4638,0,0,0,0,1002,264,5904,350,6254,-0.136353,-0.00417235,-0.990652,2
4646,0,0,0,0,928,237,5811,544,6355,-0.0341864,-0.00762433,-0.999386,2
4682,0,0,0,0,918,235,5835,331,6166,-0.00287025,0.00700839,-0.999971,2
4505,0,0,0,0,962,260,5727,1674,7401,0.015587,0.0633486,-0.99787,2
5033,0,0,0,0,1004,260,6297,466,6763,0.0202045,0.0365647,-0.999127,2
5174,0,0,0,0,1404,268,6846,438,7284,0.0234601,0.0284806,-0.999319,2
5112,0,0,0,0,1015,258,6385,397,6782,0.0213943,0.0138745,-0.999675,2
5221,0,0,0,0,1039,299,6559,300,6859,0.000481804,-0.00668141,-0.999978,2
4477,0,0,0,0,985,266,5728,1733,7461,0.018506,0.0529167,-0.998428,2
5870,0,0,0,0,1302,267,7439,425,7864,-0.00652008,0.00695474,-0.999955,2
4965,0,0,0,0,1329,418,6712,2074,8786,0.0181552,0.0544752,-0.99835,2
4538,0,0,0,0,1031,354,5923,490,6413,0.02426,0.0411949,-0.998857,2
4528,0,0,0,0,919,242,5689,342,6031,-0.00921353,0.00315277,-0.999953,2
5176,0,0,0,0,1023,259,6458,318,6776,0.0210283,-0.0472264,-0.998663,2
5836,0,0,0,0,1019,268,7123,1784,8907,0.0137434,0.0555167,-0.998363,2
5210,0,0,0,0,1091,273,6574,449,7023,0.00452902,0.0186784,-0.999815,2
4565,0,0,0,0,1299,314,6178,1663,7841,0.0138122,0.0564738,-0.998309,2
5233,0,0,0,0,1086,296,6615,463,7078,-0.00500695,0.0071173,-0.999962,2
4986,0,0,0,0,1431,362,6779,1942,8721,0.0107674,0.0491592,-0.998733,2
4983,0,0,0,0,915,234,6132,370,6502,0.0198152,0.0387768,-0.999052,2
5132,0,0,0,0,1031,296,6459,451,6910,0.0264486,0.0456151,-0.998609,2
4662,0,0,0,0,1002,273,5937,407,6344,0.0257568,0.0337417,-0.999099,2
5253,0,0,0,0,1034,263,6550,465,7015,-0.00975791,-0.00504247,-0.99994,2
5560,0,0,0,0,1164,287,7011,-1000,-1000,-1,-1,-1,2
5048,0,0,0,0,1021,264,6333,1812,8145,0.0141493,0.0670242,-0.997651,2
5207,0,0,0,0,1106,270,6583,655,7238,-0.00386471,0.00764288,-0.999963,2
5012,0,0,0,0,1123,268,6403,1754,8157,0.0151356,0.0582234,-0.998189,2
5088,0,0,0,0,1037,323,6448,415,6863,0.000884132,0.0189243,-0.999821,2
4924,0,0,0,0,922,280,6126,1644,7770,0.0159806,0.0470522,-0.998765,2
5358,0,0,0,0,1066,263,6687,441,7128,-0.0109474,0.00123407,-0.999939,2
5245,0,0,0,0,1056,291,6592,296,6888,-0.169683,0.129766,-0.976918,2
5191,0,0,0,0,1081,296,6568,692,7260,-0.0385792,0.017878,-0.999096,2
5052,0,0,0,0,1025,262,6339,503,6842,-0.0231844,0.0440219,-0.998761,2
5464,0,0,0,0,1038,261,6763,386,7149,-0.0110192,0.0314623,-0.999444,2
5195,0,0,0,0,1025,260,6480,359,6839,-0.112275,0.190151,-0.975314,2
5165,0,0,0,0,1223,298,6686,777,7463,-0.01601,0.0285202,-0.999465,2
5118,0,0,0,0,1058,294,6470,428,6898,0.00900023,-0.00715297,-0.999934,2
4824,0,0,0,0,1395,377,6596,1953,8549,0.0178474,0.0465244,-0.998758,2
3348,0,0,0,0,689,186,4223,267,4490,-0.00671986,0.000389195,-0.999977,2
5978,0,0,0,0,1074,285,7337,312,7649,-0.0112766,-0.0170076,-0.999792,2
5062,0,0,0,0,1026,269,6357,322,6679,-0.249874,0.259932,-0.932737,2
5072,0,0,0,0,1090,265,6427,770,7197,0.0158723,0.00194585,-0.999872,2
5110,0,0,0,0,1023,285,6418,1771,8189,0.0131394,0.0571561,-0.998279,2
5158,0,0,0,0,1503,269,6930,566,7496,-0.00848479,0.00641224,-0.999944,2
5265,0,0,0,0,1496,349,7110,1833,8943,0.0119708,0.0534576,-0.998498,2
5682,0,0,0,0,1297,267,7246,496,7742,-0.0166292,-0.00710231,-0.999837,2
5028,0,0,0,0,1033,262,6323,355,6678,-0.314811,0.387376,-0.866506,2
5127,0,0,0,0,1061,263,6451,680,7131,0.0416852,0.005656,-0.999115,2
5057,0,0,0,0,1220,300,6577,477,7054,-0.00472682,-0.0110462,-0.999928,2
5093,0,0,0,0,1039,272,6404,1750,8154,0.0140156,0.0533975,-0.998475,2
4983,0,0,0,0,1164,303,6450,486,6936,-0.00997357,0.0052426,-0.999937,2
5479,0,0,0,0,1111,269,6859,1825,8684,0.0141653,0.0485955,-0.998718,2
4802,0,0,0,0,964,267,6033,364,6397,-0.016946,-0.00582207,-0.99984,2
5100,0,0,0,0,1147,296,6543,372,6915,-0.174917,0.119165,-0.977345,2
5183,0,0,0,0,1071,291,6545,612,7157,-0.0413659,0.0195696,-0.998952,2
4787,0,0,0,0,1121,268,6176,392,6568,-0.0250565,0.0428586,-0.998767,2
4722,0,0,0,0,1050,264,6036,330,6366,-0.0121423,0.0267735,-0.999568,2
5475,0,0,0,0,1097,317,6889,1877,8766,0.0154988,0.0477955,-0.998737,2
4935,0,0,0,0,987,269,6191,414,6605,-0.00969419,0.00454982,-0.999943,2
4904,0,0,0,0,1004,250,6158,1665,7823,0.0125053,0.0499544,-0.998673,2
4343,0,0,0,0,839,225,5407,396,5803,-0.0128761,-0.000451945,-0.999917,2
5460,0,0,0,0,1075,286,6821,312,7133,-0.0669718,-0.000863463,-0.997754,2
5073,0,0,0,0,1095,328,6496,567,7063,-0.0174195,0.00320383,-0.999843,2
5236,0,0,0,0,999,271,6506,295,6801,0.0120841,0.016784,-0.999786,2
4988,0,0,0,0,1165,281,6434,1828,8262,0.00961383,0.0584793,-0.998242,2
4583,0,0,0,0,1003,290,5876,480,6356,0.0184906,0.0390948,-0.999065,2
4955,0,0,0,0,1002,248,6205,332,6537,-0.00230902,0.00549031,-0.999982,2
4621,0,0,0,0,924,314,5859,1577,7436,0.00770083,0.0628135,-0.997996,2
4529,0,0,0,0,936,236,5701,509,6210,-0.00442093,0.00898329,-0.99995,2
5662,0,0,0,0,1234,282,7178,1734,8912,0.0139005,0.0505805,-0.998623,2
5016,0,0,0,0,978,278,6272,455,6727,-0.0102341,-0.00437263,-0.999938,2
5606,0,0,0,0,1100,302,7008,291,7299,-0.371362,0.325201,-0.869675,2
4676,0,0,0,0,959,258,5893,612,6505,0.0447037,-0.0158547,-0.998875,2
4544,0,0,0,0,1241,247,6032,311,6343,-0.0226995,-0.00254549,-0.999739,2
5294,0,0,0,0,1063,296,6653,299,6952,0.0364959,0.019895,-0.999136,2
5134,0,0,0,0,1074,278,6486,424,6910,-0.0123409,-0.0141289,-0.999824,2
5468,0,0,0,0,1062,263,6793,298,7091,-0.371133,0.37445,-0.849734,2
4521,0,0,0,0,985,238,5744,629,6373,0.0305216,0.00289081,-0.99953,2
5159,0,0,0,0,1094,337,6590,294,6884,-0.0606642,0.00117647,-0.998157,2
4597,0,0,0,0,962,264,5823,501,6324,-0.0195842,0.0154244,-0.999689,2
4979,0,0,0,0,980,278,6237,244,6481,-0.0476178,0.0136822,-0.998772,2
5069,0,0,0,0,997,274,6340,436,6776,-0.0155463,0.030992,-0.999399,2
4643,0,0,0,0,969,249,5861,332,6193,-0.0158559,0.0271361,-0.999506,2
5077,0,0,0,0,1106,290,6473,396,6869,0.00720466,-0.00501296,-0.999962,2
4874,0,0,0,0,974,323,6171,2062,8233,0.0132597,0.0539248,-0.998457,2
4736,0,0,0,0,1003,314,6053,564,6617,-0.00997437,0.00117488,-0.99995,2
5380,0,0,0,0,1070,305,6755,1801,8556,0.0129306,0.0504589,-0.998642,2
4527,0,0,0,0,992,302,5821,525,6346,-0.0139885,-0.00745319,-0.999874,2
2596,0,0,0,0,537,149,3282,-1000,-1000,-1,-1,-1,2
4810,0,0,0,0,1187,256,6253,1549,7802,0.0117898,0.0566718,-0.998324,2
4687,0,0,0,0,956,254,5897,464,6361,0.0152957,0.0235842,-0.999605,2
5203,0,0,0,0,1306,295,6804,309,7113,-0.00773667,-0.00850898,-0.999934,2
5249,0,0,0,0,1031,276,6556,321,6877,-0.283576,0.307568,-0.908288,2
5167,0,0,0,0,1259,267,6693,740,7433,0.0327717,-0.00803244,-0.999431,2
5223,0,0,0,0,1024,315,6562,350,6912,0.0338506,-0.0278487,-0.999039,2
4972,0,0,0,0,1113,287,6372,1802,8174,0.01125,0.0591972,-0.998183,2
5096,0,0,0,0,1085,293,6474,574,7048,-0.0060946,0.00284841,-0.999978,2
5104,0,0,0,0,1110,308,6522,1777,8299,0.0153751,0.0418677,-0.999005,2
4598,0,0,0,0,931,270,5799,430,6229,-0.0165334,-0.0144108,-0.999759,2
4813,0,0,0,0,982,255,6050,1538,7588,0.0103305,0.0536593,-0.998506,2
5829,0,0,0,0,1092,306,7227,515,7742,-0.0154943,-0.0126765,-0.999799,2
5112,0,0,0,0,1127,282,6521,320,6841,-0.166398,0.158305,-0.973268,2
4710,0,0,0,0,1325,261,6296,776,7072,-0.00809183,0.00088068,-0.999967,2
5218,0,0,0,0,968,279,6465,1619,8084,0.0107601,0.047277,-0.998824,2
4566,0,0,0,0,1058,274,5898,439,6337,0.0195054,0.0319503,-0.999299,2
5411,0,0,0,0,1110,273,6794,428,7222,-0.00386839,0.00132961,-0.999992,2
4632,0,0,0,0,990,261,5883,1634,7517,0.00853508,0.0567618,-0.998351,2
5039,0,0,0,0,1499,350,6888,533,7421,-0.00883449,-0.00451077,-0.999951,2
4639,0,0,0,0,980,268,5887,1520,7407,0.0133981,0.0469779,-0.998806,2
4593,0,0,0,0,911,235,5739,383,6122,-0.0123701,-0.00533929,-0.999909,2
5009,0,0,0,0,1117,319,6445,1657,8102,0.00763828,0.0630466,-0.997981,2
5831,0,0,0,0,1193,298,7322,543,7865,-0.0097122,0.00496625,-0.99994,2
5146,0,0,0,0,1101,302,6549,1740,8289,0.0117018,0.0510846,-0.998626,2
5776,0,0,0,0,1105,270,7151,470,7621,-0.00205384,0.00775839,-0.999968,2
4535,0,0,0,0,1290,258,6083,1641,7724,0.0201617,0.0461772,-0.99873,2
4862,0,0,0,0,985,275,6122,450,6572,-0.00653491,-0.000301946,-0.999979,2
5823,0,0,0,0,1156,278,7257,1685,8942,0.0185789,0.0340783,-0.999247,2
5087,0,0,0,0,989,245,6321,379,6700,-0.00210177,-0.0238658,-0.999713,2
5156,0,0,0,0,1067,270,6493,1554,8047,0.0196834,0.0454823,-0.998771,2
4560,0,0,0,0,940,266,5766,399,6165,-0.0143792,-0.0112079,-0.999834,2
5188,0,0,0,0,1111,299,6598,1588,8186,0.00381228,0.0344561,-0.999399,2
5081,0,0,0,0,1057,302,6440,430,6870,0.0165309,0.0508381,-0.99857,2
4993,0,0,0,0,1038,239,6270,469,6739,-0.0196138,0.0297987,-0.999364,2
4972,0,0,0,0,1125,285,6382,314,6696,-0.1996,0.0626296,-0.977874,2
5150,0,0,0,0,1018,278,6446,599,7045,0.0194631,0.0395283,-0.999029,2
5567,0,0,0,0,1156,342,7065,573,7638,0.00276777,0.0643525,-0.997924,2
5110,0,0,0,0,1148,309,6567,416,6983,-0.00965944,0.125681,-0.992024,2
5447,0,0,0,0,1059,252,6758,581,7339,-0.0162233,0.105961,-0.994238,2
5118,0,0,0,0,1037,267,6422,534,6956,-0.0169576,0.159977,-0.986975,2
4990,0,0,0,0,893,214,6097,751,6848,-0.0158411,0.116913,-0.993016,2
5374,0,0,0,0,725,211,6310,608,6918,-0.0129439,0.129314,-0.991519,2
5066,0,0,0,0,719,178,5963,742,6705,-0.00851795,0.234418,-0.972099,2
5065,0,0,0,0,698,211,5974,721,6695,-0.00890448,0.238827,-0.971021,2
3128,0,0,0,0,414,102,3644,515,4159,0.000811967,0.154007,-0.98807,2
2380,0,0,0,0,296,77,2753,601,3354,0.0105509,0.10021,-0.994911,2
5314,0,0,0,0,491,150,5955,1217,7172,0.00722666,0.101957,-0.994763,2
4392,0,0,0,0,461,138,4991,1205,6196,0.0178008,0.104122,-0.994405,2
4859,0,0,0,0,485,185,5529,1351,6880,0.0286029,0.0919178,-0.995356,2
4756,0,0,0,0,420,115,5291,1383,6674,0.0317325,0.122589,-0.99195,2
5208,0,0,0,0,387,120,5715,1445,7160,0.0347799,0.113333,-0.992948,2
4794,0,0,0,0,325,108,5227,1418,6645,0.032569,0.124739,-0.991655,2
4567,0,0,0,0,315,111,4993,1542,6535,0.0322477,0.117459,-0.992554,2
4337,0,0,0,0,235,68,4640,1496,6136,0.0266945,0.156107,-0.987379,2
4410,0,0,0,0,252,77,4739,1534,6273,0.0249272,0.116125,-0.992922,2
3951,0,0,0,0,196,57,4204,1376,5580,0.00762509,0.0978368,-0.995173,2
3986,0,0,0,0,217,69,4272,1567,5839,-0.00462706,0.0703593,-0.997511,2
4145,0,0,0,0,160,65,4370,1556,5926,-0.0219074,0.0905125,-0.995654,2
1766,0,0,0,0,77,29,1872,640,2512,-0.0314924,0.0813431,-0.996189,2
3644,0,0,0,0,202,63,3909,1491,5400,-0.0422641,0.0959439,-0.994489,2
3922,0,0,0,0,215,68,4205,1483,5688,-0.0315963,0.0998811,-0.994498,2
4184,0,0,0,0,316,83,4583,1695,6278,-0.0165189,0.0688153,-0.997493,2
3774,0,0,0,0,234,71,4079,1494,5573,-0.00207332,0.0427893,-0.999082,2
4382,0,0,0,0,323,87,4792,1714,6506,0.00947252,0.0258177,-0.999622,2
4186,0,0,0,0,447,133,4766,2372,7138,0.0211069,0.0181512,-0.999613,2
4352,0,0,0,0,405,109,4866,1918,6784,0.0363432,0.0200458,-0.999138,2
4209,0,0,0,0,733,190,5132,1908,7040,0.0483622,0.019419,-0.998641,2
4219,0,0,0,0,648,163,5030,1237,6267,0.0912192,-0.0101821,-0.995779,2
6139,0,0,0,0,964,247,7350,1895,9245,0.0971416,0.007684,-0.995241,2
4991,0,0,0,0,1393,429,6813,1592,8405,0.110157,0.0191034,-0.993731,2
6236,0,0,0,0,1410,335,7981,989,8970,0.121775,0.0512747,-0.991233,2
6307,0,0,0,0,1522,330,8159,1754,9913,0.0972221,0.168774,-0.980848,2
5573,0,0,0,0,1342,331,7246,2942,10188,0.0784465,0.232093,-0.969525,2
6483,0,0,0,0,1582,390,8455,2982,11437,0.0696463,0.319639,-0.944976,2
5438,0,0,0,0,1322,377,7137,2424,9561,0.0740274,0.37453,-0.924255,2
5457,0,0,0,0,1256,315,7028,2312,9340,0.0762304,0.416279,-0.906036,2
5208,0,0,0,0,1047,261,6516,2096,8612,0.0747331,0.456847,-0.8864,2
5953,0,0,0,0,1071,235,7259,1790,9049,0.0720383,0.512888,-0.855428,2
5926,0,0,0,0,939,228,7093,1737,8830,0.0549736,0.570374,-0.819544,2
5719,0,0,0,0,827,205,6751,1473,8224,0.0505177,0.639513,-0.767119,2
5223,0,0,0,0,800,200,6223,-1000,-1000,-1,-1,-1,2
4697,0,0,0,0,792,189,5678,1440,7118,-0.0364304,0.096701,-0.994647,2
4762,0,0,0,0,701,209,5672,1676,7348,-0.0625772,0.160022,-0.985128,2
5738,0,0,0,0,701,205,6644,1755,8399,-0.044452,0.156427,-0.986689,2
5211,0,0,0,0,757,160,6128,1683,7811,-0.0455384,0.201574,-0.978414,2
4355,0,0,0,0,525,137,5017,1562,6579,-0.0403452,0.209679,-0.976938,2
4075,0,0,0,0,537,148,4760,1469,6229,-0.0575388,0.286489,-0.956355,2
3990,0,0,0,0,519,156,4665,1384,6049,-0.061179,0.243737,-0.96791,2
3905,0,0,0,0,459,128,4492,1493,5985,-0.0546297,0.166191,-0.984579,2
3938,0,0,0,0,508,127,4573,1449,6022,-0.0596675,0.178387,-0.982149,2
3990,0,0,0,0,543,125,4658,1353,6011,-0.06086,0.163033,-0.984742,2
3976,0,0,0,0,563,133,4672,1308,5980,-0.069614,0.198309,-0.977664,2
4079,0,0,0,0,470,152,4701,1701,6402,-0.0651402,0.230457,-0.9709,2
3993,0,0,0,0,538,159,4690,1297,5987,-0.0404812,0.223188,-0.973934,2
5009,0,0,0,0,559,163,5731,1229,6960,-0.0372528,0.219037,-0.975005,2
4138,0,0,0,0,577,155,4870,1241,6111,-0.013666,0.237038,-0.971404,2
4346,0,0,0,0,726,210,5282,1246,6528,-0.00562648,0.267897,-0.963431,2
4669,0,0,0,0,945,257,5871,1277,7148,0.00978646,0.275589,-0.961226,2
4737,0,0,0,0,1050,280,6067,1156,7223,0.00653574,0.258908,-0.96588,2
5020,0,0,0,0,1156,308,6484,1382,7866,-0.011092,0.265299,-0.964103,2
5388,0,0,0,0,1252,353,6993,1436,8429,-0.0211475,0.234622,-0.971857,2
5659,0,0,0,0,1327,317,7303,896,8199,-0.0331684,0.268177,-0.962799,2
5332,0,0,0,0,1061,284,6677,714,7391,-0.0470355,0.274366,-0.960474,2
5336,0,0,0,0,974,249,6559,844,7403,-0.0470841,0.22229,-0.973843,2
4885,0,0,0,0,829,226,5940,817,6757,-0.02501,0.160823,-0.986666,2
4952,0,0,0,0,749,200,5901,928,6829,-0.0249396,0.154365,-0.987699,2
4906,0,0,0,0,615,174,5695,935,6630,-0.032914,0.175942,-0.98385,2
4950,0,0,0,0,494,138,5582,949,6531,-0.01418,0.170131,-0.985319,2
4625,0,0,0,0,406,108,5139,890,6029,-0.00441896,0.12536,-0.992102,2
4594,0,0,0,0,401,122,5117,830,5947,0.00114247,0.121668,-0.99257,2
4938,0,0,0,0,411,137,5486,702,6188,-0.0132164,0.119676,-0.992725,2
4915,0,0,0,0,395,149,5459,670,6129,-0.0333847,0.150096,-0.988108,2
3353,0,0,0,0,303,96,3752,627,4379,-0.054563,0.165843,-0.984642,2
4760,0,0,0,0,486,140,5386,1410,6796,-0.0643907,0.187097,-0.980229,2
4707,0,0,0,0,462,122,5291,1608,6899,-0.0435772,0.160828,-0.98602,2
4666,0,0,0,0,392,111,5169,1607,6776,-0.0375615,0.190383,-0.980991,2
4533,0,0,0,0,369,131,5033,1750,6783,-0.0279464,0.157353,-0.987147,2
4668,0,0,0,0,333,108,5109,1700,6809,-0.0289234,0.163197,-0.98617,2
4481,0,0,0,0,327,106,4914,1680,6594,-0.00561867,0.146395,-0.98921,2
7123,0,0,0,0,460,130,7713,2200,9913,0.00766448,0.132304,-0.99118,2
4512,0,0,0,0,319,101,4932,1721,6653,-0.00759065,0.145785,-0.989287,2
4683,0,0,0,0,293,111,5087,1692,6779,-0.0225637,0.125642,-0.991819,2
4359,0,0,0,0,265,81,4705,1508,6213,-0.0113654,0.0712212,-0.997396,2
4837,0,0,0,0,261,77,5175,1532,6707,-0.0100958,0.0337325,-0.99938,2
4245,0,0,0,0,263,75,4583,1650,6233,-0.0209427,0.046548,-0.998696,2
4492,0,0,0,0,272,79,4843,1593,6436,-0.0232612,0.0633261,-0.997722,2
4260,0,0,0,0,299,83,4642,1620,6262,-0.02126,0.068803,-0.997404,2
4457,0,0,0,0,394,95,4946,1445,6391,-0.00802212,0.1121,-0.993665,2
4396,0,0,0,0,449,109,4954,1226,6180,0.014086,0.120618,-0.992599,2
4582,0,0,0,0,526,128,5236,978,6214,0.0683593,0.103767,-0.99225,2
5013,0,0,0,0,562,147,5722,1488,7210,0.106696,0.0737311,-0.991554,2
4833,0,0,0,0,738,174,5745,2216,7961,0.1293,0.0704815,-0.989098,2
5025,0,0,0,0,967,203,6195,2546,8741,0.144062,0.110018,-0.983434,2
5373,0,0,0,0,904,229,6506,1864,8370,0.145979,0.0621049,-0.987336,2
2720,0,0,0,0,559,153,3432,1465,4897,0.138196,0.0283688,-0.989999,2
5287,0,0,0,0,1184,298,6769,2571,9340,0.123771,0.0238511,-0.992024,2
5430,0,0,0,0,1234,323,6987,2730,9717,0.115496,0.0305851,-0.992837,2
5964,0,0,0,0,1346,332,7642,2329,9971,0.106323,0.0383734,-0.993591,2
5844,0,0,0,0,1473,364,7681,2242,9923,0.103226,0.0410754,-0.99381,2
6313,0,0,0,0,1671,414,8398,2033,10431,0.0960798,0.0578142,-0.993693,2
6067,0,0,0,0,1638,380,8085,1046,9131,0.0997736,0.0376626,-0.994297,2
4556,0,0,0,0,1159,311,6026,1060,7086,0.116467,0.0614904,-0.991289,2
6323,0,0,0,0,1716,424,8463,1586,10049,0.129204,0.110863,-0.985401,2
6400,0,0,0,0,1782,429,8611,2538,11149,0.0774933,0.184144,-0.97984,2
6389,0,0,0,0,1771,438,8598,3552,12150,0.0505332,0.162663,-0.985387,2
6282,0,0,0,0,1757,428,8467,2755,11222,0.0303054,0.142567,-0.989321,2
5859,0,0,0,0,1563,383,7805,3408,11213,0.020634,0.12247,-0.992258,2
6306,0,0,0,0,1752,420,8478,3577,12055,0.0137686,0.111607,-0.993657,2
6444,0,0,0,0,1779,438,8661,3579,12240,0.00902115,0.130672,-0.991385,2
4446,0,0,0,0,1261,306,6013,2637,8650,0.00701291,0.146821,-0.989138,2
6181,0,0,0,0,1569,405,8155,3550,11705,-0.0020698,0.159221,-0.987241,2
5633,0,0,0,0,1473,361,7467,3937,11404,-0.0055564,0.16,-0.987102,2
5589,0,0,0,0,1464,356,7409,3854,11263,-0.0101483,0.155894,-0.987722,2
6162,0,0,0,0,1583,381,8126,4571,12697,-0.0103083,0.144762,-0.989413,2
4246,0,0,0,0,1010,265,5521,2987,8508,-0.00837559,0.118216,-0.992953,2
5623,0,0,0,0,1282,317,7222,3705,10927,-0.00768554,0.103013,-0.99465,2
6135,0,0,0,0,1437,384,7956,4061,12017,-0.00828287,0.0910022,-0.995816,2
6069,0,0,0,0,1397,377,7843,3998,11841,-0.00721992,0.0845828,-0.99639,2
6029,0,0,0,0,1389,342,7760,4007,11767,-0.0117155,0.0795768,-0.99676,2
4865,0,0,0,0,965,295,6125,2147,8272,-0.0154174,0.0769095,-0.996919,2
2604,0,0,0,0,538,123,3265,1377,4642,-0.0196269,0.0755638,-0.996948,2
2336,0,0,0,0,538,144,3018,1525,4543,-0.0191752,0.0759323,-0.996928,2
6669,0,0,0,0,1379,370,8418,4126,12544,-0.0194881,0.0755406,-0.996952,2
6037,0,0,0,0,1401,339,7777,3967,11744,-0.0196082,0.0753597,-0.996964,2
4607,0,0,0,0,1049,191,5847,2123,7970,-0.019817,0.0728785,-0.997144,2
6098,0,0,0,0,1112,263,7473,2833,10306,-0.0195029,0.0715143,-0.997249,2
3199,0,0,0,0,728,194,4121,2203,6324,-0.022203,0.0706807,-0.997252,2
6263,0,0,0,0,1411,341,8015,3898,11913,-0.0211056,0.0686073,-0.99742,2
6003,0,0,0,0,1529,378,7910,3562,11472,-0.0227199,0.0684026,-0.997399,2
6054,0,0,0,0,1428,344,7826,3680,11506,-0.0259674,0.0688298,-0.997291,2
6066,0,0,0,0,1388,341,7795,3544,11339,-0.0278882,0.0707903,-0.997101,2
4145,0,0,0,0,1042,237,5424,2568,7992,-0.0292517,0.0710719,-0.997042,2
6070,0,0,0,0,1539,393,8002,3984,11986,-0.0304992,0.0702541,-0.997063,2
6204,0,0,0,0,1422,346,7972,3948,11920,-0.0299528,0.0704988,-0.997062,2
4179,0,0,0,0,788,182,5149,2208,7357,-0.0278453,0.0719268,-0.997021,2
3951,0,0,0,0,758,207,4916,2062,6978,-0.0279551,0.0711129,-0.997076,2
2542,0,0,0,0,608,161,3311,1666,4977,-0.0271216,0.0699868,-0.997179,2
6242,0,0,0,0,1471,377,8090,3923,12013,-0.0252064,0.0695624,-0.997259,2
6633,0,0,0,0,1719,378,8730,3783,12513,-0.0251983,0.0717198,-0.997107,2
4311,0,0,0,0,973,237,5521,2701,8222,-0.0268734,0.0742305,-0.996879,2
6034,0,0,0,0,1851,347,8232,3999,12231,-0.0289098,0.0745848,-0.996796,2
6291,0,0,0,0,1446,344,8081,3944,12025,-0.0275031,0.0710974,-0.99709,2
6076,0,0,0,0,1494,348,7918,3898,11816,-0.0289131,0.0706005,-0.997086,2
6085,0,0,0,0,1488,423,7996,2975,10971,-0.0299127,0.0689224,-0.997173,2
4455,0,0,0,0,1110,288,5853,2607,8460,-0.0307414,0.0676369,-0.997236,2
6140,0,0,0,0,1496,348,7984,3808,11792,-0.0287366,0.0657641,-0.997421,2
6825,0,0,0,0,1404,351,8580,2853,11433,-0.0283496,0.0689812,-0.997215,2
3153,0,0,0,0,776,193,4122,2164,6286,-0.0299219,0.0691738,-0.997156,2
5195,0,0,0,0,1156,284,6635,3340,9975,-0.0287549,0.0700462,-0.997129,2
6081,0,0,0,0,1450,349,7880,4070,11950,-0.0296199,0.0680289,-0.997244,2
3260,0,0,0,0,636,151,4047,1652,5699,-0.0302624,0.0686496,-0.997182,2
2177,0,0,0,0,585,129,2891,1415,4306,-0.0286034,0.0673154,-0.997322,2
5563,0,0,0,0,1291,317,7171,3456,10627,-0.0299161,0.0670907,-0.997298,2
5716,0,0,0,0,1305,325,7346,3384,10730,-0.0314631,0.0678702,-0.997198,2
6051,0,0,0,0,1469,357,7877,3786,11663,-0.0310594,0.0693588,-0.997108,2
6063,0,0,0,0,1760,356,8179,3652,11831,-0.0326622,0.0706637,-0.996965,2
4221,0,0,0,0,1003,248,5472,2713,8185,-0.0339255,0.0697911,-0.996985,2
5895,0,0,0,0,1307,350,7552,3474,11026,-0.0306597,0.068762,-0.997162,2
5475,0,0,0,0,1304,318,7097,3408,10505,-0.0269105,0.0700465,-0.997181,2
6442,0,0,0,0,1493,366,8301,3874,12175,-0.0281859,0.0708078,-0.997092,2
4489,0,0,0,0,1048,205,5742,2084,7826,-0.0288819,0.0698451,-0.99714,2
2586,0,0,0,0,620,151,3357,1663,5020,-0.0286646,0.0687526,-0.997222,2
5941,0,0,0,0,1310,321,7572,3442,11014,-0.0272585,0.0686017,-0.997272,2
