Downsample[ns],BuildFilTree[ns],SearchFil[ns],DeleteFil[ns],BuildTreeSub[ns],SearchSub[ns],DeleteSub[ns],PreProcTotal[ns],Plane[ns],Total[ns],nx,ny,nz,planeCount
5198,3796,88,486,0,867,255,10690,1760,12450,-0.0228589,0.0376383,-0.99903,0
6181,3762,34,434,0,851,298,11560,3238,14798,0.0195508,0.00104218,-0.999808,0
3506,2409,23,284,0,574,161,6957,2596,9553,0.021272,0.000981576,-0.999773,0
4076,2407,27,306,0,539,171,7526,2243,9769,0.022001,0.000947015,-0.999757,0
6269,3469,34,555,0,832,268,11427,3607,15034,0.0223892,-0.000258221,-0.999749,0
3644,2472,23,364,0,566,182,7251,2599,9850,0.0217552,-0.000254458,-0.999763,0
3512,2415,23,327,0,562,182,7021,2540,9561,0.0227144,0.0023674,-0.999739,0
3513,2384,23,288,0,563,158,6929,2551,9480,0.021647,0.000713339,-0.999766,0
5084,3447,34,405,0,915,306,10191,4692,14883,0.0221454,0.00879804,-0.999716,0
2713,1843,18,221,0,431,120,5346,1944,7290,0.02018,0.0104663,-0.999742,0
4258,2826,26,334,0,664,188,8296,3048,11344,0.0200329,0.00771998,-0.999769,0
5233,3611,44,490,0,841,309,10528,3790,14318,0.0209404,0.00893781,-0.999741,0
5364,3523,36,456,0,919,263,10561,3550,14111,0.0177641,0.0112562,-0.999779,0
5694,3530,32,461,0,813,233,10763,3715,14478,0.0205059,0.0112682,-0.999726,0
3652,2480,24,305,0,579,160,7200,2518,9718,0.0189859,0.0117682,-0.99975,0
4803,3278,34,429,0,840,215,9599,3399,12998,0.0156764,0.00934047,-0.999834,0
4835,3208,31,411,0,760,252,9497,3008,12505,0.0209909,0.0121348,-0.999706,0
5344,3619,34,408,0,909,235,10549,2856,13405,0.0198413,0.0109228,-0.999743,0
5411,3531,36,410,0,810,239,10437,3684,14121,0.0209895,0.0113428,-0.999715,0
3689,1835,19,215,0,461,120,6339,2041,8380,0.0202677,0.0103928,-0.999741,0
1872,1120,12,135,0,256,71,3466,1114,4580,0.021657,0.00848806,-0.99973,0
2313,1495,15,186,0,359,105,4473,1596,6069,0.0202811,0.00885125,-0.999755,0
5822,3587,34,459,0,919,267,11088,3744,14832,0.0192539,0.00941676,-0.99977,0
5283,3556,49,457,0,866,253,10464,2834,13298,0.021096,0.009098,-0.999736,0
2759,1851,18,243,0,563,126,5560,1908,7468,0.020031,0.00926277,-0.999757,0
5298,3518,34,433,0,817,234,10334,3577,13911,0.0218782,0.00960528,-0.999715,0
3705,1848,17,213,0,427,121,6331,1652,7983,0.0208667,0.010758,-0.999725,0
1906,1239,12,144,0,288,81,3670,1303,4973,0.0207491,0.00880139,-0.999746,0
3618,2406,24,334,0,610,161,7153,2543,9696,0.0221529,0.00661815,-0.999733,0
5337,3553,34,450,0,881,232,10487,3746,14233,0.0195,0.00862641,-0.999773,0
5290,3601,35,468,0,830,237,10461,2692,13153,0.0205411,0.00965084,-0.999742,0
3425,2227,28,264,0,549,163,6656,2332,8988,0.0201466,0.0104166,-0.999743,0
5430,3566,36,422,0,852,235,10541,3518,14059,0.0206295,0.0106481,-0.99973,0
3637,2448,23,288,0,564,161,7121,2582,9703,0.0198849,0.0110361,-0.999741,0
5403,3495,35,450,0,822,269,10474,3819,14293,0.0223545,0.00962762,-0.999704,0
3668,2397,25,299,0,556,158,7103,2486,9589,0.01994,0.00966055,-0.999754,0
5387,3518,35,499,0,827,266,10532,3641,14173,0.0184314,0.0130378,-0.999745,0
5487,3167,23,285,0,554,156,9672,2505,12177,0.0192703,0.0112118,-0.999751,0
2293,1531,14,191,0,351,109,4489,1397,5886,0.0201717,0.0102822,-0.999744,0
5171,3472,32,461,0,806,231,10173,3699,13872,0.0190588,0.0111112,-0.999757,0
4631,2470,29,248,0,427,120,7925,1989,9914,0.0195722,0.00939892,-0.999764,0
5550,3357,35,388,0,546,159,10035,2617,12652,0.0195605,0.0112821,-0.999745,0
2828,1773,19,211,0,419,129,5379,1966,7345,0.0185308,0.0105399,-0.999773,0
6487,3356,38,397,0,790,222,11290,3693,14983,0.0182786,0.0106876,-0.999776,0
6402,3454,35,433,0,799,227,11350,3282,14632,0.0202369,0.0109086,-0.999736,0
3764,2406,23,417,0,547,157,7314,2507,9821,0.018288,0.00908722,-0.999791,0
5378,3574,35,479,0,828,227,10521,3810,14331,0.0189177,0.00911862,-0.999779,0
5200,3432,32,404,0,834,227,10129,3677,13806,0.0189972,0.012017,-0.999747,0
5256,3433,35,447,0,918,259,10348,3738,14086,0.0198829,0.0103481,-0.999749,0
5063,3352,37,421,0,831,258,9962,2802,12764,0.019332,0.0124458,-0.999736,0
2740,2101,22,309,0,458,121,5751,1937,7688,0.0212025,0.00976566,-0.999728,0
6131,3543,36,453,0,890,268,11321,3574,14895,0.018975,0.0129284,-0.999736,0
3374,2230,21,312,0,568,168,6673,2380,9053,0.0188646,0.0110912,-0.999761,0
6067,3401,35,433,0,940,274,11150,3841,14991,0.0188324,0.0110713,-0.999761,0
5244,3468,35,429,0,657,163,9996,2362,12358,0.0191693,0.00962492,-0.99977,0
3069,1755,17,228,0,495,115,5679,1813,7492,0.0189906,0.0113168,-0.999756,0
5180,3588,34,455,0,838,231,10326,3664,13990,0.0197171,0.0103547,-0.999752,0
5808,3411,35,428,0,804,238,10724,3046,13770,0.0205279,0.00996746,-0.99974,0
4219,2974,34,338,0,566,180,8311,2558,10869,0.0195314,0.00965775,-0.999763,0
3749,2471,24,304,0,552,167,7267,2524,9791,0.0197991,0.00904394,-0.999763,0
5373,3377,43,434,0,792,227,10246,3712,13958,0.0180468,0.0102942,-0.999784,0
4667,3091,32,417,0,726,208,9141,3694,12835,0.0197132,0.00922587,-0.999763,0
5460,3447,42,414,0,799,239,10401,3738,14139,0.0191422,0.0102044,-0.999765,0
3601,2416,28,297,0,571,167,7080,2763,9843,0.0180789,0.0107881,-0.999778,0
5411,3451,37,423,0,808,225,10355,3851,14206,0.018839,0.0091419,-0.999781,0
5302,3659,36,409,0,870,266,10542,3741,14283,0.0192092,0.0102358,-0.999763,0
3639,2414,24,313,0,618,182,7190,2458,9648,0.0192345,0.00997716,-0.999765,0
5018,3123,31,364,0,720,204,9460,3437,12897,0.0189368,0.0096897,-0.999774,0
4709,3074,31,362,0,719,205,9100,3285,12385,0.0197481,0.00877553,-0.999767,0
3767,2330,24,294,0,511,165,7091,2342,9433,0.0205515,0.0108129,-0.99973,0
4643,3245,35,376,0,657,218,9174,3027,12201,0.0194219,0.0085071,-0.999775,0
4387,2852,34,342,0,683,198,8496,2932,11428,0.0205396,0.0101286,-0.999738,0
5337,3509,39,436,0,816,236,10373,3731,14104,0.0193413,0.010116,-0.999762,0
5304,3463,57,431,0,810,243,10308,3671,13979,0.0178876,0.00875808,-0.999802,0
3637,2413,28,292,0,553,167,7090,2565,9655,0.0182572,0.00983066,-0.999785,0
5266,3472,33,404,0,804,271,10250,4082,14332,0.0164152,0.0102041,-0.999813,0
5384,3504,36,421,0,818,229,10392,3606,13998,0.0186966,0.00990738,-0.999776,0
5301,3548,35,415,0,859,215,10373,2496,12869,0.0181564,0.00974833,-0.999788,0
2923,1807,19,218,0,430,121,5518,2001,7519,0.019398,0.00984608,-0.999763,0
5559,3441,34,496,0,851,255,10636,3702,14338,0.0189838,0.00803843,-0.999787,0
5238,3598,34,472,0,812,233,10387,2971,13358,0.0185656,0.00653534,-0.999806,0
3675,2528,24,325,0,594,178,7324,2541,9865,0.0173513,0.00722712,-0.999823,0
5257,3444,31,470,0,853,241,10296,3633,13929,0.0211312,0.00508632,-0.999764,0
5471,3713,40,473,0,861,284,10842,2586,13428,0.0175312,0.0071255,-0.999821,0
2748,1888,17,218,0,432,122,5425,1860,7285,0.0213417,0.00426104,-0.999763,0
5366,3527,32,412,0,815,231,10383,3726,14109,0.0203196,0.00506497,-0.999781,0
5283,3463,60,540,0,812,312,10470,2951,13421,0.019605,0.0046,-0.999797,0
3791,2414,24,293,0,543,156,7221,2439,9660,0.019663,0.00629863,-0.999787,0
4951,3149,32,358,0,729,226,9445,3223,12668,0.0203489,0.00716538,-0.999767,0
2634,1720,18,208,0,412,113,5105,1669,6774,0.020541,0.00544947,-0.999774,0
5388,3448,49,480,0,835,283,10483,3578,14061,0.0195004,0.00421954,-0.999801,0
3549,2370,24,325,0,547,155,6970,2777,9747,0.0195185,0.00440007,-0.9998,0
5519,3429,36,401,0,790,224,10399,3679,14078,0.0203237,0.003648,-0.999787,0
5282,3528,35,454,0,886,238,10423,3592,14015,0.0202333,0.00432077,-0.999786,0
3677,1956,22,224,0,433,128,6440,1842,8282,0.0206425,0.00349789,-0.999781,0
1876,1169,12,137,0,254,83,3531,1091,4622,0.0205106,0.00188091,-0.999788,0
1977,1304,14,175,0,313,95,3878,1327,5205,0.0202137,0.00377988,-0.999788,0
5229,3484,34,506,0,798,256,10307,3376,13683,0.0214229,0.00370305,-0.999764,0
5682,3142,31,410,0,719,230,10214,3214,13428,0.0213111,0.00254579,-0.99977,0
3401,2175,22,311,0,528,176,6613,2255,8868,0.0216385,0.00136048,-0.999765,0
5315,3346,36,513,0,846,215,10271,3568,13839,0.0223868,0.000924832,-0.999749,0
3586,2371,24,329,0,552,164,7026,2446,9472,0.023783,0.000654698,-0.999717,0
5344,3205,33,496,0,755,266,10099,3289,13388,0.0207263,0.00320631,-0.99978,0
3650,2200,25,376,0,536,164,6951,2440,9391,0.02399,-0.00023617,-0.999712,0
3815,2102,30,298,0,511,160,6916,2477,9393,0.0223554,-0.00298188,-0.999746,0
5434,2856,35,348,0,685,197,9555,3558,13113,0.0208028,0.000732493,-0.999783,0
5452,2902,30,309,0,665,192,9550,3019,12569,0.023724,0.00486703,-0.999707,0
4035,1939,24,242,0,497,132,6869,2369,9238,0.0241472,0.00896171,-0.999668,0
4001,2015,23,246,0,475,154,6914,2509,9423,0.0237171,0.0183122,-0.999551,0
6055,2836,30,330,0,785,255,10291,3716,14007,0.0269408,0.0445531,-0.998644,0
3898,2021,24,294,0,465,148,6850,2475,9325,0.0284144,0.0490832,-0.99839,0
5594,2775,36,357,0,658,181,9601,312,9913,0.0177987,0.100062,-0.994822,0
5712,2788,35,382,0,676,202,9795,656,10451,0.0195436,0.0925995,-0.995512,0
5778,3010,37,383,0,687,181,10076,643,10719,0.0235114,0.0858489,-0.996031,0
5136,2450,30,289,0,581,157,8643,510,9153,0.0247855,0.0979371,-0.994884,0
5496,2373,28,299,0,606,193,8995,551,9546,0.0231945,0.121834,-0.992279,0
5196,2370,28,271,0,560,155,8580,644,9224,0.0458687,0.108824,-0.993002,0
5377,2224,28,260,0,509,141,8539,631,9170,0.0612048,0.118357,-0.991083,0
5111,2023,40,304,0,513,139,8130,698,8828,0.0711712,0.114702,-0.990847,0
5016,2085,27,274,0,499,131,8032,904,8936,0.0715574,0.114956,-0.99079,0
4763,1782,27,221,0,433,140,7366,931,8297,0.0669088,0.111243,-0.991538,0
5622,2132,59,247,0,504,137,8701,1086,9787,0.0640556,0.126129,-0.989944,0
5078,2168,34,296,0,454,125,8155,993,9148,0.05457,0.128609,-0.990193,0
5665,2117,31,343,0,514,160,8830,1213,10043,0.0496858,0.137668,-0.989232,0
5338,2070,29,296,0,512,155,8400,1182,9582,0.0606263,0.118062,-0.991154,0
3600,1443,19,203,0,355,105,5725,1100,6825,0.0642858,0.135729,-0.988658,0
3541,1714,25,255,0,502,139,6176,1367,7543,0.0627187,0.133975,-0.988998,0
3375,1346,21,167,0,321,94,5324,1107,6431,0.0595382,0.14932,-0.986995,0
5464,1782,29,239,0,448,145,8107,1616,9723,0.0389561,0.186447,-0.981693,0
4984,2000,27,207,0,429,141,7788,1887,9675,0.0233455,0.236441,-0.971365,0
5145,1753,37,233,0,429,138,7735,1831,9566,0.0235754,0.223814,-0.974347,0
4363,1653,33,220,0,404,131,6804,1987,8791,0.0188177,0.200278,-0.979558,0
4143,1463,26,184,0,335,108,6259,2100,8359,0.0208717,0.170285,-0.985174,0
5643,1356,33,191,0,342,113,7678,2582,10260,0.0217111,0.161964,-0.986558,0
4056,1100,28,149,0,286,83,5702,2483,8185,0.0316451,0.134033,-0.990471,0
4753,1183,27,206,0,336,93,6598,2866,9464,0.0368864,0.142772,-0.989068,0
4257,1111,29,196,0,310,86,5989,2834,8823,0.0405455,0.130537,-0.990614,0
4465,1118,27,195,0,311,102,6218,3056,9274,0.0453177,0.15178,-0.987375,0
4451,1362,37,216,0,348,92,6506,2979,9485,0.0469618,0.14499,-0.988318,0
4155,1194,25,185,0,318,88,5965,2605,8570,0.0421162,0.133266,-0.990185,0
3995,1293,24,174,0,368,100,5954,2693,8647,0.0346627,0.130813,-0.990801,0
4508,1630,26,228,0,461,120,6973,2834,9807,0.0094489,0.155311,-0.987821,0
4538,1917,39,270,0,504,177,7445,2592,10037,0.00299791,0.156776,-0.987629,0
5163,2232,48,297,0,583,152,8475,2343,10818,-0.000155894,0.182006,-0.983297,0
5011,2629,24,329,0,652,178,8823,2162,10985,0.014407,0.187681,-0.982124,0
3469,1974,30,246,0,493,129,6341,1602,7943,0.0316676,0.182786,-0.982643,0
5046,3216,31,428,0,729,208,9658,2193,11851,0.0410008,0.165925,-0.985286,0
5169,3727,30,401,0,838,228,10393,2329,12722,0.0301719,0.177259,-0.983702,0
4767,3697,24,407,0,841,226,9962,2374,12336,0.0321964,0.154334,-0.987494,0
5554,4690,28,497,0,992,282,12043,3138,15181,0.0499576,0.158551,-0.986086,0
5417,4709,26,439,0,693,191,11475,2352,13827,0.0549328,0.14029,-0.988585,0
3264,3164,17,335,0,729,187,7696,2637,10333,0.050015,0.148582,-0.987635,0
5779,5765,35,632,0,1259,340,13810,4868,18678,0.0332891,0.234221,-0.971613,0
3228,2746,13,270,0,623,154,7034,2155,9189,0.0267455,0.17187,-0.984757,0
1946,1810,10,194,0,413,110,4483,1843,6326,0.0302433,0.119899,-0.992325,0
2633,2353,13,266,0,563,155,5983,3135,9118,0.021277,0.132766,-0.990919,0
6056,4935,34,552,0,1153,319,13049,6491,19540,0.0110732,0.15911,-0.987199,0
6245,4826,34,559,0,1153,310,13127,5913,19040,-0.00492987,0.250426,-0.968124,0
3151,2059,15,238,0,508,147,6118,2918,9036,0.000960873,0.204712,-0.978822,0
1941,1491,11,169,0,356,98,4066,2072,6138,0.0102285,0.132797,-0.991091,0
5485,4141,54,471,0,1023,275,11449,6077,17526,-0.0028652,0.160471,-0.987036,0
3581,2965,19,282,0,602,167,7616,4763,12379,-0.0101434,0.13424,-0.990897,0
6063,3978,36,455,0,979,269,11780,7405,19185,-0.0193993,0.216965,-0.975987,0
3666,2002,19,233,0,489,138,6547,3067,9614,-0.0164338,0.163104,-0.986472,0
1797,1173,12,137,0,284,81,3484,1737,5221,-0.0130067,0.116055,-0.993157,0
1670,1103,11,148,0,262,76,3270,1638,4908,-0.0156926,0.105195,-0.994328,0
8146,4633,32,412,0,829,233,14285,4427,18712,-0.0232785,0.147271,-0.988822,0
3605,2405,22,319,0,570,164,7085,2778,9863,-0.0213597,0.130653,-0.991198,0
4311,2891,45,312,0,642,177,8378,3095,11473,-0.0131518,0.130397,-0.991375,0
5024,3530,31,572,0,1091,301,10549,3886,14435,0.000118131,0.143981,-0.98958,0
3393,2346,19,283,0,541,145,6727,2268,8995,-0.00297287,0.118395,-0.992962,0
4520,3015,26,385,0,762,197,8905,3167,12072,-0.0066256,0.112721,-0.993605,0
4524,2712,24,331,0,647,183,8421,3247,11668,-0.0178294,0.0969856,-0.995126,0
4250,2690,28,366,0,772,187,8293,3336,11629,-0.0248274,0.0970151,-0.994973,0
4590,2756,27,349,0,702,190,8614,3107,11721,-0.0273545,0.108271,-0.993745,0
4968,2663,25,320,0,664,181,8821,3093,11914,-0.0183538,0.11203,-0.993535,0
4646,2777,23,336,0,628,250,8660,3153,11813,-0.00650109,0.138926,-0.990281,0
2453,1446,14,171,0,342,96,4522,1280,5802,0.00314559,0.15562,-0.987812,0
4261,2827,32,352,0,659,221,8352,2327,10679,0.00844084,0.196836,-0.9804,0
4394,2679,22,310,0,619,174,8198,1691,9889,-0.000657358,0.237909,-0.971288,0
4161,2887,23,408,0,693,185,8357,1418,9775,-0.0209824,0.289936,-0.956816,0
4144,3228,25,337,0,672,192,8598,1285,9883,-0.0216139,0.324139,-0.945762,0
4353,3110,23,351,0,777,198,8812,1170,9982,-0.0138253,0.311894,-0.950016,0
4337,3554,24,485,0,729,207,9336,982,10318,-0.0109902,0.277503,-0.960662,0
4619,3324,23,386,0,752,212,9316,879,10195,-0.00780698,0.225624,-0.974183,0
4398,3388,24,468,0,767,240,9285,655,9940,-0.00435742,0.183087,-0.983087,0
5051,3850,24,510,0,874,239,10548,459,11007,-0.0070685,0.17098,-0.985249,0
4633,3576,24,431,0,797,224,9685,404,10089,-0.0100873,0.192426,-0.98126,0
4557,3596,29,465,0,757,214,9618,421,10039,-0.00393124,0.218398,-0.975852,0
4461,3616,25,486,0,816,250,9654,465,10119,0.00238109,0.223661,-0.974664,0
4605,3560,24,440,0,786,247,9662,477,10139,0.000551046,0.201546,-0.979479,0
4674,3738,24,447,0,784,253,9920,1426,11346,-0.0256755,0.165258,-0.985916,0
4547,3532,25,400,0,785,225,9514,1037,10551,-0.0399417,0.181273,-0.982622,0
5352,4464,28,467,0,946,285,11542,1008,12550,-0.0578231,0.183462,-0.981325,0
5093,4016,29,435,0,667,188,10428,994,11422,-0.0426556,0.182124,-0.98235,0
3867,2613,20,290,0,560,161,7511,784,8295,-0.0234375,0.163438,-0.986275,0
5009,3537,31,440,0,750,263,10030,1347,11377,-0.0147818,0.170682,-0.985215,0
5584,3635,34,410,0,789,222,10674,365,11039,0.212582,0.44451,-0.870184,0
5467,3744,40,540,0,825,248,10864,626,11490,0.158899,0.21665,-0.963231,0
5111,3111,33,446,0,739,238,9678,590,10268,0.113762,0.279955,-0.953249,0
4532,2593,30,356,0,635,196,8342,618,8960,0.0218331,0.278315,-0.960242,0
5024,2828,39,380,0,643,218,9132,1211,10343,-0.0293682,0.292573,-0.955792,0
5119,2772,32,337,0,632,187,9079,1921,11000,-0.0472724,0.273954,-0.96058,0
5051,3338,31,478,0,723,238,9859,1695,11554,-0.0618704,0.257068,-0.964411,0
5145,3505,29,485,0,822,249,10235,999,11234,-0.096329,0.286884,-0.95311,0
5201,3647,28,501,0,810,254,10441,790,11231,-0.0800109,0.215481,-0.973225,0
5089,3608,28,467,0,777,254,10223,658,10881,-0.0553097,0.182536,-0.981642,0
5212,3518,28,536,0,825,299,10418,579,10997,-0.0383557,0.204508,-0.978113,0
5052,3252,21,307,0,524,167,9323,495,9818,-0.0320544,0.167776,-0.985304,0
2625,1570,16,192,0,382,113,4898,370,5268,-0.025696,0.123592,-0.992,0
4775,2757,36,486,0,871,269,9194,1001,10195,-0.0300129,0.0934974,-0.995167,0
5010,2215,29,317,0,572,197,8340,1193,9533,-0.0169872,0.105667,-0.994257,0
4909,3118,31,368,0,558,131,9115,764,9879,-0.017122,0.088782,-0.995904,0
4897,2594,29,328,0,640,176,8664,1367,10031,0.0115641,0.156311,-0.98764,0
3303,1826,20,209,0,332,96,5786,582,6368,0.0262076,0.155845,-0.987434,0
2004,1033,15,125,0,236,72,3485,590,4075,0.0390634,0.182658,-0.9824,0
4925,2166,35,317,0,549,162,8154,1782,9936,0.050292,0.171741,-0.983858,0
5032,1995,35,277,0,514,138,7991,1816,9807,0.0448619,0.178761,-0.982869,0
5361,2221,30,234,0,451,145,8442,2038,10480,0.0324158,0.210759,-0.977,0
5581,1681,33,230,0,418,135,8078,2426,10504,0.01637,0.210677,-0.977419,0
5080,1536,30,230,0,395,139,7410,2601,10011,0.0171337,0.1968,-0.980294,0
5565,1362,30,190,0,357,104,7608,2835,10443,0.0227797,0.178111,-0.983747,0
4965,1347,29,195,0,344,101,6981,2763,9744,0.0293583,0.171464,-0.984753,0
4857,1358,32,249,0,379,122,6997,3049,10046,0.0311566,0.164512,-0.985883,0
4740,1384,29,224,0,355,101,6833,2698,9531,0.0304632,0.154714,-0.98749,0
4891,1286,28,175,0,323,98,6801,2467,9268,0.025998,0.143065,-0.989372,0
4619,1468,29,238,0,417,117,6888,2133,9021,0.0340254,0.136297,-0.990084,0
4294,1629,26,232,0,389,120,6690,2099,8789,0.0440306,0.151354,-0.987499,0
4855,2015,30,306,0,536,151,7893,2290,10183,0.0457622,0.15286,-0.987188,0
4919,2180,30,289,0,504,149,8071,2322,10393,0.0393417,0.166233,-0.985301,0
4972,2571,28,316,0,607,165,8659,2252,10911,-0.01933,0.244093,-0.969559,0
3487,1775,21,240,0,356,103,5982,1408,7390,-0.00794655,0.182881,-0.983103,0
2165,1376,12,170,0,318,86,4127,1169,5296,-0.00110882,0.136469,-0.990644,0
5210,3725,25,348,0,838,221,10367,2405,12772,-0.03211,0.174035,-0.984216,0
5544,3814,33,498,0,707,188,10784,1588,12372,-0.0491454,0.205132,-0.977499,0
3844,3232,24,386,0,760,224,8470,1437,9907,-0.0140783,0.166416,-0.985955,0
5825,5205,29,558,0,1187,340,13144,1534,14678,0.0237263,0.182788,-0.982866,0
4478,3854,19,469,0,908,252,9980,1579,11559,0.0239509,0.172751,-0.984675,0
4365,3911,20,481,0,901,275,9953,2446,12399,0.016364,0.165982,-0.985993,0
5861,4871,26,633,0,1202,277,12870,2910,15780,-0.00580973,0.16586,-0.986132,0
5591,4714,25,612,0,1136,359,12437,3450,15887,-0.0207824,0.143774,-0.989392,0
3148,2716,17,305,0,623,176,6985,2840,9825,-0.0225604,0.11767,-0.992797,0
3694,2959,17,344,0,675,198,7887,3650,11537,-0.0222654,0.102654,-0.994468,0
5728,4147,24,498,0,1238,374,12009,6571,18580,-0.02393,0.118789,-0.992631,0
3886,2658,24,308,0,644,183,7703,4878,12581,-0.0208878,0.108509,-0.993876,0
5101,3186,31,401,0,767,221,9707,5707,15414,-0.0125247,0.136426,-0.990571,0
3711,2264,21,260,0,538,155,6949,2976,9925,-0.0125404,0.126005,-0.991951,0
2564,1690,17,196,0,403,115,4985,2477,7462,-0.00963588,0.128874,-0.991614,0
5600,3529,29,430,0,919,248,10755,4647,15402,-0.020271,0.14234,-0.98961,0
4036,2515,18,288,0,620,163,7640,3115,10755,-0.0130945,0.132614,-0.991081,0
5822,4010,31,555,0,941,303,11662,4080,15742,-0.0175541,0.140606,-0.98991,0
3401,2071,16,247,0,537,136,6408,2254,8662,-0.0162018,0.121989,-0.9924,0
5879,4535,35,509,0,945,303,12206,4335,16541,0.00522146,0.223303,-0.974735,0
2835,1934,13,208,0,389,104,5483,1683,7166,0.000880822,0.177868,-0.984054,0
1865,1319,10,159,0,316,83,3752,1253,5005,-0.00189646,0.145078,-0.989419,0
4489,3306,22,416,0,763,207,9203,2957,12160,0.0121267,0.21951,-0.975535,0
4893,3739,24,466,0,854,256,10232,3016,13248,0.00328452,0.285903,-0.958253,0
4891,3788,25,459,0,867,267,10297,1845,12142,-0.0076783,0.315139,-0.949014,0
4527,3396,21,419,0,798,214,9375,2243,11618,-0.0107,0.336556,-0.941603,0
4414,3573,45,427,0,820,219,9498,1776,11274,-0.0155456,0.364375,-0.931122,0
4632,3568,22,434,0,813,219,9688,1436,11124,-0.0240132,0.370385,-0.928568,0
4547,3495,23,382,0,758,234,9439,1135,10574,-0.0174034,0.39387,-0.919001,0
4607,3653,24,374,0,777,214,9649,1043,10692,-0.00971605,0.385448,-0.922679,0
4910,4032,29,424,0,793,225,10413,1304,11717,0.0145953,0.339252,-0.940583,0
3266,2501,19,282,0,614,157,6839,1135,7974,0.0313568,0.288923,-0.956839,0
4769,3315,29,464,0,797,243,9617,1686,11303,0.042601,0.303202,-0.951974,0
4541,3330,34,483,0,754,232,9374,1552,10926,0.0264948,0.406989,-0.913049,0
5160,3099,29,386,0,535,168,9377,1139,10516,0.00887799,0.356365,-0.934305,0
2611,1831,16,231,0,430,131,5250,907,6157,-0.00823403,0.289232,-0.957224,0
3636,2471,22,313,0,568,176,7186,554,7740,-0.0480482,0.337984,-0.939924,0
5136,3182,31,434,0,795,259,9837,876,10713,-0.0689891,0.350125,-0.934159,0
4507,2703,27,314,0,636,175,8362,778,9140,-0.051042,0.328484,-0.94313,0
5145,2758,27,290,0,628,160,9008,630,9638,-0.00986227,0.307082,-0.951632,0
4404,2111,24,258,0,488,139,7424,411,7835,0.0286934,0.251791,-0.967356,0
4967,2542,28,388,0,516,177,8618,-1000,-1000,-1,-1,-1,0
3973,1344,17,167,0,325,93,5919,766,6685,0.0146331,0.205947,-0.978454,0
2593,1030,15,130,0,250,70,4088,393,4481,0.00475242,0.166148,-0.986089,0
5588,2071,26,283,0,519,158,8645,1248,9893,0.0103721,0.190179,-0.981695,0
5235,1965,30,280,0,498,136,8144,1735,9879,0.0234827,0.226599,-0.973705,0
3485,1221,29,258,0,300,104,5397,1388,6785,0.025825,0.213664,-0.976566,0
3442,1156,23,228,0,410,111,5370,2154,7524,0.0237798,0.197888,-0.979936,0
3557,1109,23,183,0,319,83,5274,1976,7250,0.0200758,0.189309,-0.981712,0
4270,1565,24,233,0,382,115,6589,2587,9176,0.0160942,0.174102,-0.984596,0
4237,1609,26,240,0,411,121,6644,2589,9233,0.0170821,0.159084,-0.987117,0
4955,1907,29,310,0,472,167,7840,2871,10711,0.0211667,0.160129,-0.986869,0
4764,1771,25,217,0,423,138,7338,2511,9849,0.0311154,0.161652,-0.986357,0
4806,2104,34,355,0,489,135,7923,2588,10511,0.0392862,0.16776,-0.985045,0
4534,2482,32,412,0,759,193,8412,2652,11064,0.0362904,0.156076,-0.987078,0
4184,2078,24,287,0,476,140,7189,1780,8969,0.03213,0.152933,-0.987714,0
5232,2893,28,365,0,639,217,9374,2331,11705,0.0195619,0.167437,-0.985689,0
5231,3130,29,449,0,697,230,9766,1784,11550,0.00552331,0.167888,-0.98579,0
3254,1845,17,211,0,410,125,5862,1310,7172,0.00175184,0.145481,-0.989359,0
3359,2336,19,275,0,519,162,6670,1785,8455,0.00734376,0.142579,-0.989756,0
5411,3583,28,451,0,807,258,10538,2777,13315,0.0200737,0.141736,-0.989701,0
5710,3733,27,380,0,847,235,10932,2471,13403,0.0489126,0.180181,-0.982417,0
5428,4081,33,450,0,909,272,11173,2689,13862,0.0758645,0.163182,-0.983675,0
3011,2243,13,204,0,440,117,6028,1354,7382,0.0638926,0.113069,-0.991531,0
2122,1727,11,184,0,428,107,4579,867,5446,0.0902248,0.100326,-0.990855,0
6276,5131,30,639,0,1188,358,13622,2514,16136,0.0531423,0.17038,-0.983944,0
4256,3681,25,452,0,1095,291,9800,2268,12068,0.0262242,0.18225,-0.982903,0
3196,2187,15,260,0,539,153,6350,2058,8408,0.00632972,0.153998,-0.988051,0
3711,3268,24,407,0,667,175,8252,3136,11388,-0.0064877,0.110519,-0.993853,0
5415,3634,25,365,0,839,250,10528,4945,15473,-0.00747241,0.0924485,-0.995689,0
3705,2318,26,378,0,572,151,7150,3614,10764,-0.00272455,0.0573943,-0.998348,0
3708,2267,19,316,0,564,169,7043,3550,10593,0.00321681,0.0422403,-0.999102,0
4364,2550,24,298,0,631,173,8040,4087,12127,0.00306456,0.0442482,-0.999016,0
4601,3048,30,493,0,931,269,9372,3949,13321,-0.00894881,0.0392378,-0.99919,0
5597,3561,31,380,0,789,214,10572,4435,15007,-0.0160099,0.0504416,-0.998599,0
5522,3444,31,400,0,792,225,10414,4285,14699,-0.02174,0.0993842,-0.994812,0
3431,1819,17,203,0,420,119,6009,1932,7941,-0.0142604,0.0723904,-0.997275,0
1951,1272,13,196,0,290,80,3802,1436,5238,-0.0148581,0.0525412,-0.998508,0
4906,3093,26,351,0,733,204,9313,3525,12838,-0.0081987,0.0679633,-0.997654,0
5500,3514,33,407,0,902,232,10588,3765,14353,-0.00922466,0.0624565,-0.998005,0
5277,3563,29,456,0,848,231,10404,2906,13310,-0.00759848,0.0712395,-0.99743,0
3789,2366,19,273,0,569,169,7185,2292,9477,-0.00287448,0.0796465,-0.996819,0
5059,3237,24,366,0,776,218,9680,2904,12584,-0.0117623,0.0931402,-0.995584,0
5274,4010,27,425,0,844,294,10874,3222,14096,-0.00936662,0.188277,-0.982071,0
3451,2900,20,347,0,712,176,7606,2225,9831,-0.00638818,0.161332,-0.98688,0
2564,2051,13,233,0,451,128,5440,1629,7069,-0.0106559,0.113049,-0.993532,0
2114,1607,10,182,0,364,102,4379,1310,5689,-0.0116351,0.111808,-0.993662,0
6084,3722,24,431,0,860,252,11373,2697,14070,-0.00416645,0.184704,-0.982786,0
4899,3783,25,453,0,846,232,10238,2463,12701,0.00422048,0.332505,-0.943092,0
5091,2810,18,300,0,562,179,8960,1485,10445,0.00908325,0.33169,-0.943345,0
2132,1485,11,175,0,338,96,4237,841,5078,0.00424258,0.264296,-0.964432,0
1581,1324,10,126,0,245,69,3355,557,3912,0.00391265,0.258051,-0.966124,0
4294,3221,23,359,0,723,201,8821,1564,10385,0.00245801,0.265454,-0.964121,0
4468,3015,23,345,0,714,197,8762,1432,10194,0.0237288,0.261897,-0.964804,0
4336,3203,23,383,0,720,197,8862,1392,10254,0.0348926,0.271458,-0.961818,0
4626,3236,26,391,0,739,200,9218,1494,10712,0.0349853,0.276727,-0.960312,0
2825,1797,17,210,0,405,112,5366,856,6222,0.0298398,0.243869,-0.969349,0
2031,1597,16,197,0,393,105,4339,1174,5513,0.0414261,0.212141,-0.976361,0
4666,3064,30,358,0,757,191,9066,2352,11418,0.0312417,0.183046,-0.982608,0
4491,3075,31,384,0,692,191,8864,2188,11052,0.0101404,0.166004,-0.986073,0
5267,3264,40,456,0,832,212,10071,2562,12633,-0.00664111,0.165401,-0.986204,0
3431,2389,23,323,0,567,151,6884,1783,8667,-0.0168094,0.173105,-0.98476,0
5073,3454,33,483,0,846,224,10113,2940,13053,0.0056532,0.170619,-0.985321,0
5131,3563,31,440,0,851,233,10249,2863,13112,0.0330272,0.164531,-0.985819,0
3630,2443,23,325,0,639,183,7243,1971,9214,0.043363,0.149365,-0.987831,0
4637,3232,28,428,0,817,246,9388,2121,11509,0.0399443,0.137202,-0.989737,0
4604,3245,29,428,0,815,239,9360,1625,10985,0.0388348,0.128806,-0.990909,0
5031,3153,30,385,0,749,245,9593,1502,11095,0.0370822,0.123316,-0.991674,0
5059,3452,34,450,0,870,227,10092,1410,11502,0.0431638,0.116701,-0.992229,0
5097,3500,32,408,0,908,235,10180,1118,11298,0.0525221,0.108019,-0.992761,0
4993,3479,33,470,0,862,234,10071,806,10877,0.0567719,0.10896,-0.992424,0
5129,3534,31,407,0,854,234,10189,804,10993,0.0551929,0.11884,-0.991378,0
5184,3578,34,406,0,884,241,10327,990,11317,0.0559379,0.124256,-0.990672,0
3645,2457,24,331,0,647,178,7282,1102,8384,0.052839,0.120707,-0.991281,0
4072,2351,30,311,0,572,154,7490,1261,8751,0.0620717,0.121627,-0.990633,0
4706,3181,29,393,0,716,270,9295,1866,11161,0.0602415,0.121085,-0.990812,0
4922,3025,32,385,0,764,222,9350,1435,10785,0.0503978,0.122872,-0.991142,0
3266,2094,39,269,0,515,141,6324,1038,7362,0.0517718,0.123816,-0.990954,0
4995,3142,36,451,0,864,214,9702,1692,11394,0.0535121,0.118377,-0.991526,0
4597,2890,30,396,0,698,220,8831,1662,10493,0.0577488,0.110067,-0.992245,0
4888,2938,29,397,0,745,223,9220,1400,10620,0.0562781,0.101842,-0.993207,0
4633,2928,29,399,0,711,219,8919,1124,10043,0.051065,0.0852665,-0.995049,0
4694,2867,30,388,0,727,217,8923,350,9273,0.0422264,0.063552,-0.997085,0
5182,3174,34,372,0,752,260,9774,5094,14868,0.0193861,-0.00657144,-0.999791,0
3461,2163,25,262,0,580,146,6637,3574,10211,0.0231361,-0.00109819,-0.999732,0
5139,3146,42,390,0,752,225,9694,5111,14805,0.0248899,0.00936436,-0.999646,0
5111,3049,35,353,0,682,204,9434,4456,13890,0.0307239,0.0235856,-0.99925,0
4561,2880,31,400,0,506,159,8537,3229,11766,0.0363582,0.0223139,-0.99909,0
2624,1869,20,229,0,454,131,5327,3145,8472,0.0359536,0.0228731,-0.999092,0
5098,3226,31,389,0,794,245,9783,5615,15398,0.0352921,0.0238484,-0.999092,0
3700,2212,22,298,0,562,179,6973,3541,10514,0.0356645,0.0149817,-0.999252,0
4622,3134,30,342,0,682,191,9001,4473,13474,0.0320755,0.0127659,-0.999404,0
3446,2136,22,278,0,490,159,6531,3304,9835,0.0311684,0.00993773,-0.999465,0
5540,3349,35,401,0,940,251,10516,5177,15693,0.0335114,0.0125224,-0.99936,0
3896,1920,19,212,0,417,113,6577,2726,9303,0.0322438,0.0112871,-0.999416,0
3478,1910,21,225,0,458,127,6219,3176,9395,0.0317206,0.0123914,-0.99942,0
3013,1903,20,247,0,488,129,5800,3277,9077,0.031965,0.0114267,-0.999423,0
3794,1865,20,236,0,457,127,6499,3054,9553,0.0313079,0.0121597,-0.999436,0
4639,2904,29,426,0,714,224,8936,4534,13470,0.0308839,0.0104286,-0.999469,0
4681,2966,30,394,0,770,231,9072,4210,13282,0.0369424,0.0122553,-0.999242,0
4137,2646,28,355,0,671,223,8060,4095,12155,0.0341024,0.0141449,-0.999318,0
5163,3121,30,514,0,814,247,9889,4666,14555,0.0281062,0.0227225,-0.999347,0
3260,1945,18,235,0,411,124,5993,2460,8453,0.0291725,0.0122717,-0.999499,0
1723,1116,12,146,0,274,81,3352,1551,4903,0.031413,0.0152217,-0.999391,0
4542,2959,29,441,0,775,226,8972,4455,13427,0.032706,0.0112702,-0.999402,0
5152,3266,32,344,0,732,213,9739,4591,14330,0.0328496,0.0111883,-0.999398,0
3245,2008,21,241,0,578,159,6252,3190,9442,0.0299884,0.010583,-0.999494,0
4925,2986,31,396,0,685,195,9218,4475,13693,0.0299816,0.00889892,-0.999511,0
4588,2882,30,404,0,713,193,8810,4681,13491,0.0283834,0.0107046,-0.99954,0
3930,2010,22,240,0,484,136,6822,3119,9941,0.0332249,0.0134487,-0.999358,0
5119,3293,38,440,0,796,214,9900,4673,14573,0.0300757,0.0136038,-0.999455,0
3268,2078,22,278,0,508,169,6323,3054,9377,0.0368323,0.0186854,-0.999147,0
5087,3239,30,387,0,747,232,9722,4431,14153,0.0342799,0.0174788,-0.99926,0
3284,2076,21,318,0,521,174,6394,3146,9540,0.0364864,0.0165382,-0.999197,0
5314,3003,29,432,0,736,234,9748,4341,14089,0.0334643,0.014373,-0.999337,0
3306,2117,22,257,0,560,141,6403,3121,9524,0.0331,0.0170468,-0.999307,0
4189,2645,33,354,0,627,180,8028,3888,11916,0.0343,0.0165704,-0.999274,0
5070,3206,45,379,0,856,230,9786,4397,14183,0.0372698,0.0185697,-0.999133,0
4793,2915,35,376,0,688,209,9016,4045,13061,0.0372363,0.0194775,-0.999117,0
4877,3286,36,418,0,767,232,9616,4446,14062,0.0371906,0.0172829,-0.999159,0
4525,2904,33,389,0,708,193,8752,4169,12921,0.0337839,0.0195536,-0.999237,0
5037,3236,34,423,0,808,215,9753,4423,14176,0.0361621,0.0179884,-0.999184,0
4968,2876,30,432,0,684,201,9191,4376,13567,0.0350245,0.0172116,-0.999238,0
3232,2066,22,267,0,512,140,6239,3128,9367,0.0337271,0.0189016,-0.999253,0
5197,3074,32,424,0,785,226,9738,4379,14117,0.0336422,0.0171089,-0.999288,0
3263,2082,21,262,0,561,138,6327,3027,9354,0.0339214,0.0194262,-0.999235,0
5250,3258,34,480,0,819,250,10091,4821,14912,0.0326979,0.0191904,-0.999281,0
3268,2522,23,331,0,762,213,7119,3219,10338,0.0337922,0.0192805,-0.999243,0
5019,2906,31,390,0,713,196,9255,4239,13494,0.0348937,0.0165717,-0.999254,0
5128,3217,34,433,0,792,219,9823,4840,14663,0.034806,0.018419,-0.999225,0
3543,1893,28,338,0,417,114,6333,2394,8727,0.03372,0.0165591,-0.999294,0
1880,1176,13,169,0,289,91,3618,1766,5384,0.0337285,0.0176337,-0.999276,0
2795,1917,19,258,0,449,148,5586,2703,8289,0.0349602,0.0207145,-0.999174,0
5250,3280,34,402,0,856,217,10039,4309,14348,0.0336413,0.0198246,-0.999237,0
3442,2242,24,257,0,557,148,6670,3305,9975,0.0358527,0.0161109,-0.999227,0
5067,3242,35,412,0,824,214,9794,4704,14498,0.0336769,0.0132041,-0.999346,0
5268,3229,33,394,0,742,148,9814,3308,13122,0.0321729,0.0124192,-0.999405,0
2673,1684,18,201,0,414,114,5104,2582,7686,0.031921,0.0154088,-0.999371,0
5237,3289,35,415,0,777,246,9999,4827,14826,0.0322229,0.0143237,-0.999378,0
3567,2246,22,308,0,544,167,6854,3318,10172,0.0322985,0.015872,-0.999352,0
4572,2893,31,385,0,708,195,8784,4407,13191,0.0320468,0.0142284,-0.999385,0
4573,2919,31,380,0,711,197,8811,4533,13344,0.0311069,0.0175104,-0.999362,0
4545,2868,30,386,0,716,203,8748,4421,13169,0.0320746,0.0180196,-0.999323,0
4563,2888,35,372,0,683,207,8748,4499,13247,0.032088,0.0153295,-0.999367,0
4523,2942,36,400,0,686,206,8793,4319,13112,0.0321696,0.0162093,-0.999351,0
3296,2127,26,288,0,512,147,6396,3272,9668,0.0319083,0.0160797,-0.999362,0
4989,3211,32,393,0,814,219,9658,4994,14652,0.0296609,0.014506,-0.999455,0
3656,2226,28,304,0,556,161,6931,3369,10300,0.0318714,0.0117804,-0.999423,0
5142,2882,35,348,0,690,208,9305,4560,13865,0.0350239,0.014466,-0.999282,0
4532,2915,35,362,0,689,238,8771,4447,13218,0.036176,0.0154507,-0.999226,0
3212,2267,26,283,0,487,150,6425,3223,9648,0.0346759,0.0152058,-0.999283,0
5209,3210,40,381,0,761,213,9814,5035,14849,0.0340467,0.0114285,-0.999355,0
5325,3235,41,398,0,751,244,9994,4157,14151,0.0327074,0.0137864,-0.99937,0
5024,3211,40,413,0,756,227,9671,4953,14624,0.0349154,0.0160399,-0.999262,0
5119,3239,39,422,0,758,228,9805,3432,13237,0.0325971,0.0131763,-0.999382,0
3460,2234,27,273,0,614,159,6767,3278,10045,0.0330587,0.0127829,-0.999371,0
5126,3324,45,406,0,758,222,9881,5013,14894,0.0325949,0.0119842,-0.999397,0
4811,2943,37,358,0,743,206,9098,4164,13262,0.0314284,0.00978729,-0.999458,0
3183,2094,23,250,0,487,137,6174,3162,9336,0.0302983,0.00998458,-0.999491,0
5002,3245,31,394,0,772,218,9662,4581,14243,0.0308545,0.0123065,-0.999448,0
4495,2942,31,345,0,684,191,8688,4673,13361,0.0331787,0.0161859,-0.999318,0
3238,2107,27,251,0,494,158,6275,3160,9435,0.0322893,0.0156136,-0.999357,0
4260,2666,33,353,0,695,206,8213,3905,12118,0.0336668,0.0189293,-0.999254,0
4635,2838,29,351,0,708,195,8756,4363,13119,0.0331916,0.0182579,-0.999282,0
4614,2848,31,355,0,721,193,8762,4259,13021,0.0337154,0.0169963,-0.999287,0
4086,2662,27,354,0,642,190,7961,3930,11891,0.0311415,0.0144695,-0.99941,0
4299,2656,27,345,0,640,190,8157,3933,12090,0.0313177,0.0161373,-0.999379,0
4911,3236,35,453,0,726,193,9554,4694,14248,0.0310191,0.015848,-0.999393,0
4713,2877,38,401,0,736,230,8995,4431,13426,0.0304019,0.0155993,-0.999416,0
2852,1634,18,222,0,380,132,5238,2434,7672,0.0305948,0.0154297,-0.999413,0
5075,3140,31,388,0,758,213,9605,4457,14062,0.0292984,0.0153465,-0.999453,0
4691,2799,30,340,0,761,195,8816,3884,12700,0.0303146,0.013153,-0.999454,0
3250,2049,21,239,0,499,137,6195,3144,9339,0.0302674,0.0144246,-0.999437,0
5034,3235,34,382,0,832,255,9772,4994,14766,0.0311545,0.0140107,-0.999416,0
3477,2158,25,261,0,604,150,6675,3337,10012,0.0301684,0.0146919,-0.999437,0
4535,2799,30,371,0,766,197,8698,4411,13109,0.0287085,0.0138369,-0.999492,0
4613,2980,32,399,0,707,226,8957,3553,12510,0.032721,0.0137643,-0.99937,0
4224,2655,28,359,0,643,202,8111,3779,11890,0.033197,0.0133423,-0.99936,0
5053,3197,30,345,0,916,284,9825,4399,14224,0.0327477,0.0109433,-0.999404,0
3212,2109,21,281,0,502,160,6285,3034,9319,0.032587,0.0134717,-0.999378,1
5096,3091,34,445,0,726,195,9587,4289,13876,0.0313206,0.0163811,-0.999375,1
4537,2916,30,378,0,728,218,8807,3862,12669,0.0325345,0.0149323,-0.999359,1
4209,2653,29,359,0,646,189,8085,3995,12080,0.0292497,0.0147822,-0.999463,1
5268,2876,43,374,0,716,257,9534,4519,14053,0.0301336,0.0126289,-0.999466,1
4648,2876,32,340,0,686,194,8776,3672,12448,0.0297924,0.0126883,-0.999476,1
4937,2866,31,339,0,755,229,9157,4397,13554,0.0308405,0.0129184,-0.999441,1
3230,2128,22,243,0,528,136,6287,3159,9446,0.0296988,0.0148942,-0.999448,1
4705,2861,31,390,0,691,273,8951,4080,13031,0.0322547,0.0147569,-0.999371,1
4197,2616,28,396,0,633,186,8056,3777,11833,0.0292026,0.0168084,-0.999432,1
3774,2370,24,279,0,561,157,7165,3576,10741,0.0291994,0.0160203,-0.999445,1
4819,2946,31,399,0,680,218,9093,4488,13581,0.0311798,0.0150411,-0.999401,1
4786,2440,23,241,0,486,136,8112,2942,11054,0.032255,0.0157444,-0.999356,1
2167,1299,14,172,0,343,98,4093,1969,6062,0.0329336,0.00931649,-0.999414,1
4655,3536,37,464,0,1019,286,9997,4614,14611,0.0315368,0.00982557,-0.999454,1
4851,2916,37,395,0,492,156,8847,3174,12021,0.031727,0.00930698,-0.999453,1
2506,1599,18,208,0,378,121,4830,2844,7674,0.0313304,0.00794547,-0.999477,1
3180,1962,20,259,0,499,144,6064,2912,8976,0.0306359,0.00913495,-0.999489,1
4836,2876,32,380,0,710,257,9091,4503,13594,0.0301005,0.00904997,-0.999506,1
3273,2062,21,259,0,521,156,6292,3203,9495,0.031253,0.00684443,-0.999488,1
3412,2068,21,263,0,506,155,6425,3084,9509,0.0308592,0.00805359,-0.999491,1
4676,2980,31,417,0,714,260,9078,5651,14729,0.0322531,0.00706418,-0.999455,1
4685,2962,33,374,0,800,196,9050,3321,12371,0.0326209,0.00236031,-0.999465,1
2992,1945,21,251,0,474,129,5812,2975,8787,0.0338961,0.00343804,-0.999419,1
4520,2961,31,370,0,746,194,8822,4379,13201,0.0330187,0.00377313,-0.999448,1
4541,3247,31,343,0,682,191,9035,3986,13021,0.0322304,0.00444253,-0.999471,1
3506,1999,21,265,0,488,137,6416,3127,9543,0.0302516,0.00150061,-0.999541,1
4660,2907,31,382,0,711,194,8885,4435,13320,0.0327252,0.00463634,-0.999454,1
5151,3235,31,393,0,722,196,9728,4390,14118,0.0313158,0.00383565,-0.999502,1
5179,3237,33,440,0,826,221,9936,5024,14960,0.0328172,0.00484851,-0.99945,1
5089,3144,30,341,0,681,194,9479,4058,13537,0.0309876,0.00254798,-0.999517,1
4114,2589,26,312,0,683,180,7904,4088,11992,0.0313867,0.00442469,-0.999498,1
4153,2740,28,401,0,678,221,8221,4139,12360,0.0294335,0.00444967,-0.999557,1
4279,2689,32,361,0,678,191,8230,3268,11498,0.0304381,0.00267964,-0.999533,1
4647,3008,45,413,0,717,226,9056,4500,13556,0.0341255,0.00178241,-0.999416,1
4998,2965,35,405,0,766,210,9379,3663,13042,0.0286479,0.00147572,-0.999588,1
3090,2030,23,259,0,479,138,6019,2951,8970,0.0308443,0.00311849,-0.99952,1
4758,3045,30,439,0,771,236,9279,4347,13626,0.0311614,0.00243794,-0.999512,1
4645,2998,36,411,0,711,226,9027,4063,13090,0.0292909,0.00389277,-0.999563,1
4511,2900,32,389,0,707,206,8745,4913,13658,0.0267088,0.000563984,-0.999643,1
4711,2971,30,383,0,734,220,9049,4517,13566,0.0268309,-0.00198713,-0.999638,1
5015,2784,57,358,0,684,220,9118,4499,13617,0.0298728,0.000658303,-0.999553,1
4508,2871,32,382,0,722,192,8707,4019,12726,0.0325722,0.00451296,-0.999459,1
2921,1629,17,219,0,393,107,5286,2437,7723,0.0329726,0.00762451,-0.999427,1
4506,2863,31,373,0,712,194,8679,4831,13510,0.0291607,0.00262585,-0.999571,1
4823,2951,30,394,0,708,223,9129,3452,12581,0.0304593,6.71891e-05,-0.999536,1
2532,1565,17,186,0,389,105,4794,2486,7280,0.0302806,-0.000753547,-0.999541,1
4706,2918,30,389,0,702,234,8979,4570,13549,0.0317269,-0.000962999,-0.999496,1
5327,2860,29,400,0,703,222,9541,4446,13987,0.0286101,0.00226249,-0.999588,1
3229,2032,22,274,0,492,165,6214,3219,9433,0.0286238,0.0059582,-0.999573,1
4343,2622,28,318,0,668,178,8157,4183,12340,0.02705,0.00784115,-0.999603,1
4827,3566,34,387,0,759,213,9786,4945,14731,0.0331672,0.00897327,-0.99941,1
3550,2291,25,300,0,552,171,6889,3421,10310,0.0339716,0.00499532,-0.99941,1
4644,2990,36,399,0,723,225,9017,4485,13502,0.0310107,0.00501178,-0.999507,1
4579,2937,36,359,0,742,211,8864,4720,13584,0.0323493,-0.00370581,-0.99947,1
5668,3063,29,397,0,739,207,10103,4414,14517,0.0285929,-0.00270169,-0.999587,1
5145,3558,45,481,0,801,257,10287,5121,15408,0.0254518,0.00338231,-0.999671,1
4156,2286,22,263,0,431,154,7312,2618,9930,0.0264837,0.00709258,-0.999624,1
2101,1202,13,159,0,292,91,3858,1837,5695,0.0310552,0.00960655,-0.999471,1
2274,1588,15,197,0,370,115,4559,2223,6782,0.0362797,0.0132284,-0.999254,1
4584,3099,28,416,0,748,228,9103,4294,13397,0.0344249,0.0111889,-0.999345,1
4508,3096,29,410,0,762,206,9011,4485,13496,0.0338907,0.00673473,-0.999403,1
5095,3493,33,488,0,858,262,10229,5120,15349,0.0301178,0.0121288,-0.999473,1
4644,3123,34,369,0,720,204,9094,4388,13482,0.0298083,0.0171227,-0.999409,1
4585,3133,33,362,0,725,206,9044,4385,13429,0.0310731,0.0156609,-0.999394,1
4136,2807,28,359,0,692,219,8241,4218,12459,0.0332855,0.0163398,-0.999313,1
5038,3350,30,368,0,735,222,9743,4630,14373,0.0335801,0.031625,-0.998935,1
4169,2870,28,361,0,723,222,8373,4212,12585,0.0370726,0.0474871,-0.998184,1
4280,2938,27,370,0,704,235,8554,3665,12219,0.0372021,0.0571744,-0.997671,1
4928,3155,37,427,0,771,225,9543,4706,14249,0.0419993,0.0773886,-0.996116,1
4741,3301,38,405,0,757,242,9484,286,9770,0.0601929,0.130898,-0.989567,1
5338,3760,35,436,0,881,252,10702,2461,13163,0.0584454,0.201578,-0.977727,1
3700,2752,25,364,0,610,182,7633,1457,9090,0.064714,0.195679,-0.97853,1
3658,2643,23,309,0,622,178,7433,1016,8449,0.062936,0.185366,-0.980652,1
5699,3886,29,450,0,854,264,11182,1347,12529,0.0550316,0.186793,-0.980857,1
3678,2026,16,241,0,439,139,6539,661,7200,0.0383701,0.160567,-0.986279,1
2675,1887,17,232,0,424,132,5367,697,6064,0.0358428,0.120877,-0.99202,1
5357,3825,29,436,0,868,241,10756,1488,12244,0.0481215,0.100704,-0.993752,1
5311,3924,36,472,0,941,267,10951,1567,12518,0.0524805,0.0847365,-0.995021,1
4722,3463,37,436,0,805,248,9711,1030,10741,0.050229,0.0706464,-0.996236,1
3468,2447,18,302,0,554,179,6968,1147,8115,0.0390347,0.0752061,-0.996404,1
5188,3740,29,463,0,838,280,10538,1779,12317,0.0270596,0.0873944,-0.995806,1
5127,3587,30,400,0,831,238,10213,1323,11536,0.0237266,0.0887283,-0.995773,1
4695,3183,27,421,0,729,228,9283,1960,11243,0.0335262,0.0875174,-0.995599,1
4683,3040,26,370,0,673,254,9046,3239,12285,0.0353354,0.107631,-0.993563,1
4745,2841,25,361,0,650,210,8832,2473,11305,0.0433405,0.109723,-0.993017,1
4893,2769,27,305,0,728,195,8917,2797,11714,0.0464347,0.140778,-0.988952,1
5377,2724,28,325,0,679,184,9317,2807,12124,0.0442047,0.126482,-0.990984,1
4874,2415,26,290,0,562,156,8323,3051,11374,0.0464269,0.115121,-0.992266,1
4680,2234,27,291,0,578,151,7961,2733,10694,0.0466476,0.13035,-0.99037,1
4892,2118,26,250,0,539,140,7965,2848,10813,0.0439586,0.127047,-0.990922,1
4863,2094,29,278,0,563,141,7968,2943,10911,0.0359421,0.130737,-0.990766,1
4988,2181,27,309,0,536,148,8189,3061,11250,0.0412121,0.139974,-0.989297,1
5452,2954,36,474,0,894,236,10046,2495,12541,0.0331057,0.160316,-0.98651,1
3208,1521,18,192,0,343,110,5392,1299,6691,0.0284709,0.137851,-0.990044,1
4753,2596,26,392,0,871,246,8884,2472,11356,0.0163879,0.133964,-0.990851,1
4729,2936,33,345,0,624,225,8892,1935,10827,0.0128666,0.133125,-0.991016,1
3414,2044,18,235,0,475,132,6318,1058,7376,0.0102329,0.148041,-0.988928,1
4430,2908,22,360,0,649,205,8574,785,9359,0.0262346,0.153956,-0.98773,1
4813,3243,25,436,0,751,206,9474,895,10369,0.0818308,0.0459388,-0.995587,1
3417,2406,18,261,0,555,155,6812,1314,8126,0.0800977,-0.00211036,-0.996785,1
4474,3105,23,380,0,759,220,8961,2108,11069,0.0488113,-0.013141,-0.998722,1
4919,3803,47,520,0,1029,322,10640,2479,13119,0.0378176,-0.00813154,-0.999252,1
4873,3473,26,409,0,762,240,9783,2084,11867,0.054347,0.00777575,-0.998492,1
5179,4100,33,440,0,892,259,10903,1957,12860,0.0949032,0.058409,-0.993772,1
5758,2877,26,385,0,663,161,9870,984,10854,0.106278,0.0394526,-0.993554,1
4695,2136,16,246,0,450,140,7683,1062,8745,0.0955232,0.0316704,-0.994923,1
1832,1489,10,189,0,353,105,3978,811,4789,0.0937637,0.0335219,-0.99503,1
4715,4152,26,429,0,884,241,10447,2329,12776,0.0797678,0.0557451,-0.995254,1
5024,4300,27,524,0,954,286,11115,1771,12886,0.0956319,0.0626434,-0.993443,1
5173,4514,25,534,0,1048,302,11596,1885,13481,0.0828061,0.0621697,-0.994625,1
3811,3385,19,390,0,759,220,8584,1819,10403,0.0578972,0.0651053,-0.996198,1
3902,3174,20,400,0,845,220,8561,2233,10794,0.026717,0.0432589,-0.998707,1
6418,4914,24,674,0,1194,307,13531,3591,17122,-0.00151158,0.0526989,-0.998609,1
3975,3041,16,377,0,741,194,8344,2639,10983,-0.0159628,0.0153002,-0.999756,1
4011,3042,18,408,0,774,218,8471,3014,11485,-0.0120586,-0.023256,-0.999657,1
3685,3920,18,350,0,715,197,8885,3743,12628,-0.0079403,-0.0292011,-0.999542,1
3674,2780,16,331,0,684,195,7680,3729,11409,0.00663271,-0.0821834,-0.996595,1
4583,3307,21,411,0,795,236,9353,4505,13858,0.00615669,-0.0962671,-0.995337,1
4342,3221,19,362,0,876,221,9041,3817,12858,-0.00618536,-0.0874315,-0.996151,1
5169,3785,29,506,0,914,256,10659,4395,15054,-0.0186576,-0.0613032,-0.997945,1
5218,3970,30,550,0,900,245,10913,4022,14935,-0.02417,-0.0453121,-0.998681,1
3617,2415,18,323,0,568,156,7097,2637,9734,-0.0293345,-0.028604,-0.99916,1
5835,3780,31,474,0,897,242,11259,3539,14798,-0.032452,-0.00420711,-0.999465,1
3834,2434,22,277,0,612,159,7338,2238,9576,-0.0158255,-0.0269716,-0.999511,1
3459,1953,20,253,0,468,138,6291,1656,7947,-0.000860596,-0.0117066,-0.999931,1
3592,2429,20,284,0,550,170,7045,1951,8996,0.00650268,0.00480101,-0.999967,1
3630,2416,18,294,0,559,170,7087,1871,8958,0.018336,0.00135989,-0.999831,1
4466,3163,22,358,0,718,197,8924,2672,11596,0.0146422,0.00589344,-0.999875,1
4376,3408,22,343,0,702,195,9046,2262,11308,-0.00923008,-0.00468942,-0.999946,1
4336,3139,21,391,0,746,231,8864,2163,11027,-0.0232176,-0.00135191,-0.99973,1
4446,3308,21,402,0,750,202,9129,2268,11397,-0.0264407,0.0062102,-0.999631,1
4562,3322,21,441,0,785,238,9369,2106,11475,-0.0147512,0.0171078,-0.999745,1
4284,3556,25,570,0,993,303,9731,2373,12104,-0.00701901,0.00954152,-0.99993,1
4119,3227,21,424,0,791,229,8811,1934,10745,-0.00304509,0.00724308,-0.999969,1
2988,2362,15,279,0,584,145,6373,1525,7898,-0.00718294,0.00685052,-0.999951,1
6062,3861,26,414,0,817,232,11412,2259,13671,-0.0302742,0.194592,-0.980417,1
3935,2572,14,270,0,432,124,7347,1190,8537,-0.021351,0.113475,-0.993312,1
2137,1311,9,170,0,314,96,4037,770,4807,-0.0173696,0.0590227,-0.998106,1
2683,2059,13,255,0,454,156,5620,1096,6716,-0.0160985,0.0729618,-0.997205,1
5188,4160,47,495,0,1150,385,11425,2251,13676,-0.00564664,0.0881823,-0.996089,1
5108,4225,28,460,0,955,261,11037,2143,13180,0.0222498,0.0906183,-0.995637,1
5673,4511,36,592,0,722,184,11718,1548,13266,0.021706,0.0801778,-0.996544,1
4747,4001,26,472,0,856,279,10381,2399,12780,0.0160806,0.0674557,-0.997592,1
4860,3922,27,483,0,871,269,10432,2600,13032,0.00229509,0.053871,-0.998545,1
4691,3937,36,490,0,899,250,10303,2806,13109,-0.00337771,0.0442973,-0.999013,1
5283,3903,35,446,0,913,258,10838,3254,14092,0.00544787,0.0450182,-0.998971,1
3517,2879,24,381,0,696,203,7700,2445,10145,0.00857709,0.0446753,-0.998965,1
5334,4459,39,553,0,1039,311,11735,4247,15982,0.00886735,0.064131,-0.997902,1
4710,3923,29,491,0,959,254,10366,4157,14523,0.00602586,0.0908673,-0.995845,1
5331,4284,32,583,0,1090,277,11597,4592,16189,-0.000171302,0.124164,-0.992262,1
3394,2805,20,345,0,687,175,7426,2896,10322,-0.0014571,0.109426,-0.993994,1
5557,4186,33,476,0,1018,270,11540,4008,15548,0.00813063,0.105774,-0.994357,1
3580,2950,22,367,0,732,188,7839,2846,10685,0.0129827,0.0970605,-0.995194,1
5353,4470,33,561,0,1052,295,11764,4453,16217,0.0141911,0.114866,-0.99328,1
3761,3123,28,362,0,789,214,8277,3131,11408,0.00270367,0.0935679,-0.995609,1
4002,3048,22,389,0,765,199,8425,2263,10688,0.0048929,0.103583,-0.994609,1
5325,4419,33,572,0,944,273,11566,1637,13203,-0.0132636,0.0661863,-0.997719,1
4867,4045,28,483,0,886,249,10558,1067,11625,-0.00565863,0.0118052,-0.999915,1
5412,4228,36,475,0,903,268,11322,1331,12653,-0.00589002,0.0188488,-0.999805,1
5106,3830,33,625,0,1035,251,10880,1218,12098,0.00597423,0.0307817,-0.999508,1
4573,3065,31,382,0,657,201,8909,1233,10142,0.00843319,0.0190122,-0.999784,1
5454,3059,31,358,0,810,200,9912,1640,11552,0.00458484,0.0595894,-0.998212,1
5517,2618,30,327,0,660,178,9330,1726,11056,0.00304448,0.0319702,-0.999484,1
4745,2064,26,258,0,509,142,7744,1899,9643,0.0126568,0.0473785,-0.998797,1
5465,1995,29,253,0,483,139,8364,2176,10540,0.0239126,0.0324853,-0.999186,1
5139,1635,28,217,0,368,128,7515,1990,9505,0.0490062,-0.0441807,-0.997821,1
5990,1406,29,199,0,351,116,8091,1589,9680,0.0770408,-0.069964,-0.99457,1
3252,896,18,153,0,252,78,4649,972,5621,0.0710765,-0.0736097,-0.994751,1
4867,1665,29,196,0,412,133,7302,1340,8642,0.0814566,-0.0707227,-0.994165,1
4639,1688,28,251,0,441,155,7202,1154,8356,0.0688761,-0.11014,-0.991527,1
4970,1878,33,268,0,428,129,7706,1393,9099,0.0427405,-0.102959,-0.993767,1
4825,2280,29,334,0,539,171,8178,1745,9923,0.0452608,-0.0840116,-0.995436,1
4849,2368,29,278,0,517,151,8192,1502,9694,0.0544094,-0.0699616,-0.996065,1
4831,2646,26,343,0,594,194,8634,1449,10083,0.0449352,-0.0546706,-0.997493,1
4371,2614,26,307,0,550,188,8056,1481,9537,0.0500791,-0.0329006,-0.998203,1
4499,3356,45,415,0,922,272,9509,1745,11254,0.0632909,0.0241821,-0.997702,1
3182,2180,17,316,0,509,154,6358,672,7030,0.116717,-0.0344614,-0.992567,1
4990,3609,28,492,0,872,259,10250,2825,13075,0.05402,0.0122228,-0.998465,1
5226,3730,27,384,0,591,155,10113,869,10982,0.030767,0.0294943,-0.999091,1
4217,2811,19,337,0,616,184,8184,854,9038,-0.00985494,0.104663,-0.994459,1
5244,3853,28,471,0,934,245,10775,1621,12396,-0.0177743,0.148922,-0.988689,1
5681,4141,33,465,0,929,272,11521,1513,13034,-0.00418277,0.147295,-0.989084,1
3733,2857,19,345,0,638,192,7784,1177,8961,0.00537575,0.14435,-0.989512,1
6124,4484,28,488,0,1025,293,12442,1476,13918,-0.00500006,0.219905,-0.975509,1
5553,3206,19,354,0,650,151,9933,1086,11019,-0.00438684,0.178634,-0.983906,1
2566,1824,10,185,0,415,107,5107,843,5950,0.00406118,0.0649888,-0.997878,1
2627,1882,11,228,0,463,129,5340,1471,6811,-0.0069068,0.0323024,-0.999454,1
6273,4899,24,510,0,1049,278,13033,3914,16947,-0.0123397,0.0494961,-0.998698,1
3901,2983,17,334,0,729,191,8155,3365,11520,-0.019159,0.000660472,-0.999816,1
5983,4801,31,540,0,910,196,12461,4258,16719,-0.0134553,-0.0326505,-0.999376,1
3089,2078,14,232,0,494,134,6041,2737,8778,-0.0126664,-0.0521981,-0.998557,1
6008,4045,29,501,0,959,293,11835,4358,16193,-0.0262881,-0.0383864,-0.998917,1
5896,3552,19,346,0,642,199,10654,2630,13284,-0.0236822,-0.040691,-0.998891,1
3048,2063,16,285,0,517,159,6088,2226,8314,-0.0159824,-0.051323,-0.998554,1
5783,3665,36,429,0,931,243,11087,3096,14183,-0.0129067,-0.0156665,-0.999794,1
3888,2513,20,335,0,617,165,7538,1983,9521,-0.0121861,-0.0375292,-0.999221,1
5666,4608,37,532,0,916,248,12007,2687,14694,0.0115847,0.0152626,-0.999817,1
3775,2676,22,312,0,673,181,7639,1658,9297,0.0056766,-0.0144908,-0.999879,1
5480,3922,33,506,0,964,288,11193,2331,13524,0.015818,0.000827465,-0.999875,1
5351,4139,33,521,0,945,275,11264,2130,13394,0.00527657,-0.0285625,-0.999578,1
5414,4062,27,488,0,956,252,11199,2382,13581,-0.0313201,0.0835748,-0.996009,1
4264,2637,15,227,0,459,138,7740,1046,8786,-0.0375157,0.0456522,-0.998253,1
2192,1533,12,155,0,299,89,4280,647,4927,-0.0321754,-0.0141394,-0.999382,1
5138,3680,29,504,0,1220,297,10868,1948,12816,-0.0438057,0.000844686,-0.99904,1
4972,3733,30,423,0,807,261,10226,1811,12037,-0.044524,-0.00875837,-0.99897,1
5328,3804,27,421,0,869,235,10684,1902,12586,-0.0489062,0.0773656,-0.995802,1
4213,2512,21,314,0,549,128,7737,839,8576,-0.0481189,0.0521093,-0.997481,1
1784,1305,11,151,0,283,87,3621,586,4207,-0.0389095,-0.00322364,-0.999238,1
2570,1878,13,212,0,418,138,5229,843,6072,-0.0338315,2.76417e-05,-0.999427,1
4902,3669,26,423,0,799,230,10049,1603,11652,-0.0209861,0.0122345,-0.999705,1
5352,3770,29,439,0,833,313,10736,1473,12209,5.07452e-05,0.0174971,-0.999847,1
4727,2627,19,317,0,696,177,8563,685,9248,-0.00151003,0.0123239,-0.999923,1
3059,2121,18,260,0,447,142,6047,816,6863,0.00414911,0.00836072,-0.999956,1
5150,3992,27,426,0,839,239,10673,1186,11859,0.00490096,0.0352952,-0.999365,1
6541,3944,34,495,0,799,166,11979,678,12657,0.00969597,0.0598133,-0.998163,1
3479,2593,18,334,0,578,161,7163,542,7705,-0.00729148,0.0256394,-0.999645,1
5095,3714,29,552,0,873,256,10519,612,11131,-0.0332644,0.0402465,-0.998636,1
5015,3559,34,458,0,782,258,10106,412,10518,-0.0484544,-0.0125462,-0.998747,1
4929,3654,38,474,0,652,170,9917,250,10167,-0.0803296,0.0677512,-0.994463,1
4493,3224,34,389,0,791,215,9146,611,9757,-0.0370896,0.00502628,-0.999299,1
5021,3633,40,475,0,825,245,10239,718,10957,-0.0189608,0.0013475,-0.99982,1
5144,3757,36,500,0,899,263,10599,1156,11755,-0.0127547,0.0284476,-0.999514,1
4991,3665,44,512,0,890,283,10385,1157,11542,-0.0103639,0.0287044,-0.999535,1
5381,4025,41,532,0,967,267,11213,1330,12543,-0.00962361,0.0351929,-0.999335,1
3568,2812,25,353,0,673,218,7649,1448,9097,-0.0144141,0.0129621,-0.999812,1
5403,4275,35,501,0,958,264,11436,1746,13182,-0.0123931,0.0111216,-0.999862,1
5784,4351,31,399,0,723,221,11509,702,12211,-0.0210423,0.0628453,-0.997801,1
2731,2250,16,265,0,503,141,5906,375,6281,-0.0239965,0.0701716,-0.997247,1
5363,4164,30,533,0,889,259,11238,787,12025,-0.0296996,0.0910998,-0.995399,1
5023,3630,29,407,0,849,262,10200,887,11087,-0.0274688,0.0657217,-0.99746,1
5051,3497,27,430,0,812,215,10032,940,10972,-0.0249251,0.0820437,-0.996317,1
5005,3632,28,391,0,848,261,10165,1236,11401,-0.00657576,0.0379294,-0.999259,1
3548,2164,20,275,0,500,149,6656,1100,7756,0.00697901,0.0155194,-0.999855,1
5491,2867,35,409,0,726,200,9728,1638,11366,0.0204676,0.0386675,-0.999042,1
5448,2513,32,305,0,391,111,8800,1141,9941,0.0112046,0.0484206,-0.998764,1
3624,1605,20,241,0,437,119,6046,1231,7277,-0.000894176,0.0380875,-0.999274,1
5455,2015,29,358,0,510,185,8552,2005,10557,-0.00135734,0.0396545,-0.999213,1
4858,1443,26,190,0,402,145,7064,1858,8922,0.00680829,0.00579908,-0.99996,1
4891,1386,51,275,0,476,136,7215,1802,9017,0.0144028,0.00913376,-0.999855,1
2511,701,16,92,0,178,51,3549,869,4418,0.0190982,-0.0211653,-0.999594,1
4749,1536,31,197,0,355,108,6976,1644,8620,0.0224449,-0.0166215,-0.99961,1
4802,1845,29,266,0,404,157,7503,1609,9112,0.00370938,0.00702636,-0.999969,1
3613,1621,20,189,0,327,163,5933,1098,7031,-0.0108697,-0.00949815,-0.999896,1
4379,2077,25,279,0,509,183,7452,1341,8793,-0.0190846,-0.0171966,-0.99967,1
4561,2629,36,278,0,633,184,8321,1260,9581,0.00290547,-0.0262343,-0.999652,1
5001,3016,28,491,0,996,294,9826,1373,11199,0.0267992,0.0127038,-0.99956,1
3606,2321,21,289,0,501,162,6900,765,7665,0.0707446,-0.0165462,-0.997357,1
5148,3574,30,393,0,873,281,10299,1552,11851,0.125251,-0.0313539,-0.991629,1
5302,4349,42,446,0,803,169,11111,1170,12281,0.130709,0.0143082,-0.991318,1
3859,3251,20,409,0,774,203,8516,1306,9822,0.0808491,0.0742973,-0.993953,1
4275,3805,20,434,0,878,266,9678,1810,11488,0.069798,0.15855,-0.984881,1
6431,5987,36,658,0,1339,383,14834,1846,16680,0.0568289,0.192567,-0.979637,1
4360,3748,19,461,0,871,266,9725,1823,11548,0.0567386,0.179242,-0.982168,1
3250,3334,20,376,0,777,216,7973,1916,9889,0.0432717,0.130987,-0.990439,1
6972,5353,32,591,0,1203,339,14490,3071,17561,0.0126326,0.072939,-0.997257,1
3972,3240,19,364,0,712,210,8517,2285,10802,-0.0179871,-0.0383774,-0.999102,1
2950,2702,17,325,0,794,199,6987,2697,9684,-0.0309083,-0.0625538,-0.997563,1
4324,3408,22,394,0,786,230,9164,3149,12313,-0.0471949,-0.0254196,-0.998563,1
4532,3345,21,409,0,798,230,9335,2814,12149,-0.0506442,-0.00633736,-0.998697,1
5494,4245,36,471,0,900,270,11416,3038,14454,-0.0558135,-0.00233871,-0.998439,1
3643,2760,19,351,0,631,192,7596,1867,9463,-0.0547508,-0.0116073,-0.998433,1
5614,4278,32,526,0,989,321,11760,2175,13935,-0.0562587,-0.00865791,-0.998379,1
3892,2939,27,326,0,639,186,8009,1855,9864,-0.0435746,-0.0338262,-0.998478,1
6070,4039,30,500,0,1167,299,12105,2450,14555,-0.0351113,-0.0372208,-0.99869,1
5590,4008,29,450,0,891,262,11230,2324,13554,-0.0152176,0.0868459,-0.996106,1
4927,2537,19,240,0,479,137,8339,1160,9499,-0.022275,0.0519502,-0.998401,1
1885,1376,9,150,0,305,85,3810,654,4464,-0.0323296,-0.0275208,-0.999098,1
2383,1794,14,246,0,475,125,5037,949,5986,-0.0253574,-0.017753,-0.999521,1
5151,3594,25,545,0,1130,298,10743,1789,12532,-0.0263616,0.0552093,-0.998127,1
4886,3513,23,353,0,746,224,9745,1630,11375,-0.0350473,0.0777186,-0.996359,1
4316,3099,22,349,0,687,233,8706,1484,10190,-0.0304525,0.0847536,-0.995937,1
4519,3120,22,387,0,707,198,8953,1260,10213,-0.0203479,0.0957056,-0.995202,1
4498,3151,23,461,0,729,227,9089,1000,10089,-0.00628073,0.0971471,-0.99525,1
4783,3479,28,462,0,771,212,9735,953,10688,6.9659e-05,0.106202,-0.994344,1
4896,3574,29,453,0,769,247,9968,788,10756,-0.00400207,0.0784054,-0.996914,1
4340,2952,27,361,0,712,191,8583,552,9135,-0.0147893,0.105822,-0.994275,1
4712,3237,27,417,0,788,205,9386,461,9847,-0.00319694,0.0967349,-0.995305,1
4765,3054,41,389,0,714,226,9189,338,9527,-0.00971285,0.0465246,-0.99887,1
4358,2697,25,356,0,611,189,8236,395,8631,-0.0349161,0.102749,-0.994094,1
4762,3092,29,402,0,693,227,9205,892,10097,-0.0269005,0.0863626,-0.995901,1
4819,3355,38,410,0,765,220,9607,967,10574,-0.0176782,0.0651459,-0.997719,1
5075,3305,30,378,0,733,210,9731,1110,10841,-0.000899883,0.0456111,-0.998959,1
5035,3473,29,437,0,701,168,9843,758,10601,0.00572516,0.0465617,-0.998899,1
4600,3015,30,404,0,735,198,8982,1031,10013,0.0043796,0.0488769,-0.998795,1
4954,3245,30,430,0,810,251,9720,1010,10730,0.00285374,0.0538996,-0.998542,1
5694,3862,33,435,0,851,243,11118,1097,12215,-0.0218126,0.0850045,-0.996142,1
3761,3000,31,411,0,729,191,8123,565,8688,-0.0338409,0.0777322,-0.9964,1
4881,3909,26,497,0,868,286,10467,532,10999,-0.0320573,0.103082,-0.994156,1
5943,3524,27,439,0,933,218,11084,652,11736,-0.0259664,0.087091,-0.995862,1
4492,3211,24,347,0,702,208,8984,484,9468,-0.0244255,0.0599978,-0.9979,1
5023,3307,35,382,0,699,229,9675,597,10272,-0.0165725,0.0435801,-0.998913,1
4764,3103,25,312,0,667,220,9091,582,9673,-0.0104456,0.0195801,-0.999754,1
4854,2884,27,338,0,691,187,8981,617,9598,-0.00490673,-0.0102868,-0.999935,1
4867,3114,35,511,0,930,249,9706,1057,10763,-0.00181065,-0.025464,-0.999674,1
4412,2602,24,352,0,645,165,8200,698,8898,0.00537191,-0.0231767,-0.999717,1
4530,2488,24,331,0,586,161,8120,860,8980,0.0119403,-0.0373744,-0.99923,1
4600,2736,25,283,0,545,157,8346,969,9315,0.0190574,-0.0348341,-0.999212,1
5322,2577,29,358,0,629,186,9101,1051,10152,0.019649,-0.0270111,-0.999442,1
4078,2255,27,267,0,538,167,7332,1004,8336,0.0218356,-0.0235027,-0.999485,1
5047,2426,29,309,0,565,179,8555,1151,9706,0.0270324,-0.00364346,-0.999628,1
4667,2376,25,280,0,550,177,8075,1218,9293,0.0270999,-0.0066183,-0.999611,1
4239,2194,22,355,0,476,161,7447,1154,8601,0.0241619,-0.0115673,-0.999641,1
4445,2040,22,249,0,512,212,7480,1492,8972,0.0168379,0.000538722,-0.999858,1
5496,2391,34,311,0,568,157,8957,1535,10492,0.00275183,0.0182601,-0.99983,1
5392,2066,24,263,0,447,129,8321,1356,9677,-0.00738075,0.00754993,-0.999944,1
5336,1966,29,244,0,458,135,8168,1588,9756,-0.00272877,-0.0149887,-0.999884,1
5074,1840,33,282,0,642,200,8071,1688,9759,-0.00396775,-0.0292059,-0.999566,1
4628,1565,24,197,0,372,110,6896,1387,8283,-0.00426806,-0.0525586,-0.998609,1
4364,1586,24,213,0,418,138,6743,1462,8205,-0.0050763,-0.0749164,-0.997177,1
4312,1551,26,210,0,371,131,6601,1848,8449,0.000443232,-0.0782036,-0.996937,1
4477,1563,28,230,0,382,107,6787,1520,8307,-0.000271004,-0.0820968,-0.996625,1
4709,1726,26,193,0,374,115,7143,1576,8719,0.00551345,-0.0704416,-0.997501,1
4809,1786,29,257,0,405,116,7402,1208,8610,0.00718629,-0.105962,-0.994344,1
4847,1572,29,262,0,377,108,7195,1261,8456,0.00442899,-0.229948,-0.973193,1
7258,1585,30,277,0,448,113,9711,1134,10845,0.00595783,-0.250464,-0.968107,1
4376,1555,28,193,0,411,124,6687,926,7613,0.00943029,-0.136423,-0.990606,1
4330,1851,31,232,0,424,133,7001,1341,8342,0.0144708,-0.141345,-0.989855,1
4807,2311,34,327,0,522,161,8162,1418,9580,0.00711873,-0.103942,-0.994558,1
4477,2221,24,323,0,525,142,7712,1285,8997,-0.00338219,-0.131479,-0.991313,1
4860,2606,30,308,0,584,178,8566,1550,10116,-0.0148181,-0.0849189,-0.996278,1
4490,2404,31,289,0,525,166,7905,1564,9469,-0.0199183,-0.061159,-0.997929,1
3910,2235,23,267,0,500,146,7081,1492,8573,-0.0251906,-0.0305853,-0.999215,1
4078,2594,49,295,0,521,179,7716,1471,9187,-0.0331077,-0.0194899,-0.999262,1
4003,2453,27,284,0,611,166,7544,1466,9010,-0.0325276,-0.0170388,-0.999326,1
5130,3281,32,402,0,776,217,9838,1369,11207,-0.0243242,0.122535,-0.992166,1
4579,3210,27,405,0,786,207,9214,845,10059,0.036895,0.198769,-0.979352,1
5005,3762,32,416,0,874,228,10317,973,11290,0.108093,0.163656,-0.980578,1
5042,4265,26,448,0,936,253,10970,986,11956,0.202051,0.0590796,-0.977592,1
3698,3290,22,350,0,749,199,8308,752,9060,0.189373,0.0622139,-0.979932,1
5310,4620,31,537,0,1101,290,11889,1557,13446,0.147137,0.0971569,-0.984333,1
5678,4657,26,513,0,1077,283,12234,2101,14335,0.0849966,0.112212,-0.990043,1
3988,3327,44,372,0,788,208,8727,1817,10544,0.0424764,0.0923344,-0.994822,1
5095,4338,23,483,0,1072,273,11284,2484,13768,0.00560416,0.082386,-0.996585,1
6274,5208,24,587,0,1244,332,13669,2262,15931,0.00813628,0.0613523,-0.998083,1
3195,2632,17,344,0,660,172,7020,1854,8874,0.00802821,0.0211955,-0.999744,1
5487,4397,28,534,0,1031,317,11794,3728,15522,-0.015458,-0.0612126,-0.998005,1
4698,3464,28,394,0,820,262,9666,4242,13908,-0.0219012,-0.0382788,-0.999027,1
4660,3431,27,374,0,746,218,9456,3223,12679,-0.0466315,-0.00726843,-0.998886,1
3323,2294,23,249,0,713,144,6746,2006,8752,-0.0570575,-0.021105,-0.998148,1
5567,3611,30,407,0,848,227,10690,2987,13677,-0.0674737,-0.00426406,-0.997712,1
5601,3531,54,435,0,816,245,10682,2769,13451,-0.0620065,0.0140663,-0.997977,1
3804,2510,21,298,0,570,160,7363,1715,9078,-0.0516725,-0.00495244,-0.998652,1
5484,3613,26,372,0,813,209,10517,2223,12740,-0.0441967,-0.00550678,-0.999008,1
4915,3300,29,402,0,735,218,9599,2012,11611,-0.0386776,-0.00294427,-0.999248,1
4839,3296,24,376,0,733,206,9474,1832,11306,-0.0381104,0.00562908,-0.999258,1
4710,3302,23,361,0,724,249,9369,1730,11099,-0.0396101,0.0175008,-0.999062,1
4641,3322,23,413,0,754,214,9367,1557,10924,-0.0419928,0.0709151,-0.996598,1
5181,3488,28,415,0,817,232,10161,1559,11720,-0.0387271,0.0638831,-0.997206,1
4463,3109,50,355,0,678,205,8860,1426,10286,-0.0418262,0.100128,-0.994095,1
4848,3436,25,429,0,773,245,9756,1553,11309,-0.0403506,0.0980882,-0.994359,1
4761,3371,27,431,0,826,223,9639,1404,11043,-0.0443182,0.0953437,-0.994458,1
4866,3198,25,386,0,610,143,9228,701,9929,-0.0463046,0.0843372,-0.995361,1
3228,2062,20,247,0,461,141,6159,561,6720,-0.058336,0.0681389,-0.995969,1
4688,2805,29,402,0,633,198,8755,541,9296,-0.0695183,0.126622,-0.989512,1
6755,3521,22,365,0,595,169,11427,367,11794,-0.0802822,0.189528,-0.978588,1
2313,1309,14,165,0,292,84,4177,207,4384,-0.0497749,0.0920683,-0.994508,1
4282,1859,20,217,0,412,117,6907,337,7244,-0.0550665,0.177313,-0.982613,1
2452,1342,15,164,0,344,92,4409,311,4720,-0.0842505,0.129446,-0.988001,1
4777,2963,30,350,0,661,205,8986,433,9419,-0.0617554,0.156871,-0.985686,1
4610,2945,30,371,0,951,267,9174,640,9814,-0.0494378,0.0697603,-0.996338,1
5277,3345,31,477,0,811,223,10164,731,10895,-0.024797,0.0128623,-0.99961,1
4809,3389,33,580,0,932,250,9993,710,10703,-0.0227585,0.00431354,-0.999732,1
4645,3409,28,391,0,750,235,9458,428,9886,-0.0219381,-0.00691019,-0.999736,1
5329,4809,30,454,0,859,246,11727,805,12532,0.0372492,0.476981,-0.878124,1
5357,4717,36,649,0,1261,309,12329,474,12803,0.0743172,0.48304,-0.872439,1
5211,3885,35,610,0,971,265,10977,704,11681,0.0554011,0.513058,-0.856565,1
5286,3286,55,455,0,735,243,10060,646,10706,0.0632472,0.567055,-0.821248,1
5109,3247,27,403,0,695,227,9708,664,10372,0.00728529,0.500459,-0.86573,1
5069,2869,29,373,0,614,202,9156,687,9843,-0.0571654,0.0309368,-0.997885,1
4901,2326,25,327,0,539,176,8294,384,8678,-0.0836376,-0.0367728,-0.995818,1
4947,2148,35,286,0,540,163,8119,460,8579,-0.077682,-0.0443528,-0.995991,1
4758,1931,45,227,0,436,126,7523,416,7939,-0.057404,-0.0958066,-0.993743,1
5342,1918,32,242,0,450,137,8121,979,9100,-0.0359653,-0.0385013,-0.998611,1
5348,1781,31,264,0,413,143,7980,1108,9088,-0.0319538,-0.032809,-0.998951,1
5244,1468,35,227,0,347,100,7421,865,8286,-0.0478969,-0.0858455,-0.995157,1
5278,1174,35,230,0,295,91,7103,1182,8285,-0.0493005,-0.0328504,-0.998243,1
4771,1087,27,150,0,281,82,6398,1132,7530,-0.0528458,-0.0126755,-0.998522,1
5056,1325,55,188,0,363,110,7097,1267,8364,-0.048295,-0.0278419,-0.998445,1
4843,1127,28,158,0,279,86,6521,1317,7838,-0.0444915,-0.0280536,-0.998616,1
4660,1241,44,154,0,276,83,6458,1083,7541,-0.0358169,-0.0202729,-0.999153,1
4078,1312,27,180,0,319,123,6039,1094,7133,-0.0472326,-0.0459654,-0.997826,1
4672,1625,34,218,0,412,127,7088,1451,8539,-0.0618401,-0.0189665,-0.997906,1
4525,1903,34,246,0,437,174,7319,1425,8744,-0.0726757,-0.0121279,-0.997282,1
4806,2200,28,306,0,587,175,8102,1344,9446,-0.079206,0.00261762,-0.996855,1
4212,2397,33,385,0,657,171,7855,1393,9248,-0.06411,-0.0134375,-0.997852,1
4461,2362,29,295,0,509,182,7838,1249,9087,-0.0613376,-0.0376555,-0.997406,1
4476,2324,30,290,0,519,147,7786,1447,9233,-0.069662,-0.0285508,-0.997162,1
4039,2181,33,258,0,455,146,7112,1590,8702,-0.0583132,-0.0150762,-0.998185,1
4555,2509,32,300,0,588,201,8185,1620,9805,-0.052361,-0.00441541,-0.998618,1
4714,2632,49,334,0,609,182,8520,1028,9548,-0.0228642,0.0256425,-0.99941,1
4772,2964,28,337,0,699,213,9013,970,9983,0.0318015,0.0201488,-0.999291,1
4941,3432,28,440,0,817,248,9906,1193,11099,0.0919,-0.0209225,-0.995548,1
5510,4235,34,483,0,1022,284,11568,1633,13201,0.0550216,0.0398742,-0.997689,1
5155,4194,34,551,0,1030,284,11248,1971,13219,0.00744087,0.095123,-0.995438,1
6990,4928,20,417,0,858,246,13459,1611,15070,-0.0107709,0.119387,-0.992789,1
6476,4002,18,397,0,792,206,11891,1425,13316,-0.00590583,0.125606,-0.992063,1
3140,2532,16,304,0,627,167,6786,1242,8028,0.00975862,0.130282,-0.991429,1
6138,4358,25,499,0,1039,276,12335,1920,14255,0.0267929,0.182951,-0.982757,1
3883,2862,19,359,0,685,205,8013,1703,9716,0.00416246,0.152503,-0.988295,1
4579,3161,23,360,0,753,206,9082,2047,11129,-0.04156,-0.0565817,-0.997532,1
5040,3335,27,481,0,854,245,9982,3839,13821,-0.070231,-0.0581595,-0.995834,1
5148,3240,20,290,0,543,150,9391,2318,11709,-0.0679444,-0.0804324,-0.994442,1
2756,1752,21,203,0,411,114,5257,1656,6913,-0.0642442,-0.089121,-0.993947,1
5476,3291,30,381,0,770,206,10154,2693,12847,-0.0568012,-0.0393134,-0.997611,1
3707,2524,24,266,0,535,147,7203,1806,9009,-0.0526313,-0.0548208,-0.997108,1
5017,3293,27,392,0,761,220,9710,2775,12485,-0.0354691,-0.0506665,-0.998086,1
6045,3847,29,417,0,914,233,11485,2420,13905,-0.0320969,-0.0620263,-0.997558,1
3827,2593,19,324,0,597,161,7521,1571,9092,-0.0333522,-0.0675235,-0.99716,1
4968,3417,25,430,0,794,215,9849,1958,11807,-0.04116,-0.0663636,-0.996946,1
5417,3833,51,418,0,963,240,10922,1993,12915,-0.0352298,0.0890883,-0.995401,1
5327,3189,19,325,0,592,165,9617,1367,10984,-0.0551326,0.0706437,-0.995977,1
2457,1504,11,195,0,344,95,4606,736,5342,-0.0597403,-0.00729551,-0.998187,1
1754,1215,10,146,0,276,77,3478,568,4046,-0.0669052,-0.0181985,-0.997594,1
4857,3175,25,360,0,705,208,9330,1444,10774,-0.0747461,0.0283394,-0.9968,1
4514,2897,25,363,0,645,188,8632,1322,9954,-0.0778947,0.0443925,-0.995973,1
4474,2813,24,335,0,630,179,8455,1227,9682,-0.0658385,0.0407475,-0.996998,1
4494,2681,26,320,0,691,182,8394,1193,9587,-0.0647594,0.045586,-0.99686,1
4432,2716,27,315,0,590,195,8275,919,9194,-0.0446759,0.0551991,-0.997475,1
4556,2540,25,299,0,658,178,8256,828,9084,-0.0450189,0.0577151,-0.997318,1
4344,2367,22,293,0,568,192,7786,462,8248,-0.0691081,0.0642609,-0.995538,1
3875,1923,23,287,0,495,152,6755,572,7327,-0.0485643,0.0135916,-0.998728,1
3876,1936,22,262,0,492,154,6742,349,7091,-0.067739,0.0272249,-0.997332,1
4031,1776,22,265,0,400,145,6639,344,6983,0.0887739,0.197053,-0.976365,1
4192,1489,21,226,0,369,134,6431,337,6768,0.0462354,0.218163,-0.974817,1
4383,1329,16,167,0,286,105,6286,293,6579,0.0750772,0.163447,-0.983691,1
4524,1873,23,315,0,535,136,7406,395,7801,0.142443,0.237806,-0.960811,1
4786,2482,24,317,0,801,243,8653,605,9258,0.0658297,0.0620726,-0.995898,1
3153,1783,15,250,0,433,135,5769,319,6088,0.0725017,0.0311281,-0.996883,1
6147,3400,37,453,0,748,240,11025,434,11459,0.154418,0.019229,-0.987818,1
5311,3573,24,369,0,505,164,9946,187,10133,-0.123231,-0.0986636,-0.987461,1
4261,2868,22,338,0,617,184,8290,-1000,-1000,-1,-1,-1,1
4133,2692,24,297,0,611,165,7922,301,8223,-0.05501,0.141786,-0.988367,1
4210,2469,25,284,0,578,159,7725,290,8015,-0.0683395,-0.0199671,-0.997462,1
4529,2576,31,331,0,558,171,8196,-1000,-1000,-1,-1,-1,1
4703,2418,35,282,0,529,161,8128,601,8729,-0.0356239,-0.0606422,-0.997524,1
4640,2156,41,263,0,515,162,7777,782,8559,-0.0237398,-0.0315901,-0.999219,1
4910,2097,31,294,0,492,149,7973,819,8792,-0.0197584,-0.0144568,-0.9997,1
4870,2067,54,277,0,578,146,7992,890,8882,-0.0204703,-0.00635788,-0.99977,1
4901,1957,30,244,0,440,141,7713,1108,8821,-0.0287477,-0.0326442,-0.999053,1
5312,2143,33,289,0,480,163,8420,1350,9770,-0.0292707,-0.0512879,-0.998255,1
5303,2249,29,300,0,592,163,8636,1424,10060,-0.0140091,-0.0667511,-0.997672,1
4796,2144,36,339,0,547,145,8007,1438,9445,0.00396755,-0.0870076,-0.9962,1
4897,2092,32,276,0,490,150,7937,1636,9573,0.0035382,-0.0918074,-0.995771,1
4464,1874,24,221,0,461,126,7170,1299,8469,-0.0126267,-0.0705102,-0.997431,1
4347,2102,34,278,0,465,159,7385,1560,8945,-0.0273312,-0.0655356,-0.997476,1
4782,1762,28,267,0,414,125,7378,1483,8861,-0.0352276,-0.0366198,-0.998708,1
4694,1903,26,218,0,381,136,7358,1436,8794,-0.0409871,-0.036335,-0.998499,1
4208,1547,28,225,0,430,131,6569,1477,8046,-0.0383165,-0.0367111,-0.998591,1
4949,1470,27,197,0,343,122,7108,1486,8594,-0.0300161,-0.025411,-0.999226,1
3865,1219,33,167,0,301,93,5678,1617,7295,-0.0308409,-0.00384207,-0.999517,1
4155,1269,26,170,0,307,91,6018,1542,7560,-0.0137953,-0.0321695,-0.999387,1
4383,1490,37,249,0,429,135,6723,2024,8747,-0.00813063,-0.023879,-0.999682,1
4357,1830,28,268,0,468,157,7108,1957,9065,-0.0527596,0.0734464,-0.995903,1
4404,1756,25,191,0,322,111,6809,1190,7999,-0.0593866,0.0182027,-0.998069,1
2231,1254,14,148,0,332,101,4080,913,4993,-0.059026,-0.0422485,-0.997362,1
3991,2198,21,259,0,518,157,7144,1461,8605,-0.0875731,-0.047558,-0.995022,1
4610,3561,26,426,0,817,238,9678,2497,12175,-0.0885777,-0.0615707,-0.994164,1
3360,2708,18,303,0,648,173,7210,1785,8995,-0.0798422,-0.0740613,-0.994052,1
5449,4860,33,556,0,1161,310,12369,2620,14989,-0.0898249,-0.0501108,-0.994696,1
5838,5592,30,632,0,1302,347,13741,2616,16357,-0.0713552,-0.0323295,-0.996927,1
3253,4289,18,372,0,727,196,8855,2029,10884,-0.0432938,-0.0427847,-0.998146,1
6035,5707,24,607,0,1248,353,13974,3544,17518,-0.0370201,-0.035755,-0.998675,1
5697,5272,30,595,0,1208,344,13146,2817,15963,-0.0319461,-0.0572783,-0.997847,1
3087,2864,13,336,0,648,236,7184,2235,9419,-0.0290058,-0.108353,-0.993689,1
6051,5156,27,578,0,1206,320,13338,4202,17540,-0.0338426,-0.087641,-0.995577,1
3740,3040,25,367,0,706,210,8088,2543,10631,-0.0457189,-0.0890308,-0.994979,1
5209,3954,27,486,0,728,197,10601,2047,12648,-0.0403899,-0.0511329,-0.997875,1
2782,2094,16,258,0,496,147,5793,1433,7226,-0.0417559,-0.0717385,-0.996549,1
5718,4054,35,449,0,909,264,11429,2582,14011,-0.0264765,-0.0241449,-0.999358,1
5863,4402,32,483,0,894,279,11953,1920,13873,-0.0244042,-0.0410694,-0.998858,1
3999,2930,20,331,0,666,195,8141,1797,9938,-0.0363337,-0.079482,-0.996174,1
3144,2186,18,251,0,470,147,6216,1187,7403,-0.0430661,-0.0825905,-0.995653,1
6296,4178,32,462,0,952,246,12166,2069,14235,-0.0481208,-0.059448,-0.997071,1
5554,3771,32,429,0,829,249,10864,1858,12722,-0.0565431,-0.00746183,-0.998372,1
3515,2404,20,317,0,532,160,6948,1146,8094,-0.0582979,-0.0136817,-0.998206,1
3337,2077,17,244,0,472,175,6322,1031,7353,-0.0696892,-0.0352738,-0.996945,1
4596,2540,22,314,0,553,162,8187,1406,9593,-0.0512334,0.0356714,-0.998049,1
3944,2296,22,303,0,643,155,7363,1130,8493,-0.045283,0.03178,-0.998469,1
4378,2496,29,283,0,527,157,7870,916,8786,-0.0303722,0.102318,-0.994288,1
3828,2151,22,248,0,459,156,6864,568,7432,-0.0313314,0.115528,-0.99281,1
4222,2240,26,332,0,557,152,7529,637,8166,-0.0297962,0.132605,-0.990721,1
4424,2217,24,323,0,511,144,7643,511,8154,-0.0363394,0.241848,-0.969634,1
4274,2193,27,301,0,504,143,7442,406,7848,-0.0479568,0.232695,-0.971367,1
4755,2334,33,317,0,512,174,8125,358,8483,-0.0842963,0.268298,-0.959641,1
4427,2524,31,313,0,537,160,7992,1067,9059,-0.0664396,0.0813541,-0.994469,1
4629,2902,26,354,0,634,185,8730,1115,9845,-0.0395398,0.106651,-0.99351,1
5775,3655,42,516,0,785,241,11014,499,11513,-0.013378,0.205632,-0.978538,1
5551,3938,38,475,0,918,268,11188,746,11934,0.0194104,0.196499,-0.980312,1
4969,4035,35,449,0,874,253,10615,850,11465,0.0298251,0.17613,-0.983915,1
4936,4089,33,496,0,914,271,10739,871,11610,0.006782,0.169911,-0.985436,1
4916,4161,32,550,0,932,313,10904,538,11442,-0.0252212,0.125968,-0.991713,1
5743,4844,32,473,0,981,261,12334,448,12782,0.0502487,0.108233,-0.992855,1
3907,2676,16,271,0,457,148,7475,267,7742,0.0413446,-0.0169447,-0.999001,1
1844,1393,10,174,0,298,96,3815,232,4047,0.0121081,-0.0779461,-0.996884,1
2979,2166,16,262,0,475,148,6046,375,6421,0.00833295,-0.0867256,-0.996197,1
4973,3438,29,434,0,716,231,9821,581,10402,-0.00927325,-0.0606807,-0.998114,1
4872,3257,32,359,0,731,203,9454,526,9980,-0.0295009,0.0190907,-0.999383,1
4740,3082,24,361,0,759,196,9162,585,9747,-0.0363649,0.0122191,-0.999264,1
4681,3156,26,406,0,745,220,9234,672,9906,-0.0385875,-0.027908,-0.998866,1
5057,3166,38,367,0,712,218,9558,980,10538,-0.0286922,-0.030456,-0.999124,1
4804,2784,36,398,0,632,187,8841,1229,10070,-0.01991,-0.0500438,-0.998549,1
5052,2662,31,310,0,611,197,8863,1170,10033,-0.0100507,-0.0402543,-0.999139,1
5387,2707,35,322,0,584,212,9247,1297,10544,-0.00846627,-0.0522407,-0.998599,1
5130,2142,25,265,0,528,175,8265,1398,9663,-0.00817836,-0.0498053,-0.998725,1
4991,1649,29,229,0,411,117,7426,1450,8876,0.000320262,0.0428807,-0.99908,1
4207,939,30,158,0,255,85,5674,1310,6984,-0.00125866,0.0066,-0.999977,1
2820,618,22,104,0,163,55,3782,674,4456,-0.00389826,-0.0736375,-0.997277,1
2366,590,19,78,0,164,45,3262,773,4035,-0.0163094,-0.0950489,-0.995339,1
4225,1124,34,173,0,242,90,5888,1298,7186,-0.0308469,-0.0397807,-0.998732,1
4125,1076,41,175,0,244,90,5751,1172,6923,-0.0193599,-0.0651059,-0.997691,1
4149,1120,35,160,0,254,104,5822,1287,7109,-0.0205964,-0.0461932,-0.99872,1
4166,1357,34,218,0,328,115,6218,1601,7819,-0.0202828,-0.0318659,-0.999286,1
4327,1367,31,226,0,404,101,6456,1476,7932,-0.0318263,0.00161221,-0.999492,1
4189,1408,52,173,0,426,100,6348,1505,7853,-0.0487413,-0.0310986,-0.998327,1
4280,1568,28,288,0,444,138,6746,1801,8547,-0.0471514,-0.0182444,-0.998721,1
3835,1696,24,253,0,424,122,6354,802,7156,-0.033039,0.0347032,-0.998851,1
3947,1925,24,266,0,462,140,6764,650,7414,0.0112256,0.135948,-0.990653,1
4347,2306,25,311,0,586,170,7745,665,8410,0.0496868,0.260982,-0.964064,1
4374,2911,31,366,0,692,214,8588,805,9393,0.0394278,0.331613,-0.942592,1
4644,3808,30,453,0,877,248,10060,1054,11114,0.0223895,0.365788,-0.930429,1
5395,4870,33,563,0,1169,309,12339,1269,13608,0.0176134,0.396563,-0.917839,1
5411,4994,25,586,0,1155,311,12482,1077,13559,0.0237121,0.451112,-0.892153,1
5904,5471,43,649,0,896,245,13208,804,14012,0.0292587,0.499947,-0.865562,1
5155,4903,25,559,0,1149,319,12110,1090,13200,0.0321006,0.57361,-0.818499,1
5064,4951,23,532,0,1102,295,11967,1145,13112,0.0521566,0.653473,-0.755151,1
5522,4983,30,558,0,1125,320,12538,-1000,-1000,-1,-1,-1,1
5355,4750,31,537,0,1045,283,12001,3342,15343,-0.00474049,-0.0385795,-0.999245,1
3946,3142,22,347,0,698,199,8354,2207,10561,-0.0108427,-0.0674276,-0.997665,1
5277,4294,26,484,0,953,264,11298,2830,14128,-0.0225867,-0.0726345,-0.997103,1
5268,4244,40,483,0,997,269,11301,2663,13964,-0.0401216,-0.0656991,-0.997032,1
5005,3799,27,413,0,863,260,10367,2208,12575,-0.0401617,-0.0706735,-0.996691,1
4714,3759,29,432,0,810,238,9982,2185,12167,-0.0437587,-0.0809451,-0.995758,1
4611,3693,30,501,0,828,267,9930,1984,11914,-0.044162,-0.0870924,-0.995221,1
5613,4249,25,510,0,890,266,11553,2048,13601,-0.0404703,-0.0867876,-0.995405,1
4932,3814,26,517,0,946,192,10427,1410,11837,-0.0361256,-0.0894557,-0.995336,1
4340,3302,29,408,0,747,212,9038,1512,10550,-0.024288,-0.096957,-0.994992,1
4280,3028,22,355,0,809,191,8685,1454,10139,-0.0375329,-0.106652,-0.993588,1
5269,3451,32,444,0,804,230,10230,1574,11804,-0.0469053,-0.0504912,-0.997622,1
4901,3394,31,427,0,764,233,9750,1523,11273,-0.056927,-0.0293413,-0.997947,1
4164,2653,27,306,0,565,177,7892,1204,9096,-0.0691756,-0.0266333,-0.997249,1
2896,1635,19,211,0,362,115,5238,773,6011,-0.0589151,-0.0229433,-0.997999,1
3741,2075,27,267,0,511,151,6772,1096,7868,-0.0425579,-0.018184,-0.998928,1
4109,2216,30,340,0,663,184,7542,1304,8846,-0.0260242,0.0267852,-0.999302,1
4055,2205,25,311,0,512,147,7255,1152,8407,-0.0282788,0.0217927,-0.999363,1
4156,2489,27,359,0,506,142,7679,858,8537,-0.0210577,0.0569616,-0.998154,1
4116,2066,26,301,0,492,159,7160,741,7901,-0.0102723,0.166128,-0.986051,1
4177,2224,26,294,0,479,157,7357,654,8011,-0.00894415,0.163683,-0.986472,1
3955,1383,31,186,0,333,125,6013,342,6355,-0.0198372,0.0588215,-0.998072,1
2605,1291,17,159,0,279,82,4433,243,4676,-0.00461642,0.112785,-0.993609,1
4402,2327,29,268,0,527,144,7697,448,8145,-0.00164549,0.0979629,-0.995189,1
4489,2682,30,317,0,576,163,8257,476,8733,0.0193284,0.213704,-0.976707,1
4879,3043,38,389,0,664,220,9233,593,9826,-0.0204583,0.202282,-0.979114,1
4010,2549,24,365,0,633,187,7768,516,8284,-0.0736329,0.143426,-0.986918,1
3697,2825,23,360,0,676,229,7810,462,8272,-0.0816005,0.0791329,-0.993519,1
5804,4663,45,556,0,989,329,12386,491,12877,-0.0179501,0.0792836,-0.99669,1
3927,3185,21,340,0,699,208,8380,309,8689,-0.0184185,0.0791519,-0.996693,1
5620,4547,31,474,0,937,266,11875,412,12287,-0.0041652,0.0952159,-0.995448,1
3852,2850,24,357,0,614,186,7883,320,8203,-0.0116592,0.0656093,-0.997777,1
5545,3356,30,456,0,897,213,10497,629,11126,-0.0150913,0.0618082,-0.997974,1
5513,2788,32,358,0,645,173,9509,687,10196,0.000992064,0.045129,-0.998981,1
5114,2139,28,306,0,503,142,8232,914,9146,0.00262639,0.0235692,-0.999719,1
4735,1810,35,264,0,450,119,7413,1148,8561,0.0103816,0.000518046,-0.999946,1
5258,1657,28,226,0,384,110,7663,1239,8902,0.0129011,-0.00193541,-0.999915,1
4539,1641,28,248,0,405,142,7003,1210,8213,-0.0013447,-0.0218415,-0.999761,1
4353,1609,28,237,0,383,112,6722,1239,7961,-0.00383687,-0.0532416,-0.998574,1
4443,1622,28,245,0,384,118,6840,1297,8137,-0.00130746,-0.0563874,-0.998408,1
4425,1972,33,292,0,473,156,7351,1534,8885,0.00832679,-0.0712116,-0.997426,1
4362,1376,27,186,0,322,99,6372,1430,7802,0.00987781,-0.0697422,-0.997516,1
4211,1450,34,240,0,434,109,6478,1194,7672,0.0101563,-0.0830683,-0.996492,1
4187,1293,26,193,0,327,103,6129,894,7023,0.00981056,-0.0957081,-0.995361,1
4733,1192,27,187,0,329,88,6556,867,7423,0.00559741,-0.127995,-0.991759,1
4293,1169,33,191,0,286,82,6054,777,6831,0.00555273,-0.139808,-0.990163,1
4141,1030,25,181,0,277,96,5750,746,6496,0.0265887,-0.228206,-0.97325,1
4172,959,26,170,0,272,71,5670,700,6370,0.0288842,-0.206201,-0.978084,1
3925,934,28,167,0,269,69,5392,749,6141,0.0452307,-0.268587,-0.962193,1
3921,880,28,158,0,214,82,5283,629,5912,0.0563901,-0.336946,-0.939834,1
3910,1059,28,200,0,244,76,5517,617,6134,0.0387267,-0.434839,-0.899675,1
3922,1183,34,163,0,283,83,5668,642,6310,0.0699736,-0.37117,-0.925925,1
3868,1214,28,198,0,299,86,5693,679,6372,0.0184255,-0.463359,-0.885979,1
3911,1475,29,233,0,362,105,6115,1248,7363,0.00785116,-0.315683,-0.948832,1
3942,1514,30,235,0,380,135,6236,1520,7756,0.0168436,-0.194508,-0.980756,1
4041,1535,29,235,0,405,110,6355,1466,7821,0.017011,-0.0956024,-0.995274,1
3896,1521,29,231,0,381,111,6169,1262,7431,0.00994967,-0.0683601,-0.997611,1
4062,1533,30,237,0,394,112,6368,1112,7480,0.00766234,-0.0302121,-0.999514,1
4091,1712,40,271,0,633,164,6911,1072,7983,0.003249,-0.00396506,-0.999987,1
3949,1708,24,263,0,523,130,6597,681,7278,0.0726475,-0.00209339,-0.997356,1
4337,2504,27,369,0,600,161,7998,978,8976,0.143736,0.0454019,-0.988574,1
4699,2797,25,368,0,694,183,8766,1506,10272,0.186241,-0.00552911,-0.982488,1
4435,2384,18,270,0,513,137,7757,1381,9138,0.201785,-0.069213,-0.976981,1
3837,2891,21,360,0,680,188,7977,1994,9971,0.221182,-0.084721,-0.971545,1
4607,3330,25,447,0,821,216,9446,2471,11917,0.215678,-0.0686093,-0.974051,1
4586,3822,30,481,0,914,264,10097,2588,12685,0.221924,-0.0492873,-0.973817,1
4862,4637,24,552,0,1025,302,11402,2576,13978,0.212895,-0.00842015,-0.977039,1
5512,5391,28,686,0,1260,360,13237,3449,16686,0.177645,0.0520971,-0.982715,1
3943,3779,19,427,0,914,241,9323,2456,11779,0.160782,0.0822733,-0.983555,1
4066,4053,28,529,0,1019,273,9968,2332,12300,0.13173,0.0988955,-0.98634,1
5443,5197,26,588,0,1233,343,12830,2899,15729,0.10597,0.112495,-0.987985,1
5011,4897,28,618,0,1171,305,12030,2623,14653,0.0813384,0.105845,-0.99105,1
5126,4938,23,614,0,1119,326,12146,2999,15145,0.0597672,0.113253,-0.991767,1
3709,3455,26,392,0,815,217,8614,2055,10669,0.0445653,0.108651,-0.99308,1
3735,3571,51,386,0,798,238,8779,1930,10709,0.0290103,0.0888761,-0.99562,1
5554,4872,25,548,0,1250,312,12561,3469,16030,0.025161,0.0789875,-0.996558,1
5720,4786,28,538,0,1088,304,12464,2532,14996,0.0343556,0.0768069,-0.996454,1
2967,2369,17,287,0,607,157,6404,1969,8373,0.0177684,0.0100438,-0.999792,1
5483,4067,31,459,0,1033,270,11343,3569,14912,0.00156513,0.00114185,-0.999998,1
3848,2686,22,305,0,626,179,7666,2281,9947,-0.00910532,-0.0046187,-0.999948,1
5209,3559,29,419,0,854,239,10309,2581,12890,-0.00786446,0.007621,-0.99994,1
5870,4167,38,480,0,959,276,11790,2413,14203,0.00431257,0.0479877,-0.998839,1
3836,2886,25,345,0,651,190,7933,1421,9354,0.00699898,0.0467471,-0.998882,1
4989,3722,30,423,0,858,246,10268,1603,11871,-0.0153862,0.0339665,-0.999305,1
4931,4001,34,505,0,830,162,10463,1202,11665,-0.0333239,-0.00504186,-0.999432,1
3518,2485,17,309,0,548,150,7027,1051,8078,-0.04136,-0.0334135,-0.998585,1
5142,3428,23,387,0,712,196,9888,1390,11278,-0.04288,-0.030624,-0.998611,1
4440,2920,23,347,0,649,190,8569,1214,9783,-0.0389138,-0.0211694,-0.999018,1
4186,2673,68,374,0,663,197,8161,1183,9344,-0.0281231,-0.0168189,-0.999463,1
4102,2358,27,329,0,545,180,7541,1050,8591,-0.0223996,-0.0426821,-0.998838,1
3913,2292,34,411,0,558,163,7371,1174,8545,-0.0273873,-0.0655557,-0.997473,1
4553,2313,25,283,0,515,180,7869,1257,9126,-0.0254992,-0.0741649,-0.99692,1
4653,2303,25,317,0,568,185,8051,1240,9291,-0.0190247,-0.107064,-0.99407,1
3970,1939,23,238,0,459,139,6768,1201,7969,-0.0191925,-0.0928128,-0.995499,1
4547,2195,51,268,0,496,141,7698,1360,9058,-0.0155981,-0.107516,-0.994081,1
4121,1789,23,221,0,462,123,6739,1116,7855,-0.0133508,-0.0965445,-0.995239,1
4125,1972,31,267,0,487,135,7017,1209,8226,-0.0265802,-0.0718953,-0.997058,1
4232,2021,25,297,0,460,137,7172,1103,8275,-0.031401,-0.063589,-0.997482,1
3734,1663,22,221,0,403,117,6160,933,7093,-0.0349283,-0.0031553,-0.999385,1
4049,1861,25,272,0,444,129,6780,1028,7808,-0.0408729,0.0251158,-0.998849,1
3722,1730,24,243,0,426,118,6263,759,7022,-0.0398418,0.0373067,-0.998509,1
4190,1843,30,268,0,456,125,6912,435,7347,-0.0296372,0.052326,-0.99819,1
4221,1938,25,316,0,419,122,7041,327,7368,-0.0138568,0.071589,-0.997338,1
4333,2060,26,270,0,457,131,7277,574,7851,-0.0138518,0.111318,-0.993688,1
4528,2612,28,384,0,550,190,8292,390,8682,0.051368,0.208676,-0.976635,1
4610,2618,26,327,0,560,222,8363,591,8954,0.033195,0.268883,-0.962601,1
4723,3037,28,402,0,676,192,9058,558,9616,-0.0630298,0.406426,-0.911507,1
5062,3499,29,443,0,783,246,10062,650,10712,-0.153604,0.578323,-0.801217,1
5458,3780,21,355,0,631,186,10431,-1000,-1000,-1,-1,-1,1
5722,3965,25,469,0,861,264,11306,859,12165,0.356736,0.0775648,-0.93098,1
3610,2980,18,342,0,636,177,7763,266,8029,-0.221943,0.181197,-0.958076,1
5589,4562,28,500,0,966,300,11945,307,12252,-0.29141,0.263563,-0.919573,1
5955,4441,28,468,0,997,297,12186,1302,13488,-0.146371,0.662972,-0.734196,1
4072,2287,19,254,0,477,142,7251,408,7659,-0.180269,0.608381,-0.772901,1
3477,2791,19,321,0,598,182,7388,410,7798,-0.15068,0.673182,-0.723962,1
5094,3883,29,429,0,810,240,10485,554,11039,-0.145306,0.666516,-0.731193,1
4836,3736,31,412,0,788,231,10034,-1000,-1000,-1,-1,-1,1
4279,3147,29,357,0,719,206,8737,627,9364,0.0422371,0.0119235,-0.999036,1
5262,3564,33,455,0,784,220,10318,913,11231,0.0357586,0.0541354,-0.997893,1
5253,3184,27,360,0,703,205,9732,1117,10849,0.00957513,0.0674205,-0.997679,1
5652,3118,27,332,0,678,187,9994,1126,11120,-0.00619535,0.117856,-0.993011,1
4887,2577,43,340,0,576,185,8608,1223,9831,-0.0151876,0.143214,-0.989575,1
4863,1800,27,216,0,471,82,7459,854,8313,0.000882595,0.107025,-0.994256,1
2807,833,15,122,0,221,56,4054,665,4719,0.0138958,0.0362778,-0.999245,1
3090,818,20,108,0,249,62,4347,980,5327,0.024131,0.0732944,-0.997018,1
3915,603,23,102,0,227,60,4930,1133,6063,0.0143078,0.0161416,-0.999768,1
4141,618,31,104,0,204,69,5167,1328,6495,0.020155,0.00657103,-0.999775,1
4136,568,36,97,0,126,59,5022,1294,6316,0.0280016,-0.0074565,-0.99958,1
4100,478,32,94,0,121,57,4882,1206,6088,0.0430139,0.0167446,-0.998934,1
4082,480,34,93,0,168,59,4916,1312,6228,0.0221776,-0.0198727,-0.999557,1
4035,442,46,78,0,149,49,4799,1365,6164,0.0193698,-0.0357794,-0.999172,1
4053,1057,47,113,0,145,64,5479,1520,6999,0.021067,-0.036709,-0.999104,1
3944,560,28,110,0,145,65,4852,1439,6291,0.00933044,-0.0324669,-0.999429,1
3924,690,34,119,0,230,70,5067,1497,6564,-0.0100495,-0.0243123,-0.999654,1
4095,865,30,135,0,380,85,5590,1682,7272,-0.0180334,-0.0428721,-0.998918,1
4297,1194,29,198,0,293,99,6110,1958,8068,-0.0425713,-0.0190944,-0.998911,1
4134,1445,35,205,0,389,118,6326,2338,8664,-0.0573451,-0.0138441,-0.998258,1
4402,2074,32,259,0,490,177,7434,1668,9102,-0.0649384,-0.00708155,-0.997864,1
4566,2609,32,327,0,686,192,8412,1652,10064,-0.0603579,0.0145433,-0.998071,1
4959,3785,36,464,0,847,248,10339,1101,11440,-0.057402,0.152395,-0.986651,1
5616,4662,35,577,0,1118,342,12350,539,12889,0.0392701,0.224814,-0.97361,1
4994,5219,31,558,0,1093,310,12205,828,13033,0.0742806,0.326532,-0.942263,1
5758,5469,32,576,0,917,245,12997,822,13819,0.118855,0.343778,-0.931499,1
3047,2933,17,342,0,731,192,7262,874,8136,0.132097,0.346196,-0.928816,1
6520,5979,35,681,0,1435,419,15069,1728,16797,0.145451,0.399392,-0.905168,1
4305,4163,23,467,0,946,264,10168,1200,11368,0.141075,0.393956,-0.908238,1
5580,5953,25,583,0,1288,361,13790,1782,15572,0.125437,0.424563,-0.896667,1
6041,4230,19,414,0,870,243,11817,1218,13035,0.104536,0.41202,-0.905159,1
3156,2668,15,326,0,729,184,7078,1193,8271,0.0857951,0.400936,-0.91208,1
3528,2786,17,332,0,666,179,7508,1220,8728,0.0825376,0.416446,-0.905406,1
5992,4153,31,528,0,993,269,11966,1948,13914,0.0944412,0.500677,-0.860468,1
5737,3840,31,461,0,893,171,11133,1220,12353,0.101408,0.566947,-0.817489,1
3866,2560,27,318,0,608,167,7546,1234,8780,0.131403,0.669365,-0.731221,1
5660,3537,33,420,0,798,220,10668,-1000,-1000,-1,-1,-1,1
5580,3279,34,407,0,759,207,10266,1888,12154,-0.0065787,0.0787324,-0.996874,1
3755,2136,23,331,0,711,178,7134,1548,8682,-0.00672359,0.0602068,-0.998163,1
5471,3021,45,379,0,697,192,9805,1993,11798,0.00692287,0.0905131,-0.995871,1
5407,3042,28,330,0,613,173,9593,1754,11347,-0.00561991,0.0987594,-0.995096,1
4548,2535,28,324,0,604,163,8202,1614,9816,-0.0146125,0.104357,-0.994433,1
4261,2184,26,303,0,646,221,7641,1653,9294,-0.0155475,0.134837,-0.990746,1
4144,2170,24,270,0,495,148,7251,1280,8531,-0.0180424,0.120298,-0.992574,1
4136,1970,27,274,0,553,197,7157,1477,8634,-0.00429437,0.189288,-0.981912,1
3846,1748,23,255,0,406,121,6399,1010,7409,-0.00771124,0.165966,-0.986101,1
4236,1936,24,242,0,439,130,7007,897,7904,0.00844605,0.202833,-0.979177,1
4208,1977,26,238,0,444,130,7023,846,7869,-0.00672016,0.177992,-0.984009,1
4148,1963,27,240,0,444,134,6956,658,7614,0.0153733,0.213646,-0.97679,1
4194,2046,25,249,0,462,144,7120,597,7717,0.0144443,0.211124,-0.977353,1
4405,2173,28,307,0,493,147,7553,486,8039,0.0104127,0.227126,-0.97381,1
4295,2405,27,286,0,523,154,7690,497,8187,0.00761987,0.209245,-0.977834,1
4534,2586,32,364,0,577,208,8301,519,8820,0.000820729,0.170266,-0.985398,1
4303,2694,33,388,0,601,183,8202,481,8683,0.0130259,0.150574,-0.988513,1
4354,2717,35,360,0,615,175,8256,495,8751,0.0638092,0.177074,-0.982127,1
4365,2755,29,353,0,611,200,8313,493,8806,0.0439312,0.14316,-0.988724,1
3960,2331,31,308,0,549,164,7343,315,7658,0.0300009,0.109494,-0.993535,1
4382,2582,27,310,0,619,201,8121,828,8949,0.00285185,0.0733279,-0.997304,1
4445,2657,37,376,0,622,260,8397,872,9269,0.0113823,0.0776845,-0.996913,1
4425,2586,28,306,0,571,167,8083,811,8894,0.00685911,0.0801561,-0.996759,1
4449,2591,28,319,0,573,168,8128,913,9041,0.0135962,0.099642,-0.99493,1
4421,2714,28,347,0,588,195,8293,855,9148,0.0243009,0.121879,-0.992247,1
4533,2772,33,328,0,587,186,8439,802,9241,0.0217087,0.142343,-0.989579,1
4610,2904,36,399,0,625,194,8768,368,9136,0.0912253,0.30493,-0.947996,1
4664,3052,57,425,0,684,200,9082,680,9762,0.0400905,0.158334,-0.986571,1
4526,3215,34,419,0,855,203,9252,597,9849,0.0655266,0.174392,-0.982494,1
4279,3631,29,447,0,812,250,9448,665,10113,0.0720988,0.144272,-0.986908,1
4764,4020,32,465,0,947,266,10494,646,11140,0.0763536,0.148569,-0.98595,1
4699,3730,38,453,0,825,246,9991,586,10577,0.0733544,0.131317,-0.988623,1
4412,3671,38,431,0,818,243,9613,694,10307,0.0777308,0.148488,-0.985855,1
4421,4240,41,495,0,914,246,10357,741,11098,0.0672983,0.14664,-0.986898,1
4369,3647,37,431,0,817,244,9545,692,10237,0.0440303,0.107588,-0.99322,1
4549,3767,47,510,0,673,174,9720,424,10144,0.0102941,0.0580203,-0.998262,1
3120,2600,24,353,0,612,167,6876,203,7079,-0.0216575,-0.0114117,-0.9997,1
5029,4331,37,469,0,915,258,11039,480,11519,0.00633665,0.0231896,-0.999711,1
4981,3864,35,476,0,900,377,10633,2026,12659,0.0214489,0.0575723,-0.998111,1
3424,2747,30,328,0,670,186,7385,287,7672,-0.0100226,-0.000364063,-0.99995,1
4407,3691,42,461,0,813,243,9657,273,9930,0.0333852,0.0960255,-0.994819,1
5067,4052,35,467,0,902,254,10777,681,11458,0.00515666,0.0206986,-0.999772,1
5291,4154,42,483,0,927,271,11168,1409,12577,0.0275956,0.0487424,-0.99843,1
3355,2855,29,326,0,638,188,7391,253,7644,0.00780283,0.0188991,-0.999791,1
4384,3803,42,452,0,861,245,9787,1414,11201,0.0239649,0.053455,-0.998283,1
4430,3595,38,431,0,816,237,9547,291,9838,-0.00963599,0.0734669,-0.997251,1
4884,4117,42,497,0,889,264,10693,429,11122,-0.00603739,0.047934,-0.998832,1
5019,3597,37,464,0,823,244,10184,1396,11580,0.0315329,0.053374,-0.998077,1
4525,3614,36,446,0,809,271,9701,308,10009,-0.0165095,-0.000232485,-0.999864,1
4767,4112,44,529,0,797,227,10476,-1000,-1000,-1,-1,-1,1
4379,3515,33,421,0,801,249,9398,1463,10861,0.0179893,0.0696615,-0.997408,1
4318,3620,33,424,0,908,283,9586,358,9944,0.00833222,0.032917,-0.999423,1
4871,3816,29,411,0,811,244,10182,1449,11631,0.0181159,0.0689309,-0.997457,1
4304,3658,69,446,0,861,273,9611,385,9996,0.00555032,0.030196,-0.999529,1
4440,3826,39,648,0,1156,348,10457,1630,12087,0.0143829,0.06341,-0.997884,1
4899,3830,31,457,0,859,237,10313,341,10654,0.0296199,0.0558566,-0.998,1
4884,3977,42,531,0,933,295,10662,441,11103,0.00457744,0.0300713,-0.999537,1
5107,4001,34,530,0,930,274,10876,1691,12567,0.0151214,0.0624195,-0.997936,1
4858,4143,44,560,0,895,287,10787,397,11184,0.0234583,0.0642751,-0.997656,1
4855,3862,30,416,0,570,161,9894,267,10161,0.00642308,0.0385467,-0.999236,1
3133,2541,21,324,0,629,184,6832,1045,7877,0.0200372,0.073045,-0.997128,1
4337,3554,30,454,0,1188,303,9866,348,10214,-0.00209269,0.0286685,-0.999587,1
4878,3959,35,459,0,901,265,10497,1697,12194,0.0171734,0.0649846,-0.997739,1
5363,4250,34,466,0,947,258,11318,382,11700,0.0247952,0.0532855,-0.998272,1
5084,3862,31,423,0,641,173,10214,282,10496,0.0262063,0.0540651,-0.998194,1
3327,2578,22,361,0,578,184,7050,292,7342,0.0267413,0.0546803,-0.998146,1
3980,3352,34,421,0,800,211,8798,337,9135,0.0245649,0.0506073,-0.998417,1
4692,3989,38,484,0,919,256,10378,399,10777,0.0245836,0.048894,-0.998502,1
5194,4824,43,580,0,929,258,11828,312,12140,-0.0364757,-0.00538235,-0.99932,1
4771,4006,41,498,0,922,287,10525,408,10933,-0.00811952,0.0257362,-0.999636,1
4941,4071,35,476,0,898,258,10679,1641,12320,0.017543,0.0588402,-0.998113,1
4935,4121,31,461,0,812,261,10621,354,10975,0.0298161,0.0598093,-0.997764,1
4779,3686,37,496,0,817,231,10046,467,10513,0.00382187,0.0312417,-0.999504,1
4520,3675,30,463,0,861,247,9796,1530,11326,0.014554,0.0601498,-0.998083,1
3712,2525,21,294,0,594,178,7324,275,7599,0.0205033,0.0488845,-0.998594,1
4893,4053,35,531,0,926,259,10697,255,10952,-0.0826652,-0.0171779,-0.996429,1
4464,3573,29,436,0,846,225,9573,488,10061,-0.0204127,0.0132198,-0.999704,1
4650,3884,35,461,0,909,251,10190,315,10505,-0.0119735,0.0159108,-0.999802,1
11884,2707,19,297,0,577,168,15652,180,15832,-0.275418,-0.0125465,-0.961243,1
2194,1411,13,199,0,357,94,4268,223,4491,0.0227541,0.0210867,-0.999519,1
5011,4011,36,464,0,930,278,10730,1543,12273,0.0160872,0.0620583,-0.997943,1
3400,2746,22,350,0,620,174,7312,252,7564,0.0175356,0.0544595,-0.998362,1
5126,3969,33,481,0,924,284,10817,291,11108,0.00920528,0.0443436,-0.998974,1
4838,3950,35,456,0,950,293,10522,1693,12215,0.00830833,0.0889699,-0.996,1
5573,3918,38,495,0,895,269,11188,492,11680,0.00366011,0.0309079,-0.999516,1
4931,4094,43,480,0,895,272,10715,1170,11885,0.0113696,0.075782,-0.997059,1
3393,2804,26,346,0,643,196,7408,290,7698,0.0206841,0.0532946,-0.998365,1
4433,3592,31,442,0,848,254,9600,318,9918,0.0267904,0.061857,-0.997725,1
5249,3656,31,448,0,865,227,10476,405,10881,0.00811138,0.037686,-0.999257,1
4386,3597,30,457,0,834,233,9537,1546,11083,0.0168748,0.064509,-0.997774,1
4954,4112,35,475,0,896,256,10728,416,11144,0.00556299,0.0339813,-0.999406,1
5007,3995,32,510,0,933,263,10740,1736,12476,0.0118792,0.0753834,-0.997084,1
3460,2719,24,410,0,714,257,7584,369,7953,0.0303842,0.0608647,-0.997683,1
3332,2818,24,313,0,652,182,7321,314,7635,0.0284996,0.052224,-0.998229,1
4910,3873,31,491,0,928,271,10504,437,10941,0.0259062,0.0508081,-0.998372,1
4453,4347,30,446,0,844,265,10385,375,10760,0.0267548,0.0491223,-0.998434,1
4904,3991,33,540,0,897,287,10652,407,11059,0.0255204,0.0492176,-0.998462,1
5153,4283,34,508,0,802,197,10977,265,11242,0.0193637,0.0468311,-0.998715,1
3413,2835,24,375,0,653,189,7489,225,7714,0.0223866,0.0422198,-0.998858,1
5100,3929,34,458,0,889,251,10661,315,10976,0.0272842,0.0480501,-0.998472,1
4953,3994,35,457,0,943,258,10640,364,11004,0.0320705,0.0472959,-0.998366,1
4970,3957,34,518,0,973,256,10708,416,11124,0.000308322,0.0308865,-0.999523,1
4900,4245,34,574,0,1002,307,11062,1713,12775,0.0126529,0.0796424,-0.996743,1
4939,4116,34,579,0,1008,289,10965,481,11446,0.00383604,0.0372836,-0.999297,1
4945,4048,42,460,0,895,258,10648,1620,12268,0.0161679,0.0692404,-0.997469,1
4883,4001,35,520,0,935,294,10668,440,11108,0.00796803,0.0363877,-0.999306,1
5095,4037,34,552,0,951,295,10964,1750,12714,0.0128102,0.0759014,-0.997033,1
4950,4077,34,531,0,947,257,10796,483,11279,0.00447943,0.0439923,-0.999022,1
5097,3801,37,449,0,814,244,10442,1530,11972,0.00788252,0.0695057,-0.997551,1
3228,2682,26,296,0,595,188,7015,242,7257,0.00277918,0.0376272,-0.999288,1
3076,2614,21,310,0,617,197,6835,1094,7929,0.0147616,0.0711433,-0.997357,1
4462,3530,40,432,0,819,227,9510,389,9899,0.0131114,0.0434557,-0.998969,1
4445,3546,31,408,0,814,229,9473,1459,10932,0.0164516,0.0732026,-0.997182,1
5019,4074,43,507,0,949,253,10845,489,11334,-0.00373315,0.0229774,-0.999729,1
5058,4477,34,516,0,964,261,11310,1761,13071,0.0118912,0.0736322,-0.997215,1
5027,4181,34,532,0,894,255,10923,454,11377,0.00779782,0.028557,-0.999562,1
4440,3621,31,461,0,835,232,9620,1503,11123,0.0113254,0.0794177,-0.996777,1
4526,3702,31,483,0,848,257,9847,434,10281,0.00105928,0.0322556,-0.999479,2
4509,3861,32,491,0,867,294,10054,1525,11579,0.0174247,0.0589052,-0.998111,2
4055,3292,28,370,0,726,204,8675,312,8987,0.0249084,0.060317,-0.997868,2
5293,4070,41,464,0,1006,294,11168,460,11628,0.0170128,0.0462841,-0.998784,2
4545,3638,31,412,0,887,233,9746,1520,11266,0.012122,0.0793109,-0.996777,2
4568,3711,43,523,0,837,256,9938,431,10369,0.0216329,0.0556701,-0.998215,2
3176,2542,22,428,0,872,255,7295,313,7608,0.0289193,0.056232,-0.997999,2
4408,3580,33,436,0,827,231,9515,351,9866,0.0276855,0.0555007,-0.998075,2
4407,3670,32,490,0,824,267,9690,413,10103,0.0143184,0.0386337,-0.999151,2
4459,3550,32,500,0,845,259,9645,1616,11261,0.0153944,0.0726458,-0.997239,2
4969,4376,43,713,0,1321,333,11755,538,12293,0.0245077,0.0472092,-0.998584,2
4709,3671,29,447,0,824,263,9943,287,10230,0.024351,0.044988,-0.998691,2
2365,1643,16,212,0,365,115,4716,145,4861,-0.0117117,0.0108412,-0.999873,2
4536,4014,38,672,0,1153,349,10762,375,11137,0.0534979,0.0208977,-0.998349,2
4594,3663,30,454,0,881,256,9878,353,10231,0.00164635,0.0163876,-0.999865,2
4618,4996,39,597,0,576,186,11012,1112,12124,0.0120674,0.0749885,-0.997111,2
3099,2650,21,310,0,615,182,6877,282,7159,0.00537816,0.04273,-0.999072,2
4508,3528,38,459,0,800,230,9563,1435,10998,0.0148525,0.0783449,-0.996816,2
4471,3645,30,475,0,827,259,9707,459,10166,0.0247772,0.0588049,-0.997962,2
2903,2447,25,300,0,586,169,6430,288,6718,-0.000455971,0.0243487,-0.999703,2
4681,4275,38,573,0,1219,361,11147,1569,12716,0.0126172,0.0687317,-0.997555,2
4547,3662,42,491,0,818,231,9791,359,10150,0.00374619,0.0319899,-0.999481,2
4778,3820,34,462,0,898,284,10276,1794,12070,0.0163808,0.067939,-0.997555,2
4979,3962,36,480,0,895,255,10607,414,11021,-0.00145114,0.0249368,-0.999688,2
4924,3931,36,458,0,908,256,10513,1734,12247,0.0115236,0.0713003,-0.997388,2
4998,3920,34,455,0,895,251,10553,462,11015,0.0210118,0.044982,-0.998767,2
4884,3908,35,457,0,895,251,10430,402,10832,0.02483,0.0413397,-0.998837,2
4455,3646,29,464,0,819,258,9671,379,10050,0.030881,0.0481612,-0.998362,2
4428,3548,29,422,0,807,228,9462,413,9875,0.0278616,0.0454537,-0.998578,2
4632,4082,40,615,0,1191,359,10919,514,11433,-0.0134992,0.00608325,-0.99989,2
3135,2573,22,313,0,576,183,6802,190,6992,-0.0867056,0.00559422,-0.996219,2
4574,4314,37,562,0,1214,354,11055,605,11660,-0.0129918,0.00546123,-0.999901,2
3165,2565,22,320,0,641,184,6897,222,7119,-0.119878,0.00768011,-0.992759,2
4706,3340,30,454,0,764,244,9538,520,10058,-0.0209752,0.0113329,-0.999716,2
6115,4018,36,539,0,1011,392,12111,354,12465,-0.0991064,0.00576035,-0.99506,2
6976,3079,27,390,0,661,203,11336,519,11855,-0.0164548,0.00198999,-0.999863,2
2118,1706,14,216,0,353,102,4509,119,4628,-0.104534,0.00889418,-0.994482,2
2196,1816,18,246,0,454,115,4845,352,5197,-0.0162615,0.0107488,-0.99981,2
4427,3559,31,413,0,810,248,9488,289,9777,-0.284901,-0.0136767,-0.958459,2
4777,3596,37,511,0,815,240,9976,535,10511,0.0136534,0.012015,-0.999835,2
4947,3954,42,481,0,896,272,10592,1792,12384,0.0132148,0.0606546,-0.998071,2
5046,3327,30,324,0,620,184,9531,288,9819,-0.00207118,0.0134625,-0.999907,2
5005,4189,39,505,0,898,289,10925,1829,12754,0.0132118,0.0674331,-0.997636,2
4945,3903,40,516,0,905,343,10652,371,11023,0.00858936,0.0268911,-0.999601,2
3168,2539,22,321,0,800,299,7149,1289,8438,0.0116101,0.0680734,-0.997613,2
5018,3926,32,441,0,814,234,10465,362,10827,0.0226721,0.0388537,-0.998988,2
5000,4104,34,468,0,916,257,10779,302,11081,0.00983307,0.0232345,-0.999682,2
4961,4105,47,532,0,910,277,10832,1682,12514,0.0172524,0.0574635,-0.998198,2
5088,3998,34,496,0,908,255,10779,383,11162,0.024535,0.040975,-0.998859,2
4927,4118,35,486,0,901,264,10731,383,11114,0.0277805,0.0382666,-0.998881,2
4950,3821,31,484,0,922,291,10499,391,10890,0.00283971,0.0136848,-0.999902,2
4966,4094,34,492,0,944,261,10791,1682,12473,0.0171431,0.0604011,-0.998027,2
4823,3601,33,540,0,1272,235,10504,398,10902,0.0238789,0.0435708,-0.998765,2
5019,4132,33,484,0,934,256,10858,408,11266,0.00146742,0.0118891,-0.999928,2
4944,3963,35,476,0,936,262,10616,1751,12367,0.0114137,0.0698551,-0.997492,2
4594,3649,29,433,0,923,234,9862,370,10232,0.0202188,0.032711,-0.99926,2
4646,3596,35,447,0,813,233,9770,1494,11264,0.00853974,0.072124,-0.997359,2
4553,3625,31,433,0,816,234,9692,472,10164,0.00349616,0.0207825,-0.999778,2
5036,4061,36,491,0,904,273,10801,1705,12506,0.0102729,0.0696925,-0.997515,2
4751,3822,29,535,0,963,257,10357,312,10669,0.00219649,0.0218663,-0.999758,2
5172,4009,30,479,0,936,261,10887,1759,12646,0.015595,0.0509687,-0.998579,2
4480,3548,30,441,0,823,271,9593,336,9929,0.0240418,0.0363591,-0.99905,2
4491,3691,35,462,0,843,232,9754,319,10073,0.0385476,0.0286606,-0.998846,2
5125,4472,39,584,0,979,256,11455,407,11862,0.0121153,0.00973948,-0.999879,2
5143,4054,34,574,0,940,261,11006,1812,12818,0.0156611,0.0579838,-0.998195,2
3456,2840,24,378,0,740,181,7619,302,7921,0.0230611,0.0365606,-0.999065,2
4510,3475,30,456,0,841,230,9542,280,9822,0.0284286,0.0144264,-0.999492,2
5265,4052,32,543,0,1008,260,11160,1851,13011,0.0211671,0.0564888,-0.998179,2
4925,3563,31,489,0,855,239,10102,378,10480,0.00355307,0.0174741,-0.999841,2
4770,3609,30,470,0,868,235,9982,1564,11546,0.0173135,0.0542417,-0.998378,2
4714,3566,32,415,0,937,321,9985,424,10409,0.00519629,0.019165,-0.999803,2
4587,4109,32,514,0,836,260,10338,1546,11884,0.00834896,0.0724046,-0.997341,2
4661,3648,31,420,0,836,269,9865,489,10354,-0.00109694,0.0153157,-0.999882,2
4717,3794,32,415,0,807,230,9995,1641,11636,0.0113984,0.0606973,-0.998091,2
4637,3658,37,433,0,837,242,9844,362,10206,0.00409291,0.0259174,-0.999656,2
4549,3631,51,433,0,818,245,9727,1579,11306,0.0136923,0.0664084,-0.997698,2
5070,3740,41,454,0,849,260,10414,443,10857,0.0186177,0.0459591,-0.99877,2
4695,3838,40,675,0,1257,355,10860,482,11342,-0.0173481,-0.000105321,-0.999849,2
2062,1649,14,206,0,373,124,4428,174,4602,-0.136353,-0.00417235,-0.990652,2
4649,3704,33,450,0,930,265,10031,579,10610,-0.0341216,-0.00766828,-0.999388,2
4649,3572,56,479,0,829,259,9844,361,10205,-0.00281407,0.00707733,-0.999971,2
5240,3624,31,420,0,813,239,10367,1631,11998,0.0155816,0.0633081,-0.997872,2
4587,3592,37,425,0,849,242,9732,394,10126,0.0201333,0.0367166,-0.999123,2
4553,3989,30,422,0,809,231,10034,337,10371,0.0235252,0.028508,-0.999317,2
4585,3588,31,535,0,1194,231,10164,344,10508,0.021463,0.0138659,-0.999673,2
5197,4131,34,491,0,914,257,11024,341,11365,0.000481804,-0.00668141,-0.999978,2
5085,4020,41,492,0,901,271,10810,1855,12665,0.0184103,0.0528031,-0.998436,2
4655,3756,35,434,0,818,245,9943,365,10308,-0.00652008,0.00695474,-0.999955,2
4987,3745,37,463,0,815,246,10293,1508,11801,0.0183032,0.0545877,-0.998341,2
4744,3612,37,414,0,819,229,9855,355,10210,0.02426,0.0411949,-0.998857,2
5441,4103,41,482,0,904,273,11244,393,11637,-0.00921353,0.00315277,-0.999953,2
4632,3645,41,480,0,814,242,9854,296,10150,0.0209152,-0.0472514,-0.998664,2
5236,4038,40,532,0,950,277,11073,1733,12806,0.0138189,0.0555071,-0.998363,2
5282,3943,30,529,0,974,308,11066,491,11557,0.00452902,0.0186784,-0.999815,2
4629,4365,39,435,0,836,247,10551,1576,12127,0.0138122,0.0564738,-0.998309,2
4724,3627,35,437,0,871,259,9953,421,10374,-0.00515391,0.00729209,-0.99996,2
4532,4374,59,493,0,811,244,10513,1526,12039,0.0107479,0.0492924,-0.998726,2
5087,3814,37,438,0,819,243,10438,380,10818,0.0198152,0.0387768,-0.999052,2
4694,3563,36,432,0,877,250,9852,394,10246,0.0265293,0.0456629,-0.998605,2
5173,3865,61,504,0,861,248,10712,409,11121,0.0256741,0.033704,-0.999102,2
4999,3908,32,499,0,857,236,10531,383,10914,-0.009766,-0.00502231,-0.99994,2
4743,3696,36,524,0,856,246,10101,-1000,-1000,-1,-1,-1,2
4632,3666,35,468,0,840,245,9886,1681,11567,0.0141493,0.0670242,-0.997651,2
4902,3580,32,418,0,816,229,9977,464,10441,-0.00386471,0.00764288,-0.999963,2
4823,4463,65,475,0,824,242,10892,1580,12472,0.0151356,0.0582234,-0.998189,2
3204,2623,25,351,0,586,178,6967,328,7295,0.000907245,0.018818,-0.999823,2
5784,3956,43,489,0,906,277,11455,1771,13226,0.0159806,0.0470522,-0.998765,2
4573,3589,31,420,0,819,233,9665,360,10025,-0.0109474,0.00123407,-0.999939,2
4775,3552,29,423,0,814,228,9821,258,10079,-0.169683,0.129766,-0.976918,2
4632,3628,33,419,0,825,232,9769,641,10410,-0.038391,0.0177958,-0.999104,2
5060,3919,34,452,0,818,244,10527,344,10871,-0.0231065,0.04408,-0.998761,2
4792,3639,32,427,0,899,231,10020,382,10402,-0.0110192,0.0314623,-0.999444,2
5098,4003,42,462,0,907,258,10770,313,11083,-0.112275,0.190151,-0.975314,2
4752,4293,52,469,0,833,239,10638,730,11368,-0.0160708,0.0285142,-0.999464,2
4821,3867,31,476,0,841,235,10271,322,10593,0.00906404,-0.007192,-0.999933,2
4680,4187,33,530,0,958,248,10636,1565,12201,0.018016,0.0465625,-0.998753,2
4833,3761,32,470,0,841,292,10229,426,10655,-0.00674016,0.000568141,-0.999977,2
4580,3929,34,465,0,852,267,10127,320,10447,-0.0112766,-0.0170076,-0.999792,2
4496,3612,29,436,0,820,231,9624,284,9908,-0.249874,0.259932,-0.932737,2
5304,4408,36,511,0,1013,259,11531,816,12347,0.0159831,0.00194597,-0.99987,2
5100,4043,47,444,0,582,195,10411,1161,11572,0.0131394,0.0571561,-0.998279,2
2529,2077,18,236,0,456,128,5444,239,5683,-0.00835013,0.00641538,-0.999945,2
4619,3672,29,447,0,872,236,9875,1605,11480,0.0117971,0.0535185,-0.998497,2
4580,3576,31,416,0,818,230,9651,431,10082,-0.0166292,-0.00710231,-0.999837,2
4770,4185,54,481,0,863,260,10613,283,10896,-0.314811,0.387376,-0.866506,2
4754,3620,37,453,0,818,314,9996,823,10819,0.0416852,0.005656,-0.999115,2
3333,2911,29,350,0,623,182,7428,275,7703,-0.00472682,-0.0110462,-0.999928,2
4574,3670,50,486,0,852,247,9879,1674,11553,0.0140156,0.0533975,-0.998475,2
4514,3832,38,504,0,872,247,10007,390,10397,-0.00997357,0.0052426,-0.999937,2
4514,3747,46,564,0,896,273,10040,1629,11669,0.0140913,0.0486909,-0.998715,2
4528,3695,42,487,0,863,266,9881,395,10276,-0.016946,-0.00582207,-0.99984,2
6143,4084,47,538,0,907,271,11990,297,12287,-0.174917,0.119165,-0.977345,2
4749,3643,35,486,0,854,265,10032,651,10683,-0.0413659,0.0195696,-0.998952,2
5282,4070,33,519,0,1037,267,11208,414,11622,-0.0249914,0.0429946,-0.998763,2
4853,3845,42,459,0,853,256,10308,397,10705,-0.012103,0.026849,-0.999566,2
3264,2804,24,343,0,740,170,7345,1135,8480,0.0154988,0.0477955,-0.998737,2
5122,3880,34,487,0,835,265,10623,419,11042,-0.00969419,0.00454982,-0.999943,2
5417,4060,42,531,0,996,280,11326,1851,13177,0.0125297,0.0498458,-0.998679,2
5742,3904,41,508,0,851,233,11279,488,11767,-0.0128341,-0.000341835,-0.999918,2
4677,3711,35,496,0,788,178,9885,185,10070,-0.0669718,-0.000863463,-0.997754,2
6035,4119,63,544,0,946,271,11978,596,12574,-0.0175379,0.00327302,-0.999841,2
5059,3940,47,533,0,938,256,10773,378,11151,0.0120619,0.0168996,-0.999785,2
5497,4114,34,523,0,973,265,11406,1912,13318,0.0098288,0.0585864,-0.998234,2
3468,2851,25,390,0,659,181,7574,381,7955,0.0184906,0.0390948,-0.999065,2
5352,4117,35,478,0,917,258,11157,379,11536,-0.00224458,0.00536322,-0.999983,2
5072,4020,33,651,0,1311,289,11376,1777,13153,0.00752583,0.0626096,-0.99801,2
5581,4162,43,525,0,997,311,11619,558,12177,-0.0043941,0.00888838,-0.999951,2
5583,4212,39,536,0,1069,275,11714,1707,13421,0.0139005,0.0505805,-0.998623,2
3582,2891,32,332,0,630,187,7654,341,7995,-0.0102341,-0.00437263,-0.999938,2
5298,4076,43,486,0,920,309,11132,331,11463,-0.371371,0.325204,-0.86967,2
5246,4114,42,484,0,909,270,11065,715,11780,0.0446114,-0.0158242,-0.998879,2
5617,4219,33,528,0,921,301,11619,246,11865,-0.022769,-0.00252835,-0.999737,2
3550,2818,24,362,0,691,204,7649,237,7886,0.0364959,0.019895,-0.999136,2
4177,2705,20,311,0,617,162,7992,228,8220,-0.0123409,-0.0141289,-0.999824,2
1360,939,27,133,0,215,84,2758,81,2839,-0.3711,0.374452,-0.849747,2
1107,880,9,190,0,235,135,2556,239,2795,0.0305476,0.00295366,-0.999529,2
6212,4145,44,482,0,957,272,12112,315,12427,-0.0606139,0.00121117,-0.99816,2
7773,5312,24,330,0,634,179,14252,370,14622,-0.0196764,0.0154025,-0.999688,2
2807,2123,18,256,0,481,151,5836,178,6014,-0.047599,0.0138749,-0.99877,2
2159,1656,13,196,0,342,93,4459,164,4623,-0.0155463,0.030992,-0.999399,2
2888,2236,20,261,0,514,145,6064,184,6248,-0.0158559,0.0271361,-0.999506,2
5668,4366,35,480,0,909,255,11713,344,12057,0.00720466,-0.00501296,-0.999962,2
5226,4086,31,419,0,929,263,10954,1707,12661,0.0132597,0.0539248,-0.998457,2
5773,4208,34,477,0,917,259,11668,491,12159,-0.0100702,0.00122679,-0.999949,2
3677,2794,23,348,0,630,218,7690,1199,8889,0.0129306,0.0504589,-0.998642,2
3609,2872,25,337,0,653,198,7694,336,8030,-0.0139885,-0.00745319,-0.999874,2
5738,4163,36,490,0,992,258,11677,-1000,-1000,-1,-1,-1,2
5142,4164,35,566,0,932,296,11135,1749,12884,0.0119189,0.056676,-0.998322,2
3553,2961,24,365,0,646,201,7750,348,8098,0.0152957,0.0235842,-0.999605,2
5166,3921,31,503,0,969,292,10882,275,11157,-0.00783495,-0.00843986,-0.999934,2
5142,3678,31,465,0,915,259,10490,267,10757,-0.283554,0.307549,-0.908301,2
4655,3908,34,458,0,863,279,10197,693,10890,0.0327504,-0.00824054,-0.99943,2
4678,3715,28,415,0,906,257,9999,290,10289,0.0338506,-0.0278487,-0.999039,2
4764,3962,33,490,0,870,276,10395,1560,11955,0.0113765,0.0592174,-0.99818,2
5143,4114,34,525,0,949,297,11062,539,11601,-0.0060946,0.00284841,-0.999978,2
4732,4019,32,477,0,918,266,10444,1598,12042,0.0153989,0.0419696,-0.999,2
3383,2610,22,325,0,587,186,7113,287,7400,-0.0165334,-0.0144108,-0.999759,2
5320,4048,35,533,0,1054,265,11255,1697,12952,0.0103305,0.0536593,-0.998506,2
4768,3667,33,418,0,816,231,9933,467,10400,-0.0154943,-0.0126765,-0.999799,2
5164,4186,42,547,0,941,278,11158,388,11546,-0.166342,0.158304,-0.973278,2
5053,4083,57,600,0,909,272,10974,778,11752,-0.00809183,0.00088068,-0.999967,2
4536,3981,62,491,0,849,238,10157,1579,11736,0.0107278,0.0472564,-0.998825,2
4987,3687,42,424,0,866,234,10240,415,10655,0.0195054,0.0319503,-0.999299,2
4628,3762,35,462,0,829,248,9964,355,10319,-0.00386839,0.00132961,-0.999992,2
5460,4081,39,484,0,913,274,11251,1667,12918,0.00853508,0.0567618,-0.998351,2
5077,4195,39,484,0,851,203,10849,373,11222,-0.00873819,-0.00454282,-0.999951,2
3450,2916,25,363,0,894,194,7842,1281,9123,0.0133981,0.0469779,-0.998806,2
4667,3618,30,477,0,847,233,9872,432,10304,-0.0126786,-0.00511209,-0.999907,2
5368,3975,36,576,0,947,262,11164,1658,12822,0.00763828,0.0630466,-0.997981,2
4934,3884,31,488,0,817,232,10386,488,10874,-0.0097122,0.00496625,-0.99994,2
5058,3914,41,443,0,926,275,10657,1767,12424,0.0128141,0.0519386,-0.998568,2
5633,4210,38,492,0,920,273,11566,453,12019,-0.00205384,0.00775839,-0.999968,2
5139,4023,32,460,0,856,239,10749,1576,12325,0.0201617,0.0461772,-0.99873,2
5188,4149,45,529,0,951,278,11140,471,11611,-0.00639594,-0.00138204,-0.999979,2
4887,3766,37,452,0,879,257,10278,1567,11845,0.0190931,0.0326912,-0.999283,2
5275,4262,35,533,0,979,268,11352,457,11809,-0.00210177,-0.0238658,-0.999713,2
5413,4054,32,477,0,1012,294,11282,1597,12879,0.0196834,0.0454823,-0.998771,2
5218,4156,43,495,0,921,279,11112,493,11605,-0.0143792,-0.0112079,-0.999834,2
5107,4124,36,534,0,942,196,10939,1154,12093,0.00287883,0.0359868,-0.999348,2
3592,2910,30,356,0,656,197,7741,294,8035,0.0165309,0.0508381,-0.99857,2
5170,4072,36,471,0,920,260,10929,496,11425,-0.0197188,0.0387281,-0.999055,2
2704,2012,16,205,0,399,112,5448,133,5581,-0.1996,0.0626296,-0.977874,2
1904,1499,13,171,0,338,95,4020,230,4250,0.0209165,0.0323628,-0.999257,2
3671,2998,23,370,0,676,208,7946,299,8245,0.00357813,0.0557237,-0.99844,2
5320,4346,31,532,0,951,300,11480,420,11900,-0.00965944,0.125681,-0.992024,2
5368,3992,36,582,0,864,280,11122,569,11691,-0.0162233,0.105961,-0.994238,2
4633,3379,29,423,0,764,234,9462,514,9976,-0.0169576,0.159977,-0.986975,2
5052,3322,35,425,0,737,240,9811,695,10506,-0.0158411,0.116913,-0.993016,2
4945,2931,32,393,0,697,188,9186,605,9791,-0.0154827,0.141816,-0.989772,2
4985,2785,36,367,0,626,192,8991,727,9718,-0.00851795,0.234418,-0.972099,2
4990,2658,34,360,0,597,192,8831,733,9564,-0.0106942,0.255806,-0.966669,2
3234,1231,14,165,0,293,82,5019,400,5419,0.000811967,0.154007,-0.98807,2
2025,926,28,130,0,219,65,3393,447,3840,0.0105509,0.10021,-0.994911,2
4664,1714,26,230,0,425,118,7177,1173,8350,0.00722666,0.101957,-0.994763,2
4879,1696,35,220,0,402,121,7353,1329,8682,0.0178008,0.104122,-0.994405,2
4874,1535,37,206,0,352,121,7125,1320,8445,0.030828,0.102327,-0.994273,2
5005,1363,29,212,0,341,112,7062,1388,8450,0.0344684,0.133283,-0.990478,2
4539,1225,36,241,0,422,120,6583,1426,8009,0.0347799,0.113333,-0.992948,2
4198,1038,26,152,0,313,76,5803,1309,7112,0.032569,0.124739,-0.991655,2
4071,886,33,144,0,268,68,5470,1320,6790,0.0322477,0.117459,-0.992554,2
4119,730,23,118,0,255,61,5306,1377,6683,0.0266945,0.156107,-0.987379,2
4390,671,29,114,0,273,61,5538,1616,7154,0.0249272,0.116125,-0.992922,2
4353,596,28,117,0,157,52,5303,1516,6819,0.00762509,0.0978368,-0.995173,2
4460,581,37,107,0,137,67,5389,1503,6892,-0.00462706,0.0703593,-0.997511,2
3777,440,25,77,0,117,40,4476,1315,5791,-0.0173192,0.0735846,-0.997139,2
4321,642,37,116,0,183,64,5363,1582,6945,-0.036085,0.0952428,-0.9948,2
3692,435,28,90,0,126,44,4415,1458,5873,-0.0422641,0.0959439,-0.994489,2
4046,604,32,115,0,214,58,5069,1629,6698,-0.0316376,0.111917,-0.993214,2
4847,790,30,122,0,194,61,6044,1621,7665,-0.0165189,0.0688153,-0.997493,2
4198,852,29,130,0,229,70,5508,1699,7207,-0.00129574,0.0511496,-0.998691,2
4342,999,29,173,0,285,95,5923,1768,7691,0.00947252,0.0258177,-0.999622,2
3842,1022,25,144,0,270,79,5382,1735,7117,0.0211069,0.0181512,-0.999613,2
4685,1367,27,201,0,360,104,6744,2032,8776,0.0363432,0.0200458,-0.999138,2
4544,1890,29,260,0,482,135,7340,2024,9364,0.0483622,0.019419,-0.998641,2
5846,2644,33,317,0,617,191,9648,1392,11040,0.0895508,0.00168983,-0.995981,2
4533,3388,30,399,0,786,216,9352,1715,11067,0.0971416,0.007684,-0.995241,2
4924,4173,31,493,0,934,258,10813,1230,12043,0.110157,0.0191034,-0.993731,2
5471,4596,26,540,0,1087,297,12017,1013,13030,0.121775,0.0512747,-0.991233,2
5482,4202,23,553,0,983,199,11442,951,12393,0.0972221,0.168774,-0.980848,2
5915,5053,31,642,0,926,281,12848,2099,14947,0.0801816,0.269194,-0.959742,2
3134,2932,19,317,0,691,177,7270,1464,8734,0.0696463,0.319639,-0.944976,2
5631,5174,25,559,0,1212,307,12908,2392,15300,0.0740274,0.37453,-0.924255,2
3750,3078,18,361,0,749,205,8161,1630,9791,0.0762304,0.416279,-0.906036,2
3755,2712,18,308,0,789,230,7812,1446,9258,0.0747331,0.456847,-0.8864,2
6050,3715,27,454,0,934,247,11427,2030,13457,0.0720383,0.512888,-0.855428,2
5792,2667,24,459,0,864,207,10013,1328,11341,0.0549736,0.570374,-0.819544,2
3031,1766,16,223,0,415,129,5580,897,6477,0.0516594,0.629316,-0.775431,2
4631,3273,26,325,0,631,200,9086,-1000,-1000,-1,-1,-1,2
4474,2530,37,300,0,598,165,8104,1294,9398,-0.0364304,0.096701,-0.994647,2
4742,2936,26,311,0,606,169,8790,1699,10489,-0.0625772,0.160022,-0.985128,2
4534,2247,25,280,0,570,185,7841,1607,9448,-0.044452,0.156427,-0.986689,2
4297,1929,23,281,0,526,147,7203,1525,8728,-0.0455384,0.201574,-0.978414,2
3958,1741,23,225,0,424,118,6489,1375,7864,-0.0403452,0.209679,-0.976938,2
4405,1818,24,275,0,462,160,7144,1522,8666,-0.0594261,0.305093,-0.950467,2
4278,1984,25,322,0,649,167,7425,1749,9174,-0.0662308,0.276392,-0.95876,2
2722,1286,26,180,0,219,86,4519,821,5340,-0.0546297,0.166191,-0.984579,2
1950,832,12,110,0,201,59,3164,694,3858,-0.0596675,0.178387,-0.982149,2
4124,1662,31,398,0,532,136,6883,1320,8203,-0.0718709,0.199083,-0.977344,2
4144,1694,26,255,0,481,154,6754,1305,8059,-0.0753337,0.219983,-0.972591,2
3989,1748,25,267,0,422,134,6585,1310,7895,-0.0654002,0.250417,-0.965927,2
4046,1781,25,288,0,433,151,6724,1277,8001,-0.0404812,0.223188,-0.973934,2
4029,1973,26,285,0,475,148,6936,1349,8285,-0.0347035,0.240558,-0.970014,2
4058,2177,26,268,0,599,200,7328,1349,8677,-0.00882385,0.262668,-0.964846,2
4394,2992,30,431,0,683,234,8764,1317,10081,-0.00562648,0.267897,-0.963431,2
4699,3965,28,492,0,880,253,10317,1294,11611,0.0126601,0.297324,-0.954693,2
4248,3873,42,753,0,886,239,10041,1018,11059,0.00541095,0.282526,-0.959245,2
5132,4712,36,526,0,1121,292,11819,1335,13154,-0.0118044,0.285961,-0.958169,2
5824,5030,35,612,0,1094,343,12938,1401,14339,-0.0284874,0.25649,-0.966127,2
5273,4477,28,564,0,964,314,11620,839,12459,-0.0343066,0.286165,-0.957566,2
3462,2936,23,340,0,618,192,7571,489,8060,-0.0470355,0.274366,-0.960474,2
4955,3796,26,494,0,790,243,10304,714,11018,-0.0470841,0.22229,-0.973843,2
4904,3422,30,464,0,747,243,9810,827,10637,-0.0278328,0.173008,-0.984527,2
5730,3032,31,345,0,673,183,9994,966,10960,-0.0272332,0.166041,-0.985743,2
5086,2289,28,268,0,503,148,8322,854,9176,-0.032914,0.175942,-0.98385,2
4804,1728,27,242,0,454,122,7377,901,8278,-0.01418,0.170131,-0.985319,2
4577,1428,26,189,0,363,104,6687,833,7520,-0.00441896,0.12536,-0.992102,2
4680,1370,26,179,0,361,98,6714,773,7487,-0.00452819,0.133513,-0.991037,2
4722,1349,29,220,0,367,115,6802,699,7501,-0.0132164,0.119676,-0.992725,2
7605,1945,38,250,0,408,105,10351,673,11024,-0.0333847,0.150096,-0.988108,2
4770,1553,26,279,0,403,121,7152,888,8040,-0.0615136,0.178859,-0.98195,2
4668,1493,30,196,0,357,107,6851,1299,8150,-0.0643907,0.187097,-0.980229,2
4636,1496,29,216,0,396,107,6880,1592,8472,-0.0435772,0.160828,-0.98602,2
4702,1320,32,181,0,326,115,6676,1569,8245,-0.0375615,0.190383,-0.980991,2
4530,1242,33,186,0,307,133,6431,1617,8048,-0.0279464,0.157353,-0.987147,2
4416,1064,26,159,0,261,79,6005,1520,7525,-0.0289234,0.163197,-0.98617,2
4794,1119,36,161,0,305,90,6505,1736,8241,-0.00569271,0.15876,-0.987301,2
4179,994,26,148,0,263,80,5690,1611,7301,0.00766448,0.132304,-0.99118,2
3968,952,23,170,0,268,84,5465,1512,6977,-0.00189525,0.135086,-0.990832,2
4009,870,30,134,0,217,78,5338,1467,6805,-0.0225637,0.125642,-0.991819,2
4395,950,33,148,0,235,87,5848,1505,7353,-0.0113654,0.0712212,-0.997396,2
4487,897,32,143,0,247,84,5890,1610,7500,-0.0100958,0.0337325,-0.99938,2
4078,807,28,152,0,209,76,5350,1531,6881,-0.0209427,0.046548,-0.998696,2
3969,880,32,135,0,220,78,5314,1404,6718,-0.0232612,0.0633261,-0.997722,2
3888,894,29,140,0,238,84,5273,1506,6779,-0.0204504,0.0772209,-0.996804,2
4436,1205,33,178,0,298,100,6250,1407,7657,-0.00802212,0.1121,-0.993665,2
4020,1212,30,177,0,316,103,5858,1060,6918,0.014086,0.120618,-0.992599,2
4793,1698,31,235,0,480,136,7373,980,8353,0.0683593,0.103767,-0.99225,2
4784,2106,30,262,0,506,156,7844,1511,9355,0.108717,0.0824276,-0.990649,2
4699,2102,23,284,0,540,162,7810,2014,9824,0.130017,0.0790041,-0.988359,2
4868,2946,28,371,0,755,199,9167,2614,11781,0.144062,0.110018,-0.983434,2
3172,1755,14,228,0,449,119,5737,1353,7090,0.145979,0.0621049,-0.987336,2
2226,1636,11,219,0,403,121,4616,1135,5751,0.138196,0.0283688,-0.989999,2
4668,4461,33,545,0,950,283,10940,2328,13268,0.123771,0.0238511,-0.992024,2
5131,4253,29,506,0,1050,291,11260,1850,13110,0.115496,0.0305851,-0.992837,2
5428,4599,28,595,0,966,232,11848,1560,13408,0.106323,0.0383734,-0.993591,2
3762,3546,22,459,0,847,256,8892,1446,10338,0.103226,0.0410754,-0.99381,2
5612,5630,28,688,0,1306,379,13643,1839,15482,0.0960798,0.0578142,-0.993693,2
5367,5686,31,715,0,928,273,13000,1005,14005,0.0997736,0.0376626,-0.994297,2
3066,3067,16,367,0,811,223,7550,764,8314,0.116216,0.0543657,-0.991735,2
4289,3813,19,458,0,919,291,9789,959,10748,0.129204,0.110863,-0.985401,2
4935,4986,26,622,0,1202,348,12119,1909,14028,0.0774933,0.184144,-0.97984,2
4521,4716,22,581,0,1159,387,11386,2466,13852,0.0505332,0.162663,-0.985387,2
3294,3577,15,427,0,830,239,8382,1949,10331,0.0311298,0.141902,-0.989391,2
5772,6047,24,762,0,1432,407,14444,3404,17848,0.0198773,0.122865,-0.992224,2
4133,4424,19,516,0,1084,270,10446,2382,12828,0.0137686,0.111607,-0.993657,2
4118,4540,21,498,0,983,276,10436,2296,12732,0.00902115,0.130672,-0.991385,2
5243,5675,26,646,0,1369,374,13333,3315,16648,0.0066869,0.151844,-0.988382,2
3748,3932,18,435,0,895,242,9270,2323,11593,-0.0020698,0.159221,-0.987241,2
3092,3077,14,350,0,711,190,7434,2054,9488,-0.00498114,0.154314,-0.988009,2
5793,5564,24,689,0,1045,271,13386,2768,16154,-0.0106057,0.161684,-0.986786,2
3077,2928,23,369,0,713,199,7309,2354,9663,-0.0103083,0.144762,-0.989413,2
3899,3461,16,459,0,804,229,8868,2638,11506,-0.00837559,0.118216,-0.992953,2
5566,5041,24,598,0,1197,338,12764,3790,16554,-0.00718155,0.104254,-0.994525,2
4384,3449,17,420,0,833,236,9339,2596,11935,-0.00828287,0.0910022,-0.995816,2
4839,4456,25,538,0,1063,320,11241,3250,14491,-0.00721992,0.0845828,-0.99639,2
5749,5140,24,597,0,1150,348,13008,3597,16605,-0.0116892,0.0795918,-0.996759,2
3041,2419,15,370,0,682,142,6669,1599,8268,-0.0154174,0.0769095,-0.996919,2
1830,1472,7,165,0,330,89,3893,999,4892,-0.0196269,0.0755638,-0.996948,2
1777,1683,10,191,0,360,97,4118,1136,5254,-0.0191752,0.0759323,-0.996928,2
5873,4715,28,577,0,1176,304,12673,3277,15950,-0.0193079,0.0755906,-0.996952,2
6215,5511,25,814,0,1351,372,14288,3391,17679,-0.0194899,0.0752247,-0.996976,2
3121,2257,12,274,0,546,155,6365,1610,7975,-0.019817,0.0728785,-0.997144,2
1853,1658,9,194,0,395,108,4217,1217,5434,-0.0195642,0.0717396,-0.997232,2
4636,4343,23,523,0,1037,274,10836,3365,14201,-0.022203,0.0706807,-0.997252,2
6118,5480,32,839,0,1678,345,14492,2904,17396,-0.0210664,0.0683411,-0.99744,2
3641,2949,17,324,0,671,185,7787,1982,9769,-0.0226584,0.0686463,-0.997384,2
6284,5548,33,1221,0,1136,386,14608,2683,17291,-0.0259674,0.0688298,-0.997291,2
3579,2799,17,316,0,663,178,7552,1727,9279,-0.0277028,0.0708019,-0.997106,2
4532,3971,18,468,0,937,252,10178,2814,12992,-0.0291922,0.0711923,-0.997035,2
6038,5262,28,612,0,1255,368,13563,2998,16561,-0.0305685,0.0702797,-0.997059,2
7189,5383,31,661,0,1362,356,14982,3933,18915,-0.0298363,0.0707293,-0.997049,2
3392,2660,11,257,0,545,145,7010,1946,8956,-0.0278453,0.0719268,-0.997021,2
2129,1659,9,187,0,409,106,4499,1190,5689,-0.0279551,0.0711129,-0.997076,2
6111,5464,29,535,0,881,234,13254,3108,16362,-0.0269711,0.0699893,-0.997183,2
3165,2802,13,342,0,700,189,7211,2051,9262,-0.0253756,0.0696301,-0.99725,2
6027,5596,28,598,0,1254,429,13932,3790,17722,-0.0252631,0.071762,-0.997102,2
4169,3716,18,419,0,963,237,9522,2693,12215,-0.0268441,0.0742348,-0.996879,2
3209,2818,13,319,0,661,178,7198,2123,9321,-0.0293809,0.0748529,-0.996762,2
6119,5393,29,713,0,1251,340,13845,3954,17799,-0.0275031,0.0710974,-0.99709,2
4183,3768,18,415,0,896,181,9461,2059,11520,-0.0289131,0.0706005,-0.997086,2
3597,3221,16,358,0,752,202,8146,2329,10475,-0.0299127,0.0689224,-0.997173,2
6007,5457,28,686,0,1308,345,13831,3667,17498,-0.0302135,0.0672596,-0.997278,2
4331,3723,18,440,0,911,238,9661,2263,11924,-0.0289012,0.0659612,-0.997404,2
3898,3514,18,411,0,815,221,8877,2499,11376,-0.0283496,0.0689812,-0.997215,2
6251,5416,32,636,0,1274,348,13957,2766,16723,-0.0297487,0.068611,-0.9972,2
3253,3862,20,332,0,680,189,8336,2115,10451,-0.0287549,0.0700462,-0.997129,2
6129,5541,32,674,0,1315,530,14221,3106,17327,-0.0296199,0.0680289,-0.997244,2
3056,2394,14,272,0,548,154,6438,1540,7978,-0.0302624,0.0686496,-0.997182,2
1889,1722,8,210,0,409,107,4345,1214,5559,-0.0286034,0.0673154,-0.997322,2
6216,5557,43,614,0,1285,363,14078,3606,17684,-0.0298431,0.0670089,-0.997306,2
3921,3664,21,408,0,833,234,9081,2461,11542,-0.0314631,0.0678702,-0.997198,2
5475,4668,25,567,0,1114,319,12168,3096,15264,-0.0310594,0.0693588,-0.997108,2
3737,3477,16,398,0,818,212,8658,2355,11013,-0.0322756,0.0706543,-0.996978,2
6089,5526,34,677,0,1321,398,14045,3760,17805,-0.0339774,0.0697537,-0.996986,2
4246,3856,17,488,0,913,260,9780,2412,12192,-0.0306597,0.068762,-0.997162,2
5059,4484,22,510,0,1073,287,11435,3160,14595,-0.0269105,0.0700465,-0.997181,2
6552,5617,26,639,0,1642,528,15004,3881,18885,-0.028299,0.0707362,-0.997093,2
3180,2479,12,279,0,565,153,6668,1714,8382,-0.0288819,0.0698451,-0.99714,2
1883,1751,9,206,0,412,113,4374,1207,5581,-0.0286646,0.0687526,-0.997222,2
3248,2976,17,362,0,701,198,7502,2030,9532,-0.0273448,0.0686846,-0.997264,2
