Downsample[ns],BuildFilTree[ns],SearchFil[ns],DeleteFil[ns],BuildTreeSub[ns],SearchSub[ns],DeleteSub[ns],PreProcTotal[ns],Plane[ns],Total[ns],nx,ny,nz,planeCount
7091,0,399,528,4374,99,295,12786,1904,14690,-0.00874204,0.0349825,-0.99935,0
6661,0,337,427,3862,61,364,11712,1801,13513,-0.0091043,0.0334747,-0.999398,0
6145,0,335,418,3415,47,167,10527,1151,11678,-0.00947211,0.0347044,-0.999353,0
4343,0,234,293,2448,38,167,7523,1201,8724,-0.00801961,0.0337028,-0.9994,0
5484,0,302,375,3155,67,267,9650,1449,11099,-0.0118597,0.03549,-0.9993,0
6179,0,334,425,3679,79,359,11055,1815,12870,-0.00766741,0.0323975,-0.999446,0
7037,0,381,488,3727,71,272,11976,1416,13392,-0.0092681,0.0333149,-0.999402,0
4568,0,253,313,2828,59,271,8292,1363,9655,-0.0113883,0.0267726,-0.999577,0
5996,0,335,418,3618,82,312,10761,1965,12726,-0.0137611,0.0331689,-0.999355,0
6274,0,339,426,3615,49,243,10946,1463,12409,-0.016413,0.0426195,-0.998956,0
6122,0,338,422,3687,55,244,10868,1606,12474,-0.0106687,0.0379167,-0.999224,0
6000,0,332,413,3518,57,236,10556,1679,12235,-0.00652004,0.0352542,-0.999357,0
6110,0,371,424,3555,52,239,10751,1320,12071,-0.00696427,0.0324223,-0.99945,0
6231,0,335,416,3600,55,241,10878,1549,12427,-0.00771619,0.0251517,-0.999654,0
6111,0,337,421,3642,62,245,10818,1643,12461,-0.00687466,0.0290822,-0.999553,0
6918,0,384,500,3738,54,247,11841,1219,13060,-0.00701759,0.0297365,-0.999533,0
4221,0,235,293,2489,45,167,7450,1122,8572,-0.0106997,0.0302013,-0.999487,0
6146,0,339,421,3697,66,247,10916,1585,12501,-0.0101563,0.0260977,-0.999608,0
6167,0,340,429,3945,114,251,11246,1652,12898,-0.0133873,0.0271163,-0.999543,0
6442,0,338,427,3605,58,244,11114,1631,12745,-0.00687997,0.0287601,-0.999563,0
6179,0,352,427,3609,61,243,10871,1555,12426,-0.00962218,0.0268315,-0.999593,0
6165,0,339,422,3620,63,244,10853,1622,12475,-0.00765042,0.0305993,-0.999502,0
6330,0,383,423,3633,54,244,11067,1635,12702,-0.00899175,0.0331207,-0.999411,0
6153,0,365,429,3677,60,246,10930,1531,12461,-0.014545,0.0276557,-0.999512,0
6137,0,342,455,3648,58,244,10884,1640,12524,-0.012713,0.0325928,-0.999388,0
4570,0,236,296,2530,49,168,7849,1040,8889,-0.0154427,0.029584,-0.999443,0
6101,0,364,427,3642,72,243,10849,1655,12504,-0.00985456,0.0331074,-0.999403,0
6120,0,341,428,3668,74,247,10878,1580,12458,-0.0106452,0.0332826,-0.999389,0
6241,0,387,432,3763,74,265,11162,1660,12822,-0.00981389,0.0319307,-0.999442,0
4326,0,235,295,2533,44,170,7603,1169,8772,-0.0113364,0.0343694,-0.999345,0
6342,0,340,431,3672,84,245,11114,1688,12802,-0.0110027,0.03341,-0.999381,0
6662,0,524,496,3781,79,250,11792,1596,13388,-0.00907538,0.0310381,-0.999477,0
6083,0,342,426,3772,59,250,10932,1419,12351,-0.0152583,0.0342402,-0.999297,0
4246,0,335,312,2496,34,168,7591,1114,8705,-0.0132969,0.0345323,-0.999315,0
6148,0,340,423,3751,80,248,10990,1570,12560,-0.0125712,0.0371922,-0.999229,0
6227,0,343,432,3690,71,246,11009,1601,12610,-0.0104005,0.0371474,-0.999256,0
6528,0,375,435,3889,57,250,11534,1591,13125,-0.0105491,0.0365973,-0.999274,0
4245,0,237,296,2562,51,169,7560,1163,8723,-0.00978986,0.0328161,-0.999414,0
6538,0,344,444,3720,49,248,11343,1781,13124,-0.0113782,0.0328188,-0.999397,0
6120,0,342,428,3708,59,257,10914,1649,12563,-0.0154988,0.0308828,-0.999403,0
6093,0,342,426,3808,58,250,10977,1626,12603,-0.0147878,0.0361833,-0.999236,0
4213,0,237,294,2561,40,170,7515,1037,8552,-0.0128337,0.0386907,-0.999169,0
6173,0,449,434,3693,57,244,11050,1608,12658,-0.0102663,0.0337146,-0.999379,0
8070,0,345,434,3096,38,170,12153,1095,13248,-0.0121854,0.035006,-0.999313,0
3245,0,179,223,1913,29,130,5719,841,6560,-0.0115119,0.0324844,-0.999406,0
6215,0,457,437,3706,56,246,11117,1501,12618,-0.00975925,0.0297551,-0.99951,0
6598,0,346,434,3807,58,255,11498,1668,13166,-0.00684096,0.0296969,-0.999536,0
6173,0,349,437,3743,84,248,11034,1689,12723,0.00220754,0.0299274,-0.999549,0
6197,0,352,440,3823,82,263,11157,1621,12778,-0.00265171,0.0325749,-0.999466,0
6150,0,350,438,3810,61,254,11063,1682,12745,-0.00798831,0.0324872,-0.99944,0
5621,0,344,419,3417,58,236,10095,1491,11586,-0.00925791,0.0326562,-0.999424,0
6134,0,375,446,3836,54,255,11100,1641,12741,-0.00959357,0.0310259,-0.999473,0
6173,0,353,440,3851,54,254,11125,1631,12756,-0.00769154,0.035076,-0.999355,0
6158,0,402,448,3985,55,260,11308,1691,12999,-0.0110668,0.0388844,-0.999182,0
6129,0,374,447,4455,57,326,11788,1493,13281,-0.00858607,0.0371391,-0.999273,0
4203,0,245,304,2725,41,179,7697,1148,8845,-0.00934501,0.0383571,-0.999221,0
4642,0,257,313,2676,37,175,8100,1194,9294,-0.0104935,0.0403402,-0.999131,0
4229,0,247,306,2683,39,176,7680,1149,8829,-0.0121864,0.0437843,-0.998967,0
6248,0,421,446,3909,73,257,11354,1577,12931,-0.0119854,0.0452792,-0.998903,0
6337,0,349,441,3961,70,288,11446,1164,12610,-0.0144119,0.0516344,-0.998562,0
4262,0,241,302,2612,40,172,7629,1172,8801,-0.0140988,0.0482425,-0.998736,0
6736,0,346,437,3772,58,280,11629,1792,13421,-0.0108784,0.0474218,-0.998816,0
6131,0,348,433,3711,68,249,10940,1769,12709,-0.00946878,0.0468254,-0.998858,0
6307,0,343,429,3754,79,252,11164,1633,12797,-0.0121205,0.0418736,-0.99905,0
6977,0,372,454,3970,72,254,12099,1524,13623,-0.00766812,0.0433841,-0.999029,0
4245,0,238,297,2547,51,172,7550,1072,8622,-0.0138483,0.0374898,-0.999201,0
6151,0,345,434,3749,68,250,10997,1581,12578,-0.0121945,0.0383931,-0.999189,0
6264,0,343,522,3727,62,249,11167,1625,12792,-0.00926108,0.0369392,-0.999275,0
6222,0,432,437,2903,47,191,10232,1142,11374,-0.00849585,0.0359938,-0.999316,0
6260,0,345,433,3729,77,257,11101,1565,12666,-0.0120131,0.0385945,-0.999183,0
6108,0,369,505,2983,39,198,10202,1164,11366,-0.0100305,0.037144,-0.99926,0
5627,0,310,389,3324,63,223,9936,1447,11383,-0.011996,0.0389604,-0.999169,0
6101,0,345,477,3643,94,250,10910,1707,12617,-0.00998631,0.0405172,-0.999129,0
6243,0,345,459,3669,78,253,11047,1675,12722,-0.00680587,0.0381913,-0.999247,0
6391,0,527,456,2561,50,172,10157,1091,11248,-0.0088566,0.0294105,-0.999528,0
3283,0,182,238,1941,41,131,5816,813,6629,-0.00346165,0.034669,-0.999393,0
6134,0,343,452,3653,58,259,10899,1690,12589,-0.00809977,0.0359687,-0.99932,0
6195,0,345,433,4085,69,283,11410,1589,12999,-0.0156195,0.0371245,-0.999188,0
4314,0,237,314,2549,60,172,7646,1172,8818,-0.0105648,0.0375315,-0.99924,0
6277,0,364,434,3734,76,253,11138,1486,12624,-0.0147359,0.043488,-0.998945,0
6076,0,342,467,3665,58,327,10935,1577,12512,-0.00902037,0.0363558,-0.999298,0
6120,0,373,432,3683,57,245,10910,1677,12587,-0.00872585,0.0408335,-0.999128,0
6267,0,342,465,3674,61,255,11064,1262,12326,-0.0141231,0.0487512,-0.998711,0
4277,0,262,298,2466,44,167,7514,1161,8675,-0.0141197,0.0532694,-0.998481,0
6112,0,336,421,3703,78,249,10899,1675,12574,-0.0129934,0.0599224,-0.998119,0
6146,0,333,419,3557,75,245,10775,1602,12377,-0.0150049,0.0712111,-0.997348,0
6206,0,331,418,3541,54,241,10791,1415,12206,-0.00798243,0.0827759,-0.996536,0
5469,0,288,363,3111,43,211,9485,1374,10859,-0.00844474,0.106563,-0.994271,0
6154,0,312,392,3360,59,224,10501,1710,12211,-0.00768028,0.106972,-0.994233,0
6208,0,307,388,3306,61,224,10494,1586,12080,-0.0136375,0.125199,-0.992038,0
5978,0,317,383,3193,68,221,10160,1579,11739,-0.00614031,0.126501,-0.991948,0
4139,0,202,265,2086,46,145,6883,1115,7998,-0.0147735,0.117612,-0.99295,0
5928,0,266,336,2710,70,195,9505,1720,11225,-0.029119,0.117558,-0.992639,0
5868,0,242,303,2396,72,175,9056,1666,10722,-0.0466874,0.136328,-0.989563,0
5854,0,242,290,2251,56,166,8859,1578,10437,-0.0316153,0.142665,-0.989266,0
5769,0,235,284,2208,74,168,8738,1509,10247,-0.0122392,0.151954,-0.988312,0
6169,0,206,264,2013,52,161,8865,1489,10354,-0.00741477,0.163653,-0.98649,0
5245,0,173,235,1733,57,130,7573,1290,8863,-0.0136532,0.166571,-0.985935,0
6109,0,188,238,1791,59,137,8522,1404,9926,-0.0152937,0.170043,-0.985318,0
5727,0,177,228,1736,70,135,8073,1407,9480,-0.0106888,0.176252,-0.984287,0
5652,0,163,212,1600,61,121,7809,1517,9326,-0.0201372,0.16841,-0.985511,0
5613,0,146,188,1418,60,109,7534,1400,8934,-0.029691,0.197173,-0.979919,0
5841,0,127,178,1250,106,99,7601,1445,9046,-0.0170016,0.181409,-0.983261,0
5692,0,112,154,1050,57,86,7151,1478,8629,-0.00340429,0.184186,-0.982886,0
5550,0,104,141,971,69,84,6919,1443,8362,0.00203072,0.164144,-0.986435,0
5940,0,94,136,1036,52,80,7338,1452,8790,0.00691942,0.187186,-0.9823,0
5583,0,95,134,896,51,74,6833,1380,8213,0.0086531,0.136371,-0.99062,0
5744,0,93,133,853,44,77,6944,1385,8329,-0.0143959,0.180221,-0.983521,0
5593,0,100,137,960,41,78,6909,1364,8273,-0.0204996,0.158816,-0.987095,0
5884,0,112,153,1029,40,86,7304,1449,8753,-0.0138733,0.139299,-0.990153,0
5964,0,124,166,1173,58,93,7578,1409,8987,-0.0164369,0.145943,-0.989157,0
5884,0,136,182,1388,41,126,7757,1372,9129,-0.0244164,0.154296,-0.987723,0
5841,0,159,198,1496,41,125,7860,1473,9333,-0.0223392,0.140476,-0.989832,0
6284,0,167,216,1552,58,124,8401,1429,9830,0.00566834,0.0913113,-0.995806,0
6407,0,184,238,1734,61,139,8763,1445,10208,-0.00201389,0.120454,-0.992717,0
6336,0,207,268,1964,59,153,8987,1459,10446,-0.00371355,0.163241,-0.986579,0
6032,0,228,291,2240,59,168,9018,1499,10517,0.000545212,0.134891,-0.99086,0
5758,0,229,292,2267,51,170,8767,1340,10107,-0.000645126,0.125851,-0.992049,0
6306,0,282,359,2921,79,248,10195,1582,11777,0.00130226,0.123175,-0.992384,0
6947,0,315,415,3400,67,231,11375,1538,12913,-0.0224899,0.173796,-0.984525,0
6598,0,358,452,3262,47,181,10898,948,11846,-0.0226124,0.165903,-0.985883,0
4614,0,256,318,2812,49,185,8234,1051,9285,-0.0121378,0.140366,-0.990025,0
6732,0,358,460,4022,82,283,11937,1387,13324,-0.0102195,0.165126,-0.986219,0
6633,0,322,438,4210,95,238,11936,1370,13306,0.00726785,0.168958,-0.985596,0
5108,0,201,254,2166,70,190,7989,1225,9214,0.0186457,0.145242,-0.989221,0
6472,0,279,323,2655,60,180,9969,1696,11665,3.74971e-05,0.143986,-0.98958,0
6099,0,195,248,2080,68,148,8838,1580,10418,0.000665209,0.126296,-0.991992,0
5414,0,148,193,1555,69,124,7503,1459,8962,0.00373918,0.115698,-0.993277,0
5820,0,149,196,1544,83,116,7908,1550,9458,-0.0130451,0.113641,-0.993436,0
5730,0,175,213,1403,55,108,7684,1414,9098,-0.0163247,0.149429,-0.988638,0
5848,0,140,186,1386,48,106,7714,1371,9085,-0.0293746,0.131431,-0.99089,0
6718,0,157,208,1554,52,105,8794,1644,10438,-0.0356705,0.236745,-0.970917,0
7157,0,166,225,1653,62,123,9386,1540,10926,-0.032848,0.267617,-0.962965,0
5843,0,146,189,1469,52,112,7811,1392,9203,-0.0253059,0.234395,-0.971812,0
6078,0,147,191,1517,57,113,8103,1418,9521,-0.00273481,0.257305,-0.966326,0
5828,0,152,201,1581,69,116,7947,1482,9429,-0.0174237,0.260309,-0.965368,0
6517,0,184,240,1770,66,122,8899,1514,10413,-0.0115773,0.281876,-0.959381,0
6903,0,214,276,2204,65,146,9808,1579,11387,-0.0149141,0.345861,-0.938168,0
6397,0,195,255,1986,58,146,9037,1432,10469,-0.0253409,0.34695,-0.937541,0
5526,0,220,291,2308,47,184,8576,1412,9988,-0.0113478,0.340076,-0.940329,0
6310,0,287,362,3056,68,212,10295,1613,11908,-0.00224487,0.42519,-0.905101,0
6916,0,341,409,2773,33,162,10634,1136,11770,0.00143107,0.379519,-0.925183,0
3526,0,188,236,2080,31,137,6198,868,7066,0.000158371,0.32696,-0.945038,0
6332,0,328,422,3518,69,244,10913,1579,12492,0.00621776,0.326622,-0.945134,0
6050,0,281,368,2993,61,205,9958,1568,11526,0.0198838,0.322318,-0.946423,0
6311,0,255,322,2645,80,185,9798,1434,11232,0.00911447,0.334928,-0.9422,0
6060,0,212,285,2268,78,207,9110,1574,10684,0.0244245,0.279501,-0.959835,0
5835,0,193,266,2028,48,149,8519,1544,10063,0.0263199,0.296706,-0.954606,0
5913,0,286,344,2221,57,163,8984,1534,10518,0.0205937,0.225359,-0.974058,0
5963,0,176,227,1739,52,134,8291,1361,9652,0.0240657,0.235429,-0.971594,0
6565,0,183,257,1713,51,118,8887,1476,10363,0.0132133,0.192896,-0.98113,0
6489,0,207,213,1308,53,102,8372,1520,9892,-0.00286985,0.246933,-0.969028,0
5665,0,107,147,1032,50,82,7083,1446,8529,0.00957625,0.181559,-0.983334,0
6128,0,95,129,991,49,83,7475,1542,9017,0.00515021,0.208994,-0.977903,0
5832,0,89,123,802,31,48,6925,945,7870,0.00408267,0.166265,-0.986073,0
5694,0,90,123,872,44,72,6895,1399,8294,0.00565425,0.230516,-0.973052,0
5518,0,98,136,944,48,76,6820,1479,8299,0.0207125,0.172034,-0.984873,0
5585,0,112,150,1079,43,85,7054,1418,8472,-0.0039648,0.238595,-0.971111,0
6657,0,126,187,1167,44,95,8276,1396,9672,0.0107699,0.174093,-0.98467,0
6237,0,143,190,1351,66,109,8096,1402,9498,0.00383455,0.194855,-0.980824,0
6656,0,159,233,1498,51,118,8715,1373,10088,0.0171771,0.127759,-0.991657,0
7523,0,180,237,1799,39,147,9925,1450,11375,0.0110739,0.165447,-0.986157,0
5942,0,193,242,1316,26,99,7818,1055,8873,0.0174637,0.142824,-0.989594,0
4119,0,148,190,1526,34,108,6125,1064,7189,0.019276,0.121908,-0.992354,0
6425,0,232,276,1577,33,110,8653,1041,9694,0.00976965,0.149304,-0.988743,0
5046,0,193,249,2001,38,141,7668,1154,8822,0.0013622,0.146665,-0.989185,0
6450,0,283,360,2890,40,206,10229,1592,11821,0.00663463,0.143746,-0.989592,0
6469,0,314,391,3244,44,227,10689,1484,12173,0.0125931,0.148751,-0.988795,0
4974,0,242,302,2633,33,174,8358,1038,9396,0.0113947,0.107329,-0.994158,0
5973,0,347,430,3884,91,252,10977,1260,12237,0.0129458,0.132493,-0.9911,0
6888,0,418,527,4695,55,302,12885,1092,13977,0.0333342,0.144884,-0.988887,0
6664,0,425,528,3603,64,217,11501,1074,12575,0.0368864,0.154657,-0.987279,0
5363,0,332,408,3605,60,236,10004,1174,11178,0.0337891,0.136172,-0.990109,0
5421,0,311,382,3622,89,294,10119,1226,11345,0.046134,0.15427,-0.986951,0
7083,0,353,436,3886,77,259,12094,1584,13678,0.0519148,0.183685,-0.981613,0
6519,0,304,401,2873,57,174,10328,1135,11463,0.0353923,0.169751,-0.984852,0
4779,0,169,216,2151,44,127,7486,1109,8595,0.021219,0.131038,-0.991151,0
6057,0,204,256,2022,56,150,8745,1593,10338,0.004505,0.132404,-0.991186,0
6077,0,215,235,1793,50,137,8507,1586,10093,-0.0190309,0.129806,-0.991357,0
5923,0,235,303,2163,73,129,8826,1492,10318,-0.0289102,0.14984,-0.988288,0
5976,0,150,197,1469,53,109,7954,1394,9348,-0.0317228,0.131729,-0.990778,0
6472,0,239,265,1850,62,123,9011,1428,10439,-0.0493919,0.164683,-0.985109,0
5935,0,163,209,1612,72,121,8112,1416,9528,-0.0503735,0.134663,-0.98961,0
6688,0,167,218,1693,68,125,8959,1437,10396,-0.0509892,0.199349,-0.978601,0
5883,0,242,326,2233,64,134,8882,1411,10293,-0.054225,0.175976,-0.9829,0
5886,0,169,220,1731,67,127,8200,1382,9582,-0.0762856,0.258687,-0.962944,0
6407,0,178,230,1806,68,134,8823,1454,10277,-0.090641,0.28247,-0.954984,0
5894,0,196,331,1937,75,146,8579,1435,10014,-0.0998168,0.268391,-0.958125,0
6061,0,214,313,2242,74,161,9065,1488,10553,-0.0838259,0.243447,-0.966285,0
6110,0,233,308,3117,75,179,10022,1539,11561,-0.0966675,0.255786,-0.961888,0
5519,0,233,311,2451,52,175,8741,1430,10171,-0.106311,0.250497,-0.962263,0
6316,0,288,365,3047,50,213,10279,1772,12051,-0.120362,0.269896,-0.955337,0
6367,0,327,409,3595,58,242,10998,1777,12775,-0.119957,0.29088,-0.94921,0
6500,0,377,470,4245,50,269,11911,1450,13361,-0.100843,0.288392,-0.952188,0
6633,0,418,527,4788,49,298,12713,1670,14383,-0.107316,0.299582,-0.948016,0
6705,0,383,480,4148,65,277,12058,1500,13558,-0.122562,0.312194,-0.942079,0
6216,0,331,419,3581,53,246,10846,1590,12436,-0.116332,0.287123,-0.950804,0
6337,0,296,377,3103,57,214,10384,1455,11839,-0.112633,0.296668,-0.948315,0
6299,0,238,303,2462,57,176,9535,1564,11099,-0.105815,0.285456,-0.952533,0
6958,0,213,317,2122,29,111,9750,1020,10770,-0.120272,0.289559,-0.949574,0
6152,0,192,248,2424,63,184,9263,1899,11162,-0.122612,0.284907,-0.950681,0
6254,0,205,240,1763,56,133,8651,1405,10056,-0.1063,0.262649,-0.959018,0
4056,0,122,160,1086,31,106,5561,1018,6579,-0.114468,0.239505,-0.964123,0
6703,0,153,205,1513,54,119,8747,1628,10375,-0.115498,0.230906,-0.966097,0
5567,0,84,115,811,31,63,6671,1060,7731,-0.0822471,0.185812,-0.979137,0
2899,0,58,89,552,32,45,3675,728,4403,-0.0721338,0.171189,-0.982594,0
7297,0,121,168,1159,76,96,8917,1608,10525,-0.0426756,0.143584,-0.988718,0
6120,0,175,200,1265,68,101,7929,1549,9478,-0.0660553,0.151295,-0.986279,0
6340,0,142,187,1384,55,107,8215,1485,9700,-0.0289163,0.100403,-0.994527,0
6784,0,147,195,1411,51,109,8697,1423,10120,-0.0909096,0.170222,-0.981203,0
5883,0,169,218,1681,39,126,8116,1505,9621,-0.0529559,0.129503,-0.990164,0
6229,0,193,245,1915,48,140,8770,1508,10278,-0.0547814,0.168624,-0.984157,0
6156,0,334,438,2350,49,166,9493,1561,11054,-0.0281913,0.130839,-0.991003,0
6159,0,245,314,2517,39,184,9458,1318,10776,-0.0410905,0.154347,-0.987162,0
5480,0,245,312,2509,37,179,8762,1364,10126,-0.0256635,0.132589,-0.990839,0
6160,0,309,390,3274,55,230,10418,1565,11983,-0.0957478,0.170192,-0.980748,0
7060,0,345,435,3642,42,250,11774,1513,13287,-0.0748281,0.134592,-0.988072,0
4565,0,273,339,3097,47,201,8522,1205,9727,-0.088623,0.154588,-0.983996,0
7079,0,455,576,5179,121,386,13796,990,14786,-0.114448,0.163709,-0.979848,0
4793,0,318,400,3535,76,228,9350,977,10327,-0.118236,0.155334,-0.980761,0
7711,0,436,561,4769,61,312,13850,1448,15298,-0.086099,0.125143,-0.988396,0
6719,0,393,513,4232,66,285,12208,1451,13659,-0.0785056,0.138582,-0.987235,0
4584,0,247,306,2696,58,179,8070,1158,9228,-0.090339,0.149276,-0.98466,0
6573,0,307,383,3230,66,223,10782,1674,12456,-0.0850341,0.151763,-0.984752,0
6356,0,254,346,2660,65,189,9870,1674,11544,-0.0464882,0.0968643,-0.994212,0
6914,0,252,320,2502,66,187,10241,1804,12045,-0.0756691,0.124857,-0.989285,0
6986,0,222,285,1829,38,110,9470,1092,10562,-0.0747414,0.0985993,-0.992317,0
4492,0,139,223,1353,35,102,6344,1032,7376,-0.0823644,0.0915684,-0.992387,0
6880,0,206,263,1957,49,133,9488,1421,10909,-0.0823136,0.0983678,-0.99174,0
6112,0,187,237,1891,47,140,8614,1405,10019,-0.123964,0.12758,-0.984051,0
6165,0,192,246,1974,46,142,8765,1408,10173,-0.1234,0.126752,-0.984229,0
6359,0,208,250,1989,51,144,9001,1410,10411,-0.142679,0.182973,-0.972709,0
6047,0,198,254,2044,65,148,8756,1402,10158,-0.142324,0.204479,-0.968469,0
5978,0,203,258,2114,79,154,8786,1576,10362,-0.144068,0.222911,-0.964134,0
6851,0,235,303,2366,85,163,10003,1678,11681,-0.153457,0.235696,-0.959634,0
6101,0,243,286,2288,86,165,9169,1765,10934,-0.141915,0.219281,-0.965286,0
6296,0,241,308,2478,56,180,9559,1656,11215,-0.163333,0.254101,-0.953286,0
6260,0,271,353,2903,54,208,10049,1789,11838,-0.161656,0.239227,-0.957412,0
6353,0,299,374,3186,43,221,10476,1778,12254,-0.166753,0.254454,-0.9526,0
6317,0,326,405,3483,48,238,10817,1736,12553,-0.191421,0.3129,-0.930297,0
6514,0,365,456,4149,57,265,11806,1756,13562,-0.186627,0.319803,-0.928922,0
4630,0,279,345,3262,44,202,8762,1249,10011,-0.151855,0.283493,-0.946875,0
4642,0,303,419,3687,38,221,9310,1211,10521,-0.119373,0.222674,-0.967557,0
7601,0,481,612,5322,73,359,14448,1559,16007,-0.13521,0.285485,-0.948797,0
4522,0,266,357,2623,30,147,7945,873,8818,-0.119853,0.250094,-0.960775,0
5200,0,283,354,3074,60,202,9173,1239,10412,-0.104299,0.230151,-0.96755,0
7102,0,298,420,3277,53,217,11367,1544,12911,-0.107591,0.244491,-0.963664,0
6189,0,256,335,2538,66,184,9568,1603,11171,-0.123141,0.248493,-0.960775,0
6094,0,232,298,2423,44,174,9265,1555,10820,-0.1255,0.224025,-0.966469,0
5480,0,216,290,2028,52,147,8213,1407,9620,-0.108402,0.204563,-0.972833,0
6462,0,210,268,2227,53,157,9377,1411,10788,-0.104754,0.211427,-0.971764,0
6353,0,190,243,1963,66,145,8960,1408,10368,-0.104705,0.221359,-0.969555,0
5971,0,162,212,1588,51,120,8104,1457,9561,-0.0852595,0.192124,-0.97766,0
6450,0,137,181,1324,46,103,8241,1414,9655,-0.0842167,0.201201,-0.975923,0
6112,0,119,184,1080,44,93,7632,1482,9114,-0.0664681,0.190132,-0.979506,0
5721,0,109,147,1095,50,87,7209,1638,8847,-0.0711903,0.200087,-0.977188,0
5651,0,118,159,1100,40,91,7159,1454,8613,-0.0677268,0.17099,-0.982942,0
5744,0,233,281,1764,43,114,8179,1515,9694,-0.112276,0.209019,-0.971445,0
6045,0,171,223,1696,61,127,8323,1626,9949,-0.0982119,0.186908,-0.977456,0
5998,0,201,259,2003,72,147,8680,1672,10352,-0.0860644,0.184439,-0.979068,0
6061,0,232,297,2413,39,173,9215,1582,10797,-0.0787373,0.177402,-0.980984,0
6163,0,268,343,2827,38,214,9853,1497,11350,-0.0752374,0.203327,-0.976216,0
6306,0,308,388,3340,53,227,10622,1726,12348,-0.0733904,0.189703,-0.979095,0
6549,0,354,442,3868,53,258,11524,1626,13150,-0.0881298,0.187342,-0.978334,0
6918,0,393,491,3320,37,197,11356,1055,12411,-0.0952962,0.16942,-0.980926,0
4454,0,280,351,3214,79,202,8580,970,9550,-0.0722146,0.149127,-0.986178,0
7060,0,451,571,5214,68,325,13689,1373,15062,-0.0784411,0.184432,-0.97971,0
7006,0,431,542,3882,40,210,12111,1000,13111,-0.0677079,0.136633,-0.988305,0
4732,0,272,336,3008,56,197,8601,1025,9626,-0.0687004,0.115261,-0.990957,0
4294,0,230,286,2529,30,169,7538,1089,8627,-0.0668246,0.130399,-0.989207,0
6549,0,312,388,3271,62,271,10853,1829,12682,-0.0735451,0.151344,-0.985741,0
6377,0,259,328,2742,53,194,9953,1394,11347,-0.07267,0.141745,-0.987233,0
6200,0,291,303,2378,60,173,9405,1571,10976,-0.0611638,0.143324,-0.987784,0
6296,0,367,366,2680,65,167,9941,1451,11392,-0.0584544,0.137608,-0.98876,0
6116,0,209,265,2176,56,156,8978,1353,10331,-0.0470772,0.0923181,-0.994616,0
6421,0,325,396,2114,72,166,9494,1400,10894,-0.0729038,0.145555,-0.98666,0
4242,0,145,186,1463,30,106,6172,981,7153,-0.0734783,0.105958,-0.991652,0
6986,0,208,267,2187,50,162,9860,1387,11247,-0.0987195,0.184286,-0.977903,0
6213,0,207,281,2124,58,154,9037,1419,10456,-0.112279,0.223942,-0.968113,0
6080,0,204,261,2057,51,250,8903,1477,10380,-0.10929,0.243207,-0.963798,0
4173,0,145,185,1488,57,107,6155,1169,7324,-0.101565,0.238787,-0.965746,0
7023,0,309,331,2533,74,244,10514,1913,12427,-0.103945,0.37642,-0.920599,0
6570,0,285,346,2638,62,186,10087,1806,11893,-0.0840416,0.36872,-0.925733,0
6402,0,275,348,2853,69,206,10153,1786,11939,-0.0717005,0.315222,-0.946305,0
9417,0,485,575,4347,77,212,15113,1278,16391,-0.0624054,0.285521,-0.956339,0
3449,0,178,220,1978,24,130,5979,961,6940,-0.048731,0.286599,-0.956811,0
7245,0,387,481,4446,90,321,12970,1624,14594,-0.0397226,0.288677,-0.956602,0
6826,0,438,552,5159,77,218,13270,1184,14454,-0.0604145,0.346262,-0.936191,0
4636,0,278,343,3089,40,201,8587,1193,9780,-0.0634838,0.300414,-0.951694,0
6538,0,357,447,3955,54,329,11680,1507,13187,-0.0721716,0.29978,-0.951274,0
6369,0,329,410,3576,58,243,10985,1192,12177,-0.0663976,0.26495,-0.961973,0
4318,0,201,249,2019,49,155,6991,1132,8123,-0.0580907,0.26702,-0.961939,0
6198,0,252,319,2633,50,186,9638,1555,11193,-0.0552506,0.263544,-0.963064,0
6235,0,230,293,2277,57,167,9259,1428,10687,-0.0627678,0.264127,-0.962444,0
6031,0,210,272,2177,49,159,8898,1416,10314,-0.0534307,0.269716,-0.961456,0
5962,0,179,233,1772,43,136,8325,1396,9721,-0.0486163,0.262692,-0.963654,0
6077,0,142,186,1345,44,106,7900,1411,9311,-0.0359297,0.223122,-0.974128,0
5705,0,162,168,1176,51,92,7354,1429,8783,-0.0394262,0.24984,-0.967484,0
5929,0,107,146,975,46,82,7285,1496,8781,-0.0202535,0.190597,-0.98146,0
5765,0,110,152,1015,47,84,7173,1496,8669,-0.0303142,0.199149,-0.9795,0
6693,0,184,188,1217,50,102,8434,1494,9928,-0.0356486,0.219767,-0.974901,0
6052,0,148,197,1384,61,110,7952,1359,9311,-0.0306055,0.196789,-0.979968,0
5994,0,169,223,1770,44,136,8336,1625,9961,-0.0141828,0.192986,-0.981099,0
6760,0,193,289,2293,40,151,9726,1600,11326,-0.0134584,0.204196,-0.978837,0
6181,0,220,283,2192,39,160,9075,1609,10684,-0.0179782,0.187464,-0.982107,0
4344,0,179,220,1824,26,129,6722,1347,8069,-0.0237473,0.185254,-0.982404,0
6556,0,298,375,3059,42,215,10545,1703,12248,-0.0179862,0.192102,-0.98121,0
6666,0,344,458,3923,51,253,11695,1089,12784,-0.00697311,0.173892,-0.98474,0
6122,0,352,434,4563,43,258,11772,1284,13056,-0.00119546,0.138707,-0.990333,0
7044,0,423,555,4339,32,211,12604,973,13577,-0.0107958,0.184264,-0.982818,0
4768,0,386,498,3210,38,227,9127,1059,10186,-0.0232473,0.17089,-0.985016,0
8268,0,417,552,4154,62,187,13640,1087,14727,-0.0263763,0.282894,-0.958788,0
4769,0,270,309,2359,31,128,7866,866,8732,-0.0329544,0.24786,-0.968235,0
3383,0,155,194,1686,24,112,5554,908,6462,-0.0271352,0.186035,-0.982169,0
4637,0,176,222,1877,50,133,7095,1226,8321,-0.0251836,0.160718,-0.986679,0
6908,0,237,301,2414,63,175,10098,1820,11918,-0.0167973,0.148484,-0.988772,0
5999,0,196,249,1997,48,143,8632,1500,10132,-0.00977171,0.131926,-0.991212,0
5977,0,184,234,1879,94,136,8504,1449,9953,-0.0117312,0.120068,-0.992697,0
6050,0,182,234,1819,46,154,8485,1428,9913,-0.0216293,0.114303,-0.993211,0
6089,0,184,235,1934,44,140,8626,1620,10246,-0.0368157,0.156362,-0.987013,0
4221,0,130,166,1335,27,98,5977,947,6924,-0.0412473,0.160263,-0.986212,0
6218,0,189,245,2040,115,153,8960,1399,10359,-0.0475471,0.234877,-0.970862,0
6201,0,185,234,1825,54,158,8657,1519,10176,-0.0438182,0.271472,-0.961448,0
6360,0,212,256,1984,55,149,9016,1563,10579,-0.0374941,0.313842,-0.948735,0
4279,0,134,169,1297,38,99,6016,1137,7153,-0.0328676,0.271344,-0.961921,0
6609,0,210,278,2100,42,158,9397,1759,11156,-0.0479261,0.322001,-0.945525,0
6361,0,291,464,2733,38,178,10065,1316,11381,-0.052319,0.275357,-0.959917,0
4492,0,177,223,1830,28,131,6881,1263,8144,-0.065065,0.298346,-0.952238,0
6494,0,258,341,2704,39,192,10028,1622,11650,-0.0618747,0.293992,-0.953803,0
5865,0,299,385,3202,59,213,10023,1651,11674,-0.0318962,0.324701,-0.945279,0
7253,0,420,463,4307,58,188,12689,1179,13868,-0.0126611,0.332285,-0.943094,0
4774,0,279,346,3127,38,201,8765,1237,10002,-0.0116118,0.293125,-0.956004,0
6837,0,383,474,4282,57,276,12309,1590,13899,-0.00190593,0.317459,-0.94827,0
4548,0,251,303,2662,57,176,7997,979,8976,0.0040159,0.30661,-0.951827,0
6817,0,326,407,3642,65,238,11495,1580,13075,-0.0183657,0.305163,-0.952123,0
6512,0,276,351,2948,72,205,10364,1517,11881,-0.0367886,0.285265,-0.957743,0
4260,0,172,217,1785,34,125,6593,1192,7785,-0.0285656,0.2308,-0.972582,0
6024,0,222,284,2367,54,166,9117,1453,10570,-0.0237023,0.253135,-0.96714,0
6345,0,324,383,2433,45,160,9690,1439,11129,-0.0115396,0.245759,-0.969262,0
6032,0,188,264,1886,75,137,8582,1414,9996,-0.00947003,0.216315,-0.976278,0
5917,0,156,207,1504,43,115,7942,1396,9338,-0.0055785,0.234428,-0.972117,0
5782,0,124,168,1192,52,122,7440,1393,8833,0.00167172,0.22481,-0.974401,0
5638,0,106,145,1045,54,84,7072,1394,8466,0.0142416,0.198135,-0.980071,0
5656,0,104,151,986,59,84,7040,1568,8608,0.0092027,0.27371,-0.961768,0
5715,0,121,163,1105,50,94,7248,1458,8706,0.0051981,0.244259,-0.969696,0
6008,0,140,184,1322,60,108,7822,1637,9459,-0.00154674,0.265707,-0.964053,0
6495,0,169,286,1579,62,127,8718,1729,10447,0.00464939,0.232668,-0.972545,0
4182,0,131,168,1288,31,100,5900,1148,7048,0.00105561,0.199528,-0.979892,0
6227,0,218,308,2202,44,168,9167,1666,10833,-0.0114764,0.208917,-0.977866,0
6391,0,249,318,2536,39,185,9718,1947,11665,-0.0153279,0.192748,-0.981129,0
4474,0,207,274,1976,27,145,7103,1176,8279,-0.0107665,0.190311,-0.981665,0
7352,0,324,466,3541,69,239,11991,1613,13604,-0.00729503,0.183459,-0.983,0
6842,0,363,453,3198,47,201,11104,1077,12181,0.00322648,0.167676,-0.985837,0
5276,0,279,371,3106,54,216,9302,1019,10321,0.0140897,0.163456,-0.98645,0
6906,0,448,536,4960,85,312,13247,1421,14668,0.00641685,0.149018,-0.988814,0
6928,0,408,505,4426,66,292,12625,1444,14069,-0.000592298,0.0987618,-0.995111,0
6711,0,349,434,3761,52,250,11557,1268,12825,0.00952909,0.053595,-0.998517,0
6038,0,337,440,3611,52,258,10736,926,11662,0.0242051,0.0192169,-0.999522,0
7080,0,386,471,4022,81,271,12311,1467,13778,0.0247577,-0.0064241,-0.999673,0
6932,0,377,469,4417,39,192,12426,1034,13460,0.0148842,-0.0299647,-0.99944,0
4666,0,264,348,2842,53,190,8363,1041,9404,0.0150673,-0.0218297,-0.999648,0
8403,0,481,509,4319,50,307,14069,1565,15634,0.0131247,-0.00589762,-0.999896,0
6744,0,383,473,3114,35,192,10941,1078,12019,0.00443406,0.00402991,-0.999982,0
3675,0,320,312,2132,26,144,6609,854,7463,-0.00375349,0.0133468,-0.999904,0
6976,0,396,465,5024,130,398,13389,2087,15476,0.00926529,0.0288977,-0.99954,0
3642,0,200,238,2062,42,154,6338,850,7188,0.0163278,0.0335032,-0.999305,0
7112,0,420,441,3865,73,253,12164,1661,13825,-0.00195537,0.0509963,-0.998697,0
6682,0,335,418,3667,82,245,11429,1450,12879,-0.0205415,0.0547798,-0.998287,0
5016,0,237,282,2502,43,163,8243,1244,9487,-0.0100168,0.0616743,-0.998046,0
6634,0,359,429,3812,57,233,11524,1818,13342,-0.00420999,0.0845448,-0.996411,0
4506,0,203,253,2129,48,152,7291,1260,8551,0.00460171,0.0660597,-0.997805,0
6427,0,266,339,2798,56,207,10093,1780,11873,0.0105787,0.0964339,-0.995283,0
6277,0,224,286,2289,97,163,9336,1649,10985,0.019822,0.0918404,-0.995577,0
6223,0,207,264,2115,59,156,9024,1616,10640,0.0252837,0.0964311,-0.995018,0
6101,0,187,237,2258,50,196,9029,1619,10648,0.0173895,0.068835,-0.997476,0
6448,0,280,350,1895,44,134,9151,1489,10640,-0.00440594,0.0971855,-0.995257,0
6138,0,165,214,1626,42,159,8344,1493,9837,-0.0212157,0.127746,-0.99158,0
6168,0,166,247,1673,44,133,8431,1391,9822,-0.0354543,0.151744,-0.987784,0
6708,0,176,228,1794,71,134,9111,1373,10484,-0.0441274,0.291405,-0.955581,0
4234,0,127,168,960,22,72,5583,744,6327,-0.0385259,0.228746,-0.972723,0
2687,0,79,102,752,22,58,3700,598,4298,-0.0374907,0.183225,-0.982356,0
7339,0,249,295,1799,50,147,9879,1451,11330,-0.0263643,0.236414,-0.971295,0
6306,0,194,250,1851,58,149,8808,1656,10464,-0.029822,0.207493,-0.977782,0
7258,0,236,304,2200,58,156,10212,1781,11993,-0.0126391,0.297735,-0.954565,0
4365,0,211,231,1529,40,117,6493,1140,7633,-0.00830152,0.284656,-0.958594,0
6845,0,247,311,2489,56,185,10133,1768,11901,0.0115139,0.333898,-0.942539,0
7077,0,396,431,2846,53,214,11017,1847,12864,0.0164776,0.310192,-0.950531,0
4568,0,217,285,2375,38,160,7643,1296,8939,0.0210161,0.303849,-0.952488,0
6760,0,359,452,4048,54,260,11933,1881,13814,0.0166675,0.3413,-0.939807,0
7484,0,450,543,3399,40,204,12120,1309,13429,0.0196716,0.343464,-0.93896,0
3582,0,232,263,2328,45,151,6601,907,7508,0.015053,0.289511,-0.957056,0
6813,0,362,457,4056,63,299,12050,1737,13787,0.00848765,0.332169,-0.943182,0
6478,0,353,443,3050,39,175,10538,1151,11689,-0.00298882,0.298537,-0.954393,0
3378,0,165,206,1735,34,117,5635,857,6492,-0.00782664,0.237404,-0.971379,0
7867,0,309,397,3249,74,201,12097,1742,13839,-0.0104335,0.267159,-0.963596,0
6430,0,245,312,2605,54,182,9828,1612,11440,-0.00816661,0.238804,-0.971034,0
6198,0,223,284,2266,63,168,9202,1318,10520,-0.00223696,0.212281,-0.977206,0
4355,0,161,217,1402,38,104,6277,1030,7307,0.0025166,0.193729,-0.981052,0
6187,0,192,292,1957,60,144,8832,1393,10225,0.00975086,0.203307,-0.979067,0
6220,0,177,232,1800,43,133,8605,1168,9773,0.0154506,0.206446,-0.978336,0
4190,0,109,143,1155,35,84,5716,988,6704,0.0196718,0.17629,-0.984142,0
7172,0,176,213,1459,53,117,9190,1587,10777,0.0175511,0.230811,-0.97284,0
4339,0,90,135,819,35,68,5486,1088,6574,0.00991597,0.190306,-0.981675,0
6576,0,129,178,1227,59,104,8273,1691,9964,0.00363977,0.234659,-0.972071,0
9131,0,195,270,1677,79,135,11487,1426,12913,0.0030986,0.22688,-0.973918,0
5806,0,144,188,1266,37,82,7523,1004,8527,0.00647741,0.226214,-0.974056,0
6172,0,149,195,1384,47,112,8059,1464,9523,0.0159714,0.182726,-0.983034,0
6995,0,212,270,2038,79,158,9752,1798,11550,0.0217241,0.198641,-0.979832,0
6974,0,244,313,2458,67,182,10238,1766,12004,0.0241861,0.183339,-0.982753,0
6457,0,251,330,2559,42,187,9826,1690,11516,0.0185608,0.202516,-0.979103,0
5788,0,253,322,2641,39,186,9229,1407,10636,0.00444183,0.207802,-0.978161,0
7563,0,388,525,4043,56,271,12846,1255,14101,0.000848449,0.2088,-0.977958,0
5057,0,282,351,3059,44,202,8995,1171,10166,-9.95649e-05,0.193698,-0.981061,0
7933,0,517,598,5139,43,226,14456,1060,15516,0.0129155,0.217112,-0.976061,0
8160,0,547,588,5224,91,378,14988,1710,16698,0.00356424,0.285056,-0.958504,0
3838,0,175,215,2126,28,127,6509,679,7188,0.00332261,0.192675,-0.981257,0
2138,0,115,144,1252,28,83,3760,540,4300,0.00960327,0.140547,-0.990027,0
4505,0,223,276,2428,35,163,7630,1148,8778,0.0207098,0.145682,-0.989115,0
7271,0,340,414,2950,70,220,11265,1599,12864,0.0100672,0.123744,-0.992263,0
7027,0,227,295,2164,41,140,9894,1036,10930,0.0104079,0.132822,-0.991085,0
4319,0,139,177,1387,34,104,6160,1072,7232,0.0154253,0.118653,-0.992816,0
7230,0,209,315,2152,53,160,10119,1572,11691,0.00294029,0.130724,-0.991414,0
6730,0,179,230,1769,58,181,9147,1443,10590,-0.00439964,0.115817,-0.993261,0
7128,0,212,273,1995,45,139,9792,1388,11180,0.0278131,0.181623,-0.982975,0
6420,0,194,276,1879,43,145,8957,1510,10467,0.0167763,0.153688,-0.987977,0
6321,0,240,256,1934,71,148,8970,1419,10389,0.0239189,0.211344,-0.977119,0
6468,0,197,251,1988,56,170,9130,1433,10563,0.0260178,0.203512,-0.978727,0
4385,0,145,175,1349,36,104,6194,965,7159,0.0274789,0.244694,-0.969211,0
6940,0,207,300,2262,51,157,9917,1623,11540,0.0138603,0.254207,-0.967051,0
6411,0,218,280,2192,50,165,9316,1554,10870,0.0165893,0.302566,-0.952984,0
6643,0,239,301,2468,51,177,9879,1689,11568,0.0119313,0.241875,-0.970234,0
6649,0,257,328,2642,49,192,10117,1776,11893,0.0276292,0.298052,-0.95415,0
6488,0,281,373,2874,52,230,10298,1724,12022,0.0249764,0.253865,-0.966917,0
6845,0,316,396,3417,47,229,11250,1681,12931,0.0443929,0.312848,-0.948765,0
7741,0,398,519,4413,57,257,13385,1998,15383,0.0392327,0.275434,-0.960519,0
4776,0,349,348,3280,41,220,9014,1239,10253,0.0418326,0.314902,-0.948202,0
5533,0,324,456,3637,50,239,10239,1397,11636,0.029457,0.316767,-0.948046,0
5419,0,299,370,3372,67,279,9806,1454,11260,0.0217221,0.323812,-0.945872,0
7322,0,409,522,3885,76,259,12473,1681,14154,0.0152164,0.273604,-0.961722,0
4903,0,224,282,2368,42,163,7982,1171,9153,0.019399,0.25413,-0.966975,0
6011,0,258,326,2628,49,185,9457,1393,10850,0.0230362,0.227427,-0.973523,0
6866,0,284,374,2619,57,186,10386,1494,11880,0.030641,0.239392,-0.970439,0
4447,0,234,281,1941,45,135,7083,1025,8108,0.0262298,0.185036,-0.982382,0
6356,0,257,279,2227,56,161,9336,1462,10798,0.0499279,0.228029,-0.972374,0
8570,0,211,275,1930,43,130,11159,846,12005,0.0434497,0.18178,-0.982379,0
3163,0,84,109,841,33,74,4304,767,5071,0.0399777,0.173915,-0.983949,0
5939,0,135,179,1301,47,104,7705,1378,9083,0.0236493,0.371496,-0.928134,0
6581,0,117,157,1200,51,102,8208,1525,9733,0.0171919,0.352781,-0.935548,0
3919,0,75,103,624,27,43,4791,745,5536,0.017223,0.234962,-0.971852,0
2412,0,50,67,458,21,38,3046,621,3667,0.0164502,0.15561,-0.987682,0
5785,0,147,177,1207,53,101,7470,1533,9003,0.0353842,0.212954,-0.976421,0
6373,0,150,195,1345,52,110,8225,1588,9813,0.0382676,0.170294,-0.98465,0
6191,0,179,219,1568,53,124,8334,1520,9854,0.0493779,0.297415,-0.953471,0
5848,0,130,175,1262,42,98,7555,1134,8689,0.0490921,0.244738,-0.968346,0
2979,0,89,113,866,21,68,4136,654,4790,0.0452959,0.150643,-0.98755,0
6313,0,240,308,2399,45,199,9504,1585,11089,0.0245686,0.211747,-0.977016,0
6354,0,272,343,2810,42,196,10017,1562,11579,0.0182656,0.182427,-0.98305,0
6492,0,314,404,3412,51,232,10905,1572,12477,0.0186011,0.207725,-0.978011,0
6654,0,364,462,3934,78,274,11766,1015,12781,0.0115981,0.153002,-0.988158,0
4828,0,272,337,3081,50,207,8775,1070,9845,-0.0010125,0.160317,-0.987065,0
6785,0,386,489,4204,71,296,12231,1413,13644,0.0207556,0.14218,-0.989623,0
6721,0,373,473,3904,72,262,11805,1399,13204,0.0500394,0.166096,-0.984839,0
5919,0,301,373,3335,80,222,10230,1463,11693,0.0520517,0.121488,-0.991227,0
6622,0,281,376,2930,82,204,10495,1647,12142,0.0440675,0.130689,-0.990444,0
6931,0,238,302,2487,67,178,10203,1519,11722,0.0399926,0.210902,-0.976689,0
6145,0,232,264,1821,36,104,8602,1057,9659,0.0262142,0.167503,-0.985523,0
3912,0,121,153,1195,31,88,5500,900,6400,0.00561509,0.108403,-0.994091,0
6281,0,226,240,1835,46,141,8769,1411,10180,-0.00218973,0.161735,-0.986832,0
6910,0,295,296,1938,46,148,9633,1392,11025,0.0154483,0.180136,-0.98352,0
6580,0,204,259,2002,41,161,9247,1388,10635,0.0256274,0.228141,-0.973291,0
6240,0,206,262,2067,42,156,8973,1376,10349,0.0387719,0.256173,-0.965853,0
6246,0,206,263,2009,44,151,8919,1429,10348,0.0440914,0.248353,-0.967666,0
6787,0,215,276,2102,79,158,9617,1646,11263,0.0671837,0.386918,-0.919663,0
4134,0,118,149,1179,36,86,5702,913,6615,0.0637882,0.352085,-0.933792,0
2714,0,100,128,983,20,72,4017,749,4766,0.0593405,0.307852,-0.949582,0
6569,0,246,317,2507,49,219,9907,1827,11734,0.0504932,0.366482,-0.929054,0
6384,0,273,343,2868,50,202,10120,1623,11743,0.0353332,0.343589,-0.938455,0
6549,0,315,418,3426,48,232,10988,1755,12743,0.0435921,0.385019,-0.921879,0
6527,0,359,448,3899,53,260,11546,1495,13041,0.0530878,0.351073,-0.934842,0
4516,0,261,365,2868,51,186,8247,1181,9428,0.0445868,0.29981,-0.952956,0
7485,0,371,445,3763,61,256,12381,1573,13954,0.0527245,0.298902,-0.952826,0
6706,0,365,495,4559,122,433,12680,1846,14526,0.0731338,0.306327,-0.949113,0
4580,0,227,345,2550,58,166,7926,986,8912,0.0695923,0.247011,-0.966511,0
6720,0,299,376,3195,47,221,10858,1684,12542,0.106239,0.296369,-0.949146,0
6649,0,280,457,2205,40,142,9773,981,10754,0.0916402,0.242535,-0.965805,0
4592,0,175,258,1830,37,130,7022,1010,8032,0.0895475,0.250005,-0.964095,0
6258,0,222,282,2265,56,166,9249,1409,10658,0.0799944,0.225382,-0.970981,0
6208,0,187,266,1878,49,142,8730,1371,10101,0.100359,0.273973,-0.956487,0
5297,0,137,179,1306,40,100,7059,1384,8443,0.0932439,0.233762,-0.967812,0
5667,0,125,166,1198,44,96,7296,1375,8671,0.0983749,0.2367,-0.96659,0
5720,0,128,150,999,51,82,7130,1425,8555,0.0798528,0.186523,-0.9792,0
5625,0,102,138,923,55,78,6921,1434,8355,0.0935905,0.185271,-0.978221,0
5819,0,110,150,1027,65,85,7256,1511,8767,0.0922277,0.18723,-0.977977,0
5763,0,135,171,1217,46,98,7430,1519,8949,0.0914481,0.170417,-0.98112,0
5769,0,138,181,1257,42,103,7490,1411,8901,0.0793466,0.14673,-0.985989,0
5944,0,158,207,1475,48,139,7971,1525,9496,0.0886937,0.166363,-0.982068,0
5987,0,180,234,1675,54,136,8266,1494,9760,0.0834356,0.182365,-0.979684,0
6154,0,273,274,1997,49,153,8900,1465,10365,0.0775087,0.195696,-0.977597,0
6149,0,243,339,2465,43,182,9421,1496,10917,0.0795669,0.156225,-0.984512,0
6361,0,311,359,2920,51,205,10207,1535,11742,0.0977563,0.16597,-0.981273,0
6418,0,332,420,3627,67,244,11108,1449,12557,0.0781441,0.164425,-0.98329,0
6657,0,372,465,4077,57,224,11852,982,12834,0.0702325,0.177295,-0.981648,0
6811,0,385,477,4214,85,282,12254,1404,13658,0.0777813,0.280982,-0.956556,0
5681,0,260,324,2429,44,142,8880,745,9625,0.0560583,0.226978,-0.972285,0
2622,0,128,157,1346,30,90,4373,501,4874,0.0353872,0.134994,-0.990214,0
6632,0,326,438,3411,56,241,11104,1655,12759,0.0873276,0.222756,-0.970955,0
3895,0,148,183,1551,44,114,5935,841,6776,0.0655696,0.14705,-0.986953,0
3042,0,113,143,1196,29,85,4608,730,5338,0.040907,0.0740536,-0.996415,0
6728,0,196,256,1953,61,145,9339,1479,10818,0.0384364,0.0979161,-0.994452,0
6081,0,178,220,1703,51,154,8387,1535,9922,0.0718101,0.259045,-0.963192,0
6075,0,156,203,1134,33,83,7684,977,8661,0.0590917,0.2199,-0.973731,0
3528,0,80,104,766,27,59,4564,798,5362,0.0345035,0.150879,-0.98795,0
2654,0,64,84,619,19,48,3488,798,4286,0.0240501,0.141283,-0.989677,0
6013,0,151,200,1477,43,116,8000,1586,9586,0.0637672,0.338074,-0.938957,0
4933,0,107,136,1020,30,80,6306,1283,7589,0.0411022,0.258603,-0.965109,0
3203,0,84,109,798,26,63,4283,851,5134,0.0382616,0.234765,-0.971299,0
6131,0,185,238,1741,51,137,8483,1407,9890,0.0532226,0.266476,-0.962371,0
6144,0,211,269,1994,50,155,8823,1400,10223,0.0789403,0.328888,-0.941064,0
6499,0,238,303,2305,57,172,9574,1420,10994,0.0669831,0.293531,-0.9536,0
6291,0,269,337,2954,54,204,10109,1020,11129,0.101509,0.371759,-0.922763,0
4361,0,379,359,2403,40,163,7705,1120,8825,0.0838215,0.310347,-0.946921,0
6599,0,377,460,4201,54,274,11965,1635,13600,0.102407,0.336023,-0.93627,0
4624,0,273,338,3037,36,198,8506,1100,9606,0.0747578,0.280411,-0.956965,0
6338,0,350,404,3437,60,229,10818,1377,12195,0.0957249,0.323906,-0.941234,0
5858,0,330,389,3254,61,223,10115,1118,11233,0.0811746,0.326252,-0.941791,0
6690,0,318,406,3372,66,229,11081,1405,12486,0.0715592,0.331792,-0.940635,0
6487,0,314,346,2776,61,199,10183,1541,11724,0.0483797,0.256314,-0.965382,0
6261,0,238,316,2493,49,178,9535,1386,10921,0.0473024,0.287829,-0.956513,0
6247,0,205,263,2028,44,149,8936,1439,10375,0.0380678,0.242744,-0.969343,0
6324,0,177,232,1740,50,132,8655,1531,10186,0.0342845,0.266061,-0.963346,0
5885,0,141,187,1411,55,108,7787,1623,9410,0.0348338,0.222154,-0.974389,0
5821,0,110,154,1038,67,84,7274,1692,8966,0.0295606,0.206682,-0.977961,0
5571,0,91,127,846,56,70,6761,2042,8803,0.031944,0.257729,-0.965689,0
5580,0,80,115,721,67,66,6629,1783,8412,0.0507278,0.235572,-0.970532,0
5682,0,92,128,870,71,77,6920,1560,8480,0.0550317,0.17497,-0.983035,0
3929,0,74,101,669,43,56,4872,1043,5915,0.0467831,0.190557,-0.980561,0
6030,0,127,170,1179,38,100,7644,1399,9043,0.0277854,0.192959,-0.980813,0
5901,0,148,195,1348,75,113,7780,1431,9211,0.0147796,0.198443,-0.980001,0
6368,0,202,230,1605,54,128,8587,1513,10100,0.00748408,0.177833,-0.984032,0
6774,0,200,259,1946,41,147,9367,1487,10854,-0.0125068,0.23901,-0.970936,0
6059,0,235,299,2400,42,172,9207,1672,10879,-0.0104699,0.193944,-0.980957,0
4424,0,197,268,2112,32,145,7178,1179,8357,-0.028549,0.206588,-0.978011,0
6542,0,333,443,3572,77,251,11218,1620,12838,-0.0174508,0.202819,-0.979061,0
6746,0,412,491,3803,35,208,11695,1057,12752,-0.00017086,0.185576,-0.98263,0
3595,0,217,273,2398,25,156,6664,810,7474,0.00812748,0.150122,-0.988634,0
6901,0,385,478,4180,53,278,12275,1450,13725,0.00551012,0.178582,-0.983909,0
6791,0,369,430,3633,86,249,11558,1473,13031,-0.0111769,0.170957,-0.985215,0
4568,0,204,256,2154,34,147,7363,1050,8413,-0.00681795,0.129477,-0.991559,0
6563,0,242,310,2464,50,175,9804,1696,11500,-0.00866342,0.121778,-0.99252,0
7074,0,194,252,1930,77,145,9672,1519,11191,-0.0197456,0.126352,-0.991789,0
5875,0,157,204,1548,53,127,7964,1564,9528,-0.0207302,0.0721513,-0.997179,0
6620,0,154,204,1522,59,118,8677,1436,10113,-0.0341373,0.177011,-0.983617,0
5837,0,124,164,1279,76,135,7615,1556,9171,-0.0245887,0.139854,-0.989867,0
5854,0,131,176,1296,47,98,7602,1392,8994,-0.0372842,0.181568,-0.982672,0
6780,0,147,195,1403,49,109,8683,1394,10077,-0.0455515,0.19059,-0.980612,0
6189,0,165,220,1653,70,129,8426,1400,9826,-0.052552,0.270923,-0.961166,0
6263,0,171,222,1633,50,130,8469,1365,9834,-0.061682,0.294768,-0.953576,0
6057,0,181,230,1824,148,190,8630,1527,10157,-0.0598983,0.310747,-0.948603,0
6242,0,199,256,1916,57,149,8819,1660,10479,-0.0484167,0.346833,-0.936677,0
6877,0,224,287,2271,60,114,9833,1183,11016,-0.0383536,0.359773,-0.932251,0
4413,0,178,224,1813,28,129,6785,1272,8057,-0.0334909,0.376173,-0.925944,0
7567,0,343,434,3678,51,251,12324,1825,14149,-0.0241722,0.409718,-0.911892,0
4935,0,265,329,2887,46,190,8652,1271,9923,-0.0248803,0.35076,-0.936135,0
7420,0,439,545,4647,54,282,13387,1581,14968,-0.0254243,0.389291,-0.920764,0
4890,0,429,524,4000,86,284,10213,1623,11836,-0.0156442,0.321913,-0.94664,0
3212,0,171,237,1801,26,123,5570,784,6354,-0.0189003,0.315646,-0.948689,0
7460,0,361,457,3668,72,234,12252,1717,13969,-0.00810727,0.265485,-0.964081,0
5016,0,200,254,2059,43,147,7719,1182,8901,-0.0143358,0.273561,-0.961748,0
6939,0,243,314,2407,66,158,10127,1568,11695,-0.0177383,0.252371,-0.967468,0
6889,0,186,241,1923,59,139,9437,1467,10904,-0.043007,0.280753,-0.958817,0
5962,0,168,218,1672,56,125,8201,1477,9678,-0.0376325,0.230266,-0.9724,0
6613,0,156,202,1546,55,115,8687,1392,10079,-0.059592,0.264275,-0.962605,0
5735,0,127,168,1390,60,103,7583,1419,9002,-0.0539587,0.228422,-0.972066,0
5606,0,104,140,1030,49,83,7012,1389,8401,-0.0737924,0.236763,-0.968761,0
6279,0,99,138,938,64,77,7595,1442,9037,-0.0565366,0.194687,-0.979235,0
6126,0,92,128,840,50,73,7309,1444,8753,-0.0955936,0.245533,-0.964664,0
6258,0,110,152,1140,54,100,7814,1391,9205,-0.0590328,0.187282,-0.980531,0
6606,0,157,212,1344,85,109,8513,1431,9944,-0.0759642,0.185297,-0.979742,0
6053,0,165,217,1587,39,123,8184,1486,9670,-0.0614845,0.146188,-0.987344,0
6009,0,197,258,1940,78,148,8630,1397,10027,-0.0736924,0.165186,-0.983506,0
6218,0,241,317,2533,41,178,9528,1570,11098,-0.0592288,0.191503,-0.979703,0
6480,0,316,381,3114,45,235,10571,1730,12301,-0.0647987,0.227829,-0.971543,0
6592,0,346,431,3752,41,252,11414,1582,12996,-0.0456652,0.216384,-0.97524,0
4629,0,273,338,3010,34,196,8480,1066,9546,-0.0359512,0.1937,-0.980402,0
6977,0,449,608,4980,44,321,13379,1482,14861,-0.0644442,0.187797,-0.980092,0
4744,0,309,387,3394,88,222,9144,983,10127,-0.0713298,0.169632,-0.982922,0
6739,0,422,510,4375,104,296,12446,1477,13923,-0.0494653,0.13687,-0.989353,0
6701,0,379,495,3904,74,271,11824,1546,13370,-0.0753187,0.166504,-0.98316,0
4500,0,228,283,2361,50,164,7586,1144,8730,-0.0552603,0.117523,-0.991532,0
6745,0,263,334,2697,72,191,10302,1599,11901,-0.0692092,0.140245,-0.987695,0
6216,0,218,281,2175,59,159,9108,1570,10678,-0.0648221,0.142553,-0.987662,0
6347,0,191,251,1873,73,140,8875,1416,10291,-0.0648328,0.132572,-0.989051,0
6747,0,175,229,1721,59,129,9060,1400,10460,-0.0789411,0.114292,-0.990306,0
6060,0,176,224,1799,79,129,8467,1409,9876,-0.112396,0.167164,-0.979501,0
6330,0,192,247,1964,55,140,8928,1414,10342,-0.118552,0.20068,-0.972457,0
6310,0,316,367,2335,48,157,9533,1411,10944,-0.119032,0.19716,-0.973118,0
5579,0,185,234,1895,45,155,8093,1305,9398,-0.128863,0.21638,-0.967768,0
6277,0,182,246,1875,41,137,8758,1380,10138,-0.138543,0.252447,-0.957641,0
6169,0,210,268,2116,54,154,8971,1555,10526,-0.140802,0.23625,-0.961437,0
6487,0,225,290,2326,57,167,9552,1479,11031,-0.161502,0.295457,-0.941606,0
7030,0,248,320,2518,50,182,10348,1457,11805,-0.155553,0.321795,-0.933944,0
4512,0,196,245,2089,34,142,7218,1138,8356,-0.144988,0.318556,-0.93675,0
6715,0,355,419,3616,55,242,11402,1798,13200,-0.143993,0.353367,-0.924337,0
6688,0,390,483,4284,53,301,12199,1658,13857,-0.200917,0.469032,-0.860025,0
3545,0,187,242,2064,21,132,6191,712,6903,-0.166166,0.359065,-0.918402,0
2092,0,136,170,1491,20,96,4005,463,4468,-0.129968,0.281246,-0.950794,0
5022,0,317,392,3391,52,226,9400,1281,10681,-0.125267,0.267933,-0.955259,0
6613,0,360,447,3789,57,256,11522,1507,13029,-0.147438,0.284473,-0.947279,0
6415,0,312,378,3208,63,227,10603,1593,12196,-0.113868,0.220077,-0.968814,0
6243,0,256,323,2674,76,184,9756,1590,11346,-0.122665,0.231589,-0.965049,0
6263,0,239,294,2396,54,168,9414,1485,10899,-0.113717,0.214712,-0.970034,0
6097,0,221,280,2319,44,162,9123,1428,10551,-0.104032,0.205109,-0.973195,0
6285,0,216,282,2234,52,162,9231,1456,10687,-0.0996574,0.180465,-0.97852,0
4323,0,132,170,1339,32,97,6093,1053,7146,-0.123245,0.202158,-0.971567,0
5957,0,164,225,1654,44,142,8186,1381,9567,-0.0953671,0.168021,-0.98116,0
6045,0,141,189,1355,50,106,7886,1430,9316,-0.0906437,0.189468,-0.977694,0
5652,0,122,162,1188,48,96,7268,1438,8706,-0.0647321,0.148552,-0.986784,0
5815,0,137,219,1047,46,95,7359,1448,8807,-0.102062,0.186276,-0.977182,0
5707,0,119,164,1103,54,94,7241,1453,8694,-0.0741719,0.155615,-0.985029,0
5678,0,139,192,1273,53,106,7441,1557,8998,-0.0824149,0.150481,-0.985172,0
6733,0,260,262,1674,90,145,9164,1467,10631,-0.105758,0.16046,-0.98136,0
6753,0,214,276,2184,46,202,9675,2119,11794,-0.10041,0.169437,-0.980413,0
4844,0,189,240,1648,37,121,7079,1159,8238,-0.0688413,0.139446,-0.987834,0
7046,0,252,323,2665,42,191,10519,1695,12214,-0.0755394,0.165737,-0.983273,0
6226,0,286,359,2976,40,209,10096,1575,11671,-0.0748665,0.14767,-0.986199,0
4535,0,217,283,2326,27,157,7545,1171,8716,-0.0766142,0.150151,-0.98569,0
6493,0,338,439,3649,44,259,11222,1678,12900,-0.0539795,0.129036,-0.99017,0
6638,0,409,463,3577,39,186,11312,1114,12426,-0.0736482,0.134055,-0.988233,0
3524,0,223,260,2290,26,151,6474,848,7322,-0.0599703,0.104662,-0.992698,0
7211,0,428,543,4731,66,334,13313,1264,14577,-0.0679017,0.117684,-0.990727,0
4861,0,305,383,3358,47,218,9172,1059,10231,-0.0392532,0.0808495,-0.995953,0
6867,0,424,578,4514,58,306,12747,1788,14535,-0.0814048,0.166804,-0.982624,0
3785,0,206,252,2104,29,120,6496,656,7152,-0.0326825,0.0944318,-0.994995,0
2691,0,148,183,1569,29,109,4729,687,5416,-0.0300648,0.0846166,-0.99596,0
6505,0,319,396,3304,64,233,10821,1652,12473,-0.0502201,0.10243,-0.993472,0
6581,0,267,351,3017,74,220,10510,1788,12298,-0.141585,0.193602,-0.97081,0
3884,0,126,158,1252,25,92,5537,868,6405,-0.0795544,0.117371,-0.989897,0
2672,0,95,123,965,24,70,3949,692,4641,-0.0372601,0.0558098,-0.997746,0
6228,0,217,278,2194,48,163,9128,1443,10571,-0.142432,0.159335,-0.976896,0
4499,0,151,192,1201,27,89,6159,727,6886,-0.0774189,0.0804308,-0.993749,0
6183,0,225,284,2527,77,211,9507,1402,10909,-0.0914049,0.0932114,-0.991442,0
4379,0,162,208,1704,41,128,6622,1011,7633,-0.083563,0.0693471,-0.994087,0
6446,0,250,310,2521,69,184,9780,1376,11156,-0.0923661,0.0953637,-0.991148,0
6580,0,240,308,2405,43,206,9782,1384,11166,-0.0984125,0.111976,-0.988826,0
6316,0,236,299,2302,47,172,9372,1424,10796,-0.110728,0.154393,-0.981785,0
4575,0,159,208,1654,36,118,6750,1022,7772,-0.10282,0.172323,-0.97966,0
6284,0,250,293,2256,54,167,9304,1700,11004,-0.0957466,0.165343,-0.981578,0
6367,0,243,306,2458,71,179,9624,1746,11370,-0.116867,0.213717,-0.96988,0
6359,0,257,322,2814,57,191,10000,1743,11743,-0.125115,0.211097,-0.969425,0
5844,0,249,316,2617,35,184,9245,1587,10832,-0.157374,0.240435,-0.957823,0
6461,0,310,387,3245,53,226,10682,1767,12449,-0.139344,0.216095,-0.966378,0
6644,0,387,459,3864,41,259,11654,1836,13490,-0.213454,0.297314,-0.930614,0
6730,0,409,508,4515,41,204,12407,1281,13688,-0.187058,0.262588,-0.946603,0
6213,0,422,529,4632,59,340,12195,1398,13593,-0.223499,0.298774,-0.927783,0
4421,0,303,380,3792,45,219,9160,1089,10249,-0.172026,0.233312,-0.957065,0
6872,0,436,552,4575,35,215,12685,1118,13803,-0.199589,0.287451,-0.936769,0
5157,0,295,374,3169,44,214,9253,1157,10410,-0.158191,0.237368,-0.958453,0
6854,0,387,480,4077,66,280,12144,1657,13801,-0.160572,0.267628,-0.950048,0
6549,0,369,426,3644,75,251,11314,1744,13058,-0.132073,0.215375,-0.967559,0
6467,0,311,420,3234,65,226,10723,1653,12376,-0.207632,0.359722,-0.909664,0
4983,0,193,244,1849,28,107,7404,832,8236,-0.164452,0.308414,-0.936929,0
2741,0,104,134,1060,28,76,4143,544,4687,-0.103399,0.206485,-0.972971,0
4173,0,141,178,1407,37,102,6038,970,7008,-0.123095,0.219353,-0.967849,0
6093,0,166,242,1627,49,124,8301,1397,9698,-0.162718,0.252762,-0.953747,0
6150,0,144,188,1345,53,106,7986,1427,9413,-0.129834,0.221172,-0.966554,0
5682,0,132,175,1199,50,99,7337,1499,8836,-0.132648,0.239609,-0.961765,0
5679,0,143,188,1394,38,112,7554,1539,9093,-0.0980116,0.187439,-0.977374,0
6123,0,175,224,1643,43,127,8335,1503,9838,-0.120563,0.206636,-0.970961,0
6083,0,210,298,2144,44,160,8939,1644,10583,-0.0860134,0.167658,-0.982086,0
6300,0,254,325,2695,50,188,9812,1674,11486,-0.103244,0.179895,-0.978253,0
6383,0,399,548,3677,42,240,11289,1087,12376,-0.0706429,0.135472,-0.988259,0
4569,0,225,284,2477,36,165,7756,1096,8852,-0.074011,0.154905,-0.985153,0
7303,0,372,445,3946,47,260,12373,1457,13830,-0.0866759,0.172509,-0.981187,0
4794,0,260,324,2875,48,210,8511,1066,9577,-0.0921731,0.189253,-0.977593,0
6905,0,404,515,4718,54,295,12891,1489,14380,-0.0896457,0.183509,-0.978922,0
7345,0,698,649,4386,54,215,13347,963,14310,-0.105621,0.17716,-0.978498,0
3643,0,245,298,2481,29,160,6856,774,7630,-0.0999932,0.147808,-0.983948,0
7772,0,409,508,4426,97,318,13530,1371,14901,-0.105743,0.137412,-0.984853,0
4705,0,299,405,2835,41,195,8480,980,9460,-0.0943327,0.102883,-0.990211,0
6826,0,365,444,3778,58,280,11751,1613,13364,-0.0842762,0.0933072,-0.992064,0
6515,0,329,412,3568,46,168,11038,1128,12166,-0.0585722,0.0634776,-0.996263,0
4566,0,199,253,2064,41,146,7269,1155,8424,-0.042409,0.0664271,-0.99689,0
4367,0,199,222,1745,33,127,6693,1419,8112,-0.0407746,0.0490658,-0.997963,0
6243,0,230,291,2218,51,166,9199,1488,10687,-0.055891,0.046586,-0.99735,0
6116,0,209,264,2046,83,153,8871,1506,10377,-0.0547269,0.0654021,-0.996357,0
6288,0,205,261,2001,60,149,8964,1376,10340,-0.0606591,0.0926228,-0.993852,0
5521,0,183,232,1772,49,135,7892,1237,9129,-0.0562247,0.0722038,-0.995804,0
6478,0,207,266,2086,52,156,9245,1388,10633,-0.0900203,0.117235,-0.989016,0
6317,0,214,272,2143,62,156,9164,1167,10331,-0.088234,0.120498,-0.988785,0
6386,0,210,266,2146,57,176,9241,1414,10655,-0.129601,0.175536,-0.975905,0
6186,0,209,268,2265,76,232,9236,1464,10700,-0.119895,0.159461,-0.979897,0
6338,0,215,282,2064,55,181,9135,1095,10230,-0.14045,0.230889,-0.96279,0
5641,0,206,277,2094,44,150,8412,1308,9720,-0.119394,0.201182,-0.972251,0
6520,0,244,310,2552,54,180,9860,1723,11583,-0.131789,0.238977,-0.96204,0
6409,0,267,338,2852,40,197,10103,1856,11959,-0.11613,0.195928,-0.973718,0
6509,0,295,370,3285,53,217,10729,1808,12537,-0.139836,0.233948,-0.96214,0
6500,0,316,394,3360,44,264,10878,1859,12737,-0.125224,0.204536,-0.970816,0
4537,0,233,300,2593,32,179,7874,1248,9122,-0.106367,0.202796,-0.973427,0
6508,0,401,439,3827,49,255,11479,1804,13283,-0.0932658,0.182713,-0.978733,0
6493,0,366,440,3796,50,255,11400,1756,13156,-0.0848848,0.189089,-0.978284,0
6742,0,357,448,4200,52,290,12089,1689,13778,-0.0763188,0.16567,-0.983224,0
6771,0,372,421,3050,40,189,10843,1275,12118,-0.0870327,0.169903,-0.98161,0
3461,0,203,252,2316,40,151,6423,975,7398,-0.0799672,0.147481,-0.985827,0
5573,0,382,464,3642,41,233,10335,1381,11716,-0.0794161,0.155923,-0.984571,0
7132,0,465,553,4566,51,293,13060,1817,14877,-0.0773538,0.211856,-0.974235,0
3496,0,221,261,1939,23,127,6067,707,6774,-0.0656225,0.138109,-0.98824,0
6579,0,441,562,4591,82,327,12582,1941,14523,-0.0676095,0.107641,-0.991888,0
7357,0,423,536,3714,35,216,12281,1169,13450,-0.0633875,0.113072,-0.991563,0
3515,0,219,278,2374,25,155,6566,932,7498,-0.0608044,0.101246,-0.993001,0
7075,0,403,500,4451,63,290,12782,1628,14410,-0.0519989,0.0996018,-0.993668,0
6590,0,440,501,4016,48,200,11795,1202,12997,-0.0551497,0.0826432,-0.995052,0
4700,0,304,350,3064,50,209,8677,1095,9772,-0.0481183,0.0713178,-0.996293,0
6113,0,409,457,3907,60,260,11206,1450,12656,-0.0325211,0.0607374,-0.997624,0
6119,0,406,488,3553,43,188,10797,1092,11889,-0.0293318,0.0571259,-0.997936,0
4481,0,264,374,2874,45,188,8226,1089,9315,-0.026138,0.0517068,-0.99832,0
7385,0,423,527,4564,84,321,13304,1529,14833,-0.0199668,0.0426455,-0.998891,0
6507,0,414,528,4446,80,293,12268,1774,14042,-0.0149474,0.0455966,-0.998848,0
6358,0,376,474,4118,75,269,11670,1451,13121,-0.011424,0.0532315,-0.998517,0
5945,0,421,476,4025,66,269,11202,1529,12731,-0.0134305,0.0558807,-0.998347,0
4734,0,271,338,2841,44,190,8418,1037,9455,-0.0190003,0.0627946,-0.997846,0
7205,0,417,522,4526,69,301,13040,1592,14632,-0.0184417,0.0671938,-0.997569,0
6493,0,439,526,4424,83,294,12259,1199,13458,-0.0204949,0.0675067,-0.997508,0
4736,0,264,337,2804,49,187,8377,976,9353,-0.0175942,0.069616,-0.997419,0
6530,0,415,638,4410,71,319,12383,1365,13748,-0.0160684,0.0732671,-0.997183,0
4556,0,288,363,3106,50,205,8568,1160,9728,-0.0180546,0.0668328,-0.997601,0
5165,0,333,375,3226,49,211,9359,1108,10467,-0.01092,0.0708799,-0.997425,0
6627,0,416,527,4918,72,302,12862,1707,14569,-0.0135766,0.0667951,-0.997674,0
7458,0,405,369,3088,45,208,11573,1026,12599,-0.0113091,0.0676755,-0.997643,0
3466,0,221,278,2398,37,159,6559,848,7407,-0.0142327,0.0612329,-0.998022,0
6585,0,420,529,4646,73,304,12557,1658,14215,-0.00928684,0.0637958,-0.99792,0
6809,0,421,529,4601,74,324,12758,1619,14377,-0.00795898,0.06107,-0.998102,0
4576,0,254,282,2375,42,158,7687,855,8542,-0.00507446,0.0534536,-0.998557,0
2803,0,180,225,1937,35,128,5308,692,6000,-0.0100153,0.0479743,-0.998798,0
6615,0,424,536,4498,82,300,12455,1549,14004,-0.00700101,0.0469118,-0.998874,0
6553,0,423,552,3942,61,209,11740,1162,12902,-0.0120804,0.0448442,-0.998921,0
4274,0,320,356,2924,48,196,8118,1080,9198,-0.00826817,0.048134,-0.998807,0
6575,0,425,539,4590,72,307,12508,1669,14177,-0.0108355,0.0477979,-0.998798,0
