Downsample[ns],BuildFilTree[ns],SearchFil[ns],DeleteFil[ns],BuildTreeSub[ns],SearchSub[ns],DeleteSub[ns],PreProcTotal[ns],Plane[ns],Total[ns],nx,ny,nz,planeCount
6031,0,213,289,2154,74,153,8914,7267,16181,-0.0296609,0.0880457,-0.995675,0
5996,0,223,279,2028,53,152,8731,5875,14606,-0.0114202,0.0127984,-0.999853,0
3094,0,112,136,1088,27,80,4537,3679,8216,-0.108715,0.0210926,-0.993849,0
5905,0,211,257,2017,55,150,8595,5858,14453,-0.0103252,0.0107871,-0.999889,0
5845,0,211,258,1971,55,147,8487,4710,13197,-0.0107994,0.0116723,-0.999873,0
4853,0,172,210,1693,40,123,7091,6212,13303,-0.00840696,0.0104149,-0.99991,0
4777,0,173,220,1644,38,122,6974,6374,13348,-0.0117041,0.0116654,-0.999863,0
5989,0,224,285,2029,54,151,8732,6398,15130,-0.116144,0.0278313,-0.992842,0
4040,0,147,188,1408,37,102,5922,2487,8409,0.696315,0.0657792,-0.714716,0
6010,0,211,278,2037,49,150,8735,4479,13214,0.690685,0.0817067,-0.718525,0
5898,0,211,257,1999,45,148,8558,6003,14561,-0.00607939,0.0113953,-0.999917,0
5956,0,214,260,2033,53,148,8664,4479,13143,-0.00938437,0.0135108,-0.999865,0
5735,0,147,179,1418,34,103,7616,3520,11136,-0.105146,0.0239274,-0.994169,0
2495,0,90,109,883,21,64,3662,2480,6142,-0.0134214,0.0121439,-0.999836,0
2010,0,74,89,695,17,50,2935,1337,4272,0.692358,0.0738114,-0.717769,0
5874,0,226,262,2000,49,158,8569,3858,12427,0.685866,0.0714968,-0.724206,0
5956,0,227,259,2018,48,157,8665,7189,15854,-0.122209,0.0343022,-0.991912,0
4077,0,148,178,1446,36,102,5987,2880,8867,0.700765,0.0594664,-0.710909,0
6072,0,223,258,2012,48,171,8784,5231,14015,0.678758,0.0770364,-0.730311,0
5990,0,212,275,2039,50,151,8717,6360,15077,-0.0240658,0.0868095,-0.995934,0
4069,0,161,177,1419,33,101,5960,6955,12915,-0.0108685,0.0120016,-0.999869,0
6009,0,212,258,2016,49,150,8694,5905,14599,-0.0100787,0.0129928,-0.999865,0
4065,0,146,176,1423,34,101,5945,4835,10780,-0.00916883,0.0126376,-0.999878,0
6016,0,211,262,2006,48,151,8694,4158,12852,0.699982,0.0732447,-0.710395,0
5883,0,235,261,1940,60,102,8481,5331,13812,-0.00984353,0.0957321,-0.995358,0
3808,0,137,167,1290,39,98,5539,4552,10091,-0.0917198,0.0309674,-0.995303,0
5838,0,211,255,2040,52,150,8546,7118,15664,-0.119519,0.0370628,-0.99214,0
5333,0,190,249,1813,47,134,7766,3264,11030,0.698721,0.0621467,-0.71269,0
6639,0,211,271,2052,47,152,9372,7911,17283,-0.00669367,0.0119579,-0.999906,0
5996,0,212,260,2097,51,151,8767,3783,12550,0.703121,0.0593278,-0.708591,0
4139,0,147,177,1375,34,102,5974,2094,8068,0.689175,0.0596028,-0.72214,0
5922,0,214,260,2042,53,152,8643,6813,15456,-0.0132937,0.0150549,-0.999798,0
5962,0,212,259,2015,47,149,8644,5072,13716,0.695514,0.0687989,-0.715212,0
4107,0,204,279,1707,32,116,6445,5563,12008,-0.109209,0.0280132,-0.993624,0
5450,0,189,234,1848,66,135,7922,5376,13298,-0.0109519,0.0124044,-0.999863,0
6092,0,215,275,2027,49,149,8807,6449,15256,-0.105311,0.0238937,-0.994152,0
3126,0,116,137,1063,29,78,4549,2782,7331,0.688524,0.0544443,-0.723167,0
5829,0,212,257,1981,46,147,8472,3569,12041,0.696109,0.0617946,-0.715271,0
5919,0,213,260,2072,47,150,8661,6318,14979,-0.0091421,0.0951438,-0.995422,0
4070,0,146,176,1390,35,102,5919,5959,11878,-0.00900394,0.0956319,-0.995376,0
5964,0,231,272,2181,52,172,8872,6434,15306,-0.0142774,0.0146935,-0.99979,0
5986,0,213,264,2038,58,154,8713,3837,12550,0.688256,0.069902,-0.722092,0
4118,0,210,196,1387,37,102,6050,4559,10609,-0.0181704,0.0472454,-0.998718,0
6010,0,212,267,2017,52,159,8717,7330,16047,-0.122177,0.0262558,-0.992161,0
4094,0,147,179,1408,34,101,5963,5568,11531,-0.120344,0.0286654,-0.992319,0
3818,0,135,164,1294,32,96,5539,4123,9662,-0.0347777,0.0884828,-0.99547,0
5880,0,211,348,2617,52,155,9263,7407,16670,-0.0130034,0.0126483,-0.999835,0
4142,0,147,179,1441,38,103,6050,2662,8712,0.693578,0.0672427,-0.717237,0
6639,0,210,258,1978,50,148,9283,8734,18017,-0.00576621,0.0100573,-0.999932,0
4217,0,146,178,1368,34,102,6045,2656,8701,0.696838,0.0537399,-0.715213,0
6506,0,210,312,1994,46,151,9219,2961,12180,0.702016,0.0549119,-0.710041,0
6654,0,213,284,2078,47,152,9428,3898,13326,0.694835,0.0544658,-0.717104,0
4073,0,151,176,1441,31,105,5977,5498,11475,-0.0153882,0.0951784,-0.995341,0
6614,0,210,264,1977,47,145,9257,9326,18583,-0.110219,0.0277153,-0.993521,0
4131,0,151,190,1432,34,102,6040,4587,10627,-0.104069,0.0186963,-0.994394,0
5924,0,212,259,1994,49,147,8585,6582,15167,-0.0106602,0.0139652,-0.999846,0
4103,0,148,181,1399,36,102,5969,4104,10073,-0.108703,0.0210053,-0.993852,0
5976,0,212,258,2023,55,151,8675,5629,14304,-0.0133865,0.0408973,-0.999074,0
4089,0,146,177,1378,33,100,5923,5878,11801,-0.00938726,0.0482042,-0.998794,0
5441,0,191,233,1827,47,135,7874,7679,15553,-0.013316,0.0120535,-0.999839,0
3823,0,136,164,1267,31,93,5514,4187,9701,-0.00980383,0.0123751,-0.999875,0
6054,0,258,272,2074,55,152,8865,6566,15431,-0.0884768,0.0275374,-0.995698,0
5942,0,211,255,1967,49,144,8568,3860,12428,-0.117255,0.0280791,-0.992705,0
5394,0,190,253,1920,43,137,7937,5893,13830,-0.107913,0.0210679,-0.993937,0
5366,0,207,235,1831,46,133,7818,3137,10955,-0.00843155,0.0121633,-0.999891,0
4879,0,241,216,1747,41,124,7248,6944,14192,-0.118936,0.0333273,-0.992343,0
3609,0,130,155,1190,32,88,5204,3855,9059,-0.106841,0.0231812,-0.994006,0
6060,0,211,305,2034,52,150,8812,6650,15462,-0.0152419,-0.0163873,-0.999749,0
4074,0,205,224,1403,35,106,6047,2858,8905,0.699489,0.0650818,-0.711674,0
6028,0,212,286,1985,45,149,8705,3592,12297,0.697809,0.0578008,-0.713948,0
5894,0,211,255,1993,50,146,8549,7031,15580,-0.112967,0.0285781,-0.993187,0
3136,0,113,137,1080,28,78,4572,4329,8901,-0.0135038,0.0481993,-0.998746,0
6125,0,214,260,2086,71,211,8967,8013,16980,-0.120074,0.0257961,-0.99243,0
4163,0,148,201,1386,44,104,6046,5044,11090,-0.120632,0.0313561,-0.992202,0
5961,0,261,283,1873,45,136,8559,3727,12286,0.700381,0.0585439,-0.711364,0
5316,0,191,233,1812,44,132,7728,6922,14650,-0.10737,0.0288342,-0.993801,0
2931,0,105,127,976,24,72,4235,4246,8481,-0.0117092,0.0122719,-0.999856,0
6538,0,281,289,2036,49,152,9345,8500,17845,-0.101596,0.02245,-0.994572,0
5820,0,211,254,1982,49,145,8461,3219,11680,0.69346,0.0547742,-0.71841,0
4210,0,146,179,1496,45,156,6232,2584,8816,0.703127,0.0640351,-0.708175,0
6028,0,211,259,1947,40,131,8616,8382,16998,-0.126021,0.0202153,-0.991821,0
3929,0,136,175,1324,33,97,5694,3180,8874,0.700289,0.0726436,-0.710154,0
6265,0,222,283,2211,52,154,9187,8398,17585,-0.012643,-0.0171391,-0.999773,0
1564,0,56,68,538,14,38,2278,1754,4032,-0.0115151,0.0126802,-0.999853,0
2387,0,86,104,806,20,59,3462,2519,5981,-0.102638,0.024271,-0.994423,0
5919,0,212,258,2363,51,152,8955,6310,15265,-0.122037,0.0211593,-0.9923,0
5955,0,214,259,2005,52,147,8632,6449,15081,-0.123003,0.0242313,-0.992111,0
3061,0,112,135,1073,33,97,4511,1966,6477,0.699975,0.0598166,-0.711659,0
5989,0,212,257,1980,45,146,8629,6943,15572,-0.0102665,0.0122001,-0.999873,0
4065,0,147,179,1501,35,106,6033,2721,8754,0.699527,0.0626252,-0.711857,0
6120,0,317,329,2216,53,153,9188,7332,16520,-0.104926,0.0292157,-0.994051,0
4135,0,147,190,1397,35,101,6005,5213,11218,-0.0821081,0.0594337,-0.99485,0
6737,0,212,294,2035,50,157,9485,6694,16179,-0.102372,0.0275579,-0.994364,0
3900,0,136,167,1271,32,94,5600,2858,8458,-0.0119173,0.0130147,-0.999844,0
6577,0,210,259,1952,71,148,9217,6787,16004,-0.00863403,0.01172,-0.999894,0
3795,0,162,168,1343,43,123,5634,2767,8401,0.700609,0.0582945,-0.71116,0
6012,0,214,261,1997,47,148,8679,3869,12548,0.703712,0.0613815,-0.707828,0
6113,0,190,250,1796,46,136,8531,3461,11992,0.703316,0.0651189,-0.707889,0
5483,0,201,233,1769,42,131,7859,3201,11060,0.704016,0.0622344,-0.707452,0
5253,0,191,232,1806,45,131,7658,6261,13919,-0.112595,0.0254698,-0.993315,0
3788,0,138,165,1364,50,133,5638,2298,7936,0.703823,0.0630586,-0.707571,0
5942,0,211,256,1987,46,148,8590,8978,17568,-0.115391,0.0348255,-0.99271,0
4065,0,160,178,1371,35,100,5909,2987,8896,0.685578,0.0497424,-0.726298,0
6620,0,211,308,2023,45,151,9358,3141,12499,0.698891,0.0541256,-0.713177,0
5930,0,210,257,1967,49,158,8571,7136,15707,-0.00941589,0.0942571,-0.995504,0
3885,0,137,166,1386,48,143,5765,3173,8938,0.681948,0.0670334,-0.728323,0
5622,0,192,254,1817,41,133,8059,7743,15802,-0.119837,0.0335271,-0.992227,0
3820,0,137,169,1305,35,96,5562,2333,7895,0.698699,0.0620677,-0.712718,0
6913,0,212,258,2048,47,148,9626,4119,13745,0.699128,0.0744406,-0.711111,0
5898,0,211,259,1981,46,146,8541,3861,12402,0.702204,0.0612084,-0.709341,0
5928,0,213,257,2014,49,147,8608,3590,12198,0.696377,0.0677264,-0.714473,0
6022,0,210,257,1995,48,150,8682,8652,17334,-0.105744,0.0306075,-0.993922,0
3776,0,135,164,1269,31,94,5469,2657,8126,-0.107105,0.0241181,-0.993955,0
6740,0,252,263,1947,50,146,9398,7713,17111,-0.00955768,0.0102484,-0.999902,0
3868,0,136,167,1275,30,94,5570,2220,7790,0.704146,0.0576708,-0.70771,0
6326,0,211,267,2026,70,152,9052,3147,12199,0.694463,0.0589418,-0.71711,0
5864,0,210,254,2231,64,206,8829,4167,12996,0.694267,0.0767661,-0.715612,0
5324,0,190,233,1786,40,134,7707,6801,14508,-0.0134341,0.0462036,-0.998842,0
3810,0,136,163,1304,31,97,5541,4164,9705,-0.120055,0.0254247,-0.992442,0
6094,0,211,256,1974,45,132,8712,6679,15391,-0.106595,0.0209957,-0.994081,0
5372,0,190,249,1762,44,133,7750,6103,13853,-0.106987,0.0242267,-0.993966,0
3889,0,135,163,1334,32,114,5667,3356,9023,0.682246,0.0808975,-0.726634,0
5961,0,213,260,2011,47,148,8640,8081,16721,-0.0129646,0.0962004,-0.995278,0
3810,0,135,165,1290,31,107,5538,5338,10876,-0.0109502,-0.0169186,-0.999797,0
5873,0,211,253,2013,42,133,8525,7102,15627,-0.120318,0.0202171,-0.992529,0
4911,0,177,229,1631,45,118,7111,7575,14686,-0.00805956,0.0123603,-0.999891,0
4896,0,174,211,1641,44,137,7103,6181,13284,-0.030403,0.0856903,-0.995858,0
6018,0,210,257,2019,69,132,8705,9290,17995,-0.0963551,0.0267319,-0.994988,0
3786,0,135,166,1251,31,92,5461,2527,7988,0.697704,0.060602,-0.713818,0
6033,0,257,266,2006,49,148,8759,3614,12373,0.704245,0.0522311,-0.708034,0
6102,0,210,260,2006,47,151,8776,4772,13548,0.704099,0.0650277,-0.707119,0
5272,0,136,168,1347,31,97,7051,2155,9206,0.690898,0.0675961,-0.719785,0
2456,0,85,112,800,18,59,3530,2602,6132,-0.119025,0.032818,-0.992349,0
1949,0,70,88,673,18,48,2846,2209,5055,-0.119583,0.0296564,-0.992381,0
5571,0,191,231,1744,45,151,7933,6173,14106,-0.00895588,0.0111097,-0.999898,0
6104,0,238,262,2052,49,153,8858,6073,14931,-0.105057,0.0286188,-0.994055,0
4082,0,146,178,1390,35,101,5932,4822,10754,-0.11255,0.0191738,-0.993461,0
6029,0,214,262,2024,47,141,8717,6243,14960,-0.0109041,0.0139704,-0.999843,0
3907,0,138,167,1318,34,98,5662,4872,10534,-0.0078842,0.010261,-0.999916,0
6162,0,210,263,2008,52,151,8846,6086,14932,-0.0109782,0.0130864,-0.999854,0
3934,0,135,165,1252,31,92,5609,3050,8659,0.688561,0.037356,-0.724215,0
6335,0,211,268,1970,41,132,8957,7603,16560,-0.00630975,0.0100674,-0.999929,0
3838,0,136,168,1283,32,94,5551,2355,7906,0.697455,0.0561369,-0.714426,0
6040,0,213,260,2015,52,147,8727,8470,17197,-0.110865,0.0296929,-0.993392,0
3186,0,112,135,991,21,64,4509,2611,7120,-0.00622714,0.00952875,-0.999935,0
2112,0,76,92,722,19,52,3073,2580,5653,-0.00948784,0.0114568,-0.999889,0
2620,0,104,115,887,26,64,3816,2168,5984,0.687362,0.0630806,-0.723571,0
6070,0,211,268,2097,48,153,8847,3404,12251,0.701141,0.0709136,-0.709487,0
6769,0,214,263,2056,76,151,9529,4395,13924,0.703748,0.0673488,-0.707251,0
4511,0,183,246,1462,33,106,6541,2994,9535,0.690803,0.0579023,-0.720722,0
5421,0,190,240,1765,41,132,7789,7055,14844,-0.113519,0.0323495,-0.993009,0
5529,0,175,217,1641,40,123,7725,8687,16412,-0.010762,-0.0176377,-0.999787,0
3533,0,173,181,1207,29,88,5211,2023,7234,0.703877,0.0606899,-0.707725,0
5983,0,210,288,1980,46,150,8657,2825,11482,0.698104,0.0622076,-0.713289,0
6837,0,212,261,1979,44,149,9482,5947,15429,-0.0499572,0.0391299,-0.997985,0
3337,0,113,139,1208,28,80,4905,1938,6843,0.702999,0.0622341,-0.708463,0
5990,0,210,260,1978,47,153,8638,6713,15351,-0.00990414,0.0104888,-0.999896,0
5894,0,210,256,2010,54,151,8575,8651,17226,-0.101161,0.0307771,-0.994394,0
3175,0,112,149,971,21,63,4491,2578,7069,-0.120203,0.0193309,-0.992561,0
2167,0,76,93,746,19,54,3155,1319,4474,0.697657,0.0518666,-0.714552,0
2316,0,83,101,810,22,69,3401,3151,6552,-0.119271,0.0386755,-0.992108,0
7039,0,219,265,2032,49,149,9753,3599,13352,0.703708,0.056728,-0.708221,0
5923,0,209,258,1960,46,147,8543,6047,14590,-0.117163,0.032066,-0.992595,0
6047,0,209,258,1981,48,148,8691,3221,11912,0.703497,0.0648195,-0.707736,0
4029,0,146,177,1534,46,153,6085,6417,12502,-0.0127202,0.096891,-0.995214,0
5246,0,188,229,1767,43,130,7603,3461,11064,0.701028,0.0633524,-0.710314,0
6751,0,211,258,1977,46,148,9391,2859,12250,0.68619,0.0734688,-0.723702,0
4112,0,151,194,1810,36,116,6419,2537,8956,0.697839,0.0750117,-0.712316,0
5821,0,209,254,1947,49,144,8424,9508,17932,-0.0350042,0.0901635,-0.995312,0
3065,0,119,143,1030,26,76,4459,2203,6662,0.680312,0.0827726,-0.728233,0
5815,0,209,253,1992,63,169,8501,3597,12098,0.703657,0.0601686,-0.707988,0
5859,0,229,255,1973,49,145,8510,3401,11911,0.696064,0.0708328,-0.714478,0
5915,0,209,257,1956,46,143,8526,6917,15443,-0.0910503,0.0576834,-0.994174,0
4062,0,142,173,1404,33,102,5916,2483,8399,0.684374,0.0587593,-0.72676,0
6052,0,207,267,1979,56,170,8731,4044,12775,0.681148,0.0858982,-0.72709,0
5925,0,204,319,2106,48,156,8758,3042,11800,0.685919,0.0567968,-0.725458,0
4116,0,155,181,1327,34,97,5910,2589,8499,0.690942,0.0452881,-0.72149,0
6243,0,206,255,1982,44,147,8877,3194,12071,0.70266,0.0670981,-0.708356,0
5937,0,205,251,1929,52,143,8517,7539,16056,-0.0071024,-0.0225136,-0.999722,0
3051,0,115,134,1057,32,110,4499,1820,6319,0.697552,0.0699437,-0.713112,0
5743,0,204,272,1926,47,142,8334,7112,15446,-0.0127389,-0.0170341,-0.999774,0
5949,0,205,250,1945,49,145,8543,2695,11238,0.700951,0.0689431,-0.70987,0
5823,0,205,252,2039,49,149,8517,3655,12172,0.68482,0.0810497,-0.724191,0
4225,0,143,176,1211,25,76,5856,4099,9955,-0.0098977,0.0188354,-0.999774,0
2075,0,73,90,685,18,50,2991,1085,4076,0.687603,0.0767086,-0.722023,0
5317,0,183,228,1743,39,130,7640,6440,14080,-0.0142402,-0.0181765,-0.999733,0
5823,0,206,252,1942,52,142,8417,4480,12897,0.687282,0.0702454,-0.722986,0
5963,0,203,250,1924,44,142,8526,7026,15552,-0.0162071,0.0486108,-0.998686,0
6545,0,205,297,2011,47,148,9253,3228,12481,0.699163,0.0749303,-0.711025,0
4258,0,142,174,1329,31,98,6032,2371,8403,0.702995,0.0660306,-0.708124,0
6093,0,207,252,1999,46,148,8745,6958,15703,-0.0172428,-0.0120542,-0.999779,0
5868,0,204,252,2025,50,146,8545,2719,11264,0.699689,0.0655474,-0.711435,0
4690,0,143,173,1392,32,102,6532,1758,8290,0.695742,0.0738235,-0.714488,0
2100,0,74,91,771,17,53,3106,3031,6137,-0.0125421,-0.0189696,-0.999741,0
1596,0,55,68,521,14,38,2292,921,3213,0.673523,0.0649562,-0.736307,0
5996,0,241,289,1931,53,144,8654,6603,15257,-0.00877625,-0.0223431,-0.999712,0
5776,0,203,248,1940,52,144,8363,3380,11743,0.68843,0.0765611,-0.721251,0
6074,0,207,258,1982,51,146,8718,6220,14938,-0.0132498,0.072849,-0.997255,0
3111,0,108,138,1013,26,74,4470,3486,7956,-0.0229395,0.0840674,-0.996196,0
5878,0,207,306,1953,51,147,8542,7767,16309,-0.0129029,0.0456251,-0.998876,0
3094,0,131,137,1058,25,78,4523,2439,6962,0.701362,0.0466673,-0.711276,0
4891,0,192,216,1568,39,117,7023,3391,10414,0.680876,0.0838693,-0.727581,0
6242,0,204,254,1936,45,142,8823,3353,12176,0.700305,0.0712427,-0.710281,0
9190,0,296,280,1997,46,144,11953,2860,14813,0.700246,0.0678828,-0.710667,0
3058,0,109,132,1028,24,75,4426,1788,6214,0.701727,0.0677433,-0.709219,0
5859,0,206,275,1965,69,144,8518,3376,11894,0.699692,0.0681134,-0.71119,0
6482,0,208,265,1966,47,146,9114,6730,15844,-0.0141057,0.0436978,-0.998945,0
3097,0,109,134,1065,28,80,4513,1475,5988,0.692223,0.0678753,-0.718485,0
5950,0,205,254,1932,46,143,8530,4173,12703,0.700425,0.0659233,-0.710675,0
5855,0,206,252,1926,45,145,8429,3905,12334,0.678091,0.0816741,-0.730427,0
5927,0,203,255,1901,44,141,8471,3396,11867,0.698949,0.071426,-0.711596,0
5356,0,187,233,1759,42,129,7706,3246,10952,0.697831,0.0753201,-0.712291,0
6005,0,205,252,1921,45,141,8569,3414,11983,0.68849,0.0822209,-0.720571,0
5932,0,244,314,2076,45,149,8760,8494,17254,-0.00845814,0.00693546,-0.99994,0
3085,0,110,134,1023,30,76,4458,1512,5970,0.692362,0.070042,-0.718143,0
5884,0,207,254,1971,44,145,8505,8326,16831,-0.00809179,-0.0212552,-0.999741,0
4071,0,145,174,1330,33,98,5851,4822,10673,-0.0101882,0.0411239,-0.999102,0
5788,0,205,252,1922,51,144,8362,3016,11378,0.698272,0.0476971,-0.714243,0
5880,0,206,252,1928,47,144,8457,7299,15756,-0.0139439,0.0436897,-0.998948,0
3234,0,109,132,1033,25,75,4608,1760,6368,0.670416,0.0443627,-0.740658,0
2081,0,74,90,687,17,51,3000,1088,4088,0.692358,0.0720476,-0.717948,0
5924,0,260,342,1844,48,136,8554,2797,11351,0.701739,0.0679332,-0.709188,0
5857,0,204,250,1927,46,143,8427,3185,11612,0.694472,0.0645059,-0.716623,0
5945,0,208,256,1973,45,146,8573,8192,16765,-0.00750958,-0.018058,-0.999809,0
5473,0,142,173,1371,38,99,7296,4158,11454,-0.0121886,0.0435319,-0.998978,0
2444,0,75,89,687,17,50,3362,1735,5097,-0.0132095,-0.017349,-0.999762,0
1777,0,63,77,597,30,43,2587,1976,4563,-0.00705113,0.0382243,-0.999244,0
5835,0,204,249,1911,43,130,8372,2721,11093,0.688553,0.0787739,-0.720895,0
5224,0,193,225,1702,40,126,7510,3426,10936,0.669563,0.0699626,-0.739453,0
5930,0,206,253,2150,45,151,8735,6907,15642,-0.0141971,0.0392431,-0.999129,0
4184,0,142,174,1397,34,99,6030,2872,8902,0.686632,0.0842814,-0.722103,0
5786,0,206,252,2020,50,146,8460,3181,11641,0.693632,0.069712,-0.716948,0
5756,0,204,251,1925,51,144,8331,7640,15971,-0.0127599,-0.0179612,-0.999757,0
4046,0,142,201,1361,34,101,5885,1949,7834,0.694819,0.059853,-0.716689,0
5896,0,205,252,1921,49,141,8464,4105,12569,0.689976,0.0808301,-0.719306,0
5822,0,204,256,1911,45,142,8380,7086,15466,-0.0152274,0.0486633,-0.998699,0
4022,0,141,172,1364,34,97,5830,2864,8694,0.698723,0.0438828,-0.714045,0
5441,0,184,270,1802,45,139,7881,2562,10443,0.70211,0.0643287,-0.709157,0
6041,0,204,250,1914,49,141,8599,2788,11387,0.701422,0.0630714,-0.70995,0
6125,0,203,254,1423,33,100,8138,5424,13562,-0.0139483,-0.0155811,-0.999781,0
2461,0,87,105,817,22,60,3552,1487,5039,0.702115,0.070769,-0.708539,0
6244,0,201,257,1929,65,147,8843,7303,16146,-0.0116873,0.0398075,-0.999139,0
6599,0,200,259,1729,33,98,8918,5358,14276,-0.0199177,-0.0116074,-0.999734,0
3141,0,105,129,1009,27,73,4484,4334,8818,-0.00942909,0.00872816,-0.999917,0
3147,0,106,131,1195,39,111,4729,2124,6853,0.673696,0.0800061,-0.734665,0
6020,0,196,245,2068,51,178,8758,3190,11948,0.702676,0.0653045,-0.708507,0
5800,0,198,245,1941,46,143,8373,4652,13025,-0.0129907,0.0436658,-0.998961,0
4114,0,138,169,1344,35,99,5899,2489,8388,0.70361,0.0647672,-0.707629,0
5835,0,199,244,1850,44,137,8309,6915,15224,-0.014482,-0.0167594,-0.999755,0
1580,0,55,68,522,14,38,2277,940,3217,0.698291,0.0791256,-0.711427,0
2561,0,91,110,884,20,64,3730,1611,5341,0.680095,0.067142,-0.730043,0
5884,0,203,251,2367,43,147,8895,7403,16298,0.657185,0.0503694,-0.752045,0
6247,0,203,253,1913,44,140,8800,8209,17009,0.673438,0.0553113,-0.737172,0
5881,0,213,259,1953,48,145,8499,6857,15356,0.587227,0.0643495,-0.80686,0
3273,0,107,132,1030,24,76,4642,3688,8330,-0.0141519,0.0696051,-0.997474,0
5821,0,206,252,1936,51,142,8408,7558,15966,0.546817,0.0767952,-0.833723,0
5909,0,205,255,1894,45,141,8449,5266,13715,-0.0113652,0.043817,-0.998975,0
5447,0,191,238,1762,42,130,7810,5617,13427,-0.017993,0.0577314,-0.99817,0
5252,0,184,223,1717,45,148,7569,5094,12663,0.628498,0.0669561,-0.774924,0
5810,0,205,251,1938,46,142,8392,6224,14616,0.651051,0.108524,-0.751236,0
5803,0,205,250,1956,46,145,8405,5067,13472,-0.0132205,0.0482581,-0.998747,0
5533,0,184,244,1755,43,130,7889,7606,15495,0.696331,0.0584578,-0.715337,0
3712,0,132,160,1241,30,130,5405,3992,9397,0.653838,0.0766331,-0.752745,0
5960,0,205,261,1911,45,145,8527,4549,13076,0.648754,0.0779842,-0.756992,0
5289,0,183,228,1717,41,127,7585,-1000,-1000,-1,-1,-1,0
2388,0,84,103,801,22,59,3457,1563,5020,-0.00376089,0.0387173,-0.999243,0
5960,0,207,253,1876,44,146,8486,5715,14201,0.627364,0.0665121,-0.775881,0
6255,0,206,257,1970,64,156,8908,5639,14547,-0.0129819,0.0476376,-0.99878,0
3769,0,133,162,1283,30,95,5472,3327,8799,-0.0123353,0.0448658,-0.998917,0
5798,0,205,250,2003,45,147,8448,5339,13787,0.639052,0.0945,-0.763336,0
4569,0,141,171,1350,30,100,6361,3272,9633,0.645123,0.113735,-0.755566,0
2116,0,73,100,605,28,45,2967,1897,4864,-0.0134845,0.0553287,-0.998377,0
1919,0,68,83,652,17,48,2787,1897,4684,-0.00256894,0.0400581,-0.999194,0
5897,0,185,226,1800,44,131,8283,6196,14479,0.614169,0.0501038,-0.787582,0
5798,0,212,272,1996,55,148,8481,5808,14289,-0.00914798,0.0466269,-0.99887,0
3558,0,107,131,1048,27,80,4951,2825,7776,-0.0127374,0.0442008,-0.998941,0
2080,0,73,89,687,18,50,2997,2489,5486,0.649485,0.0995546,-0.75383,0
5427,0,209,228,1801,55,140,7860,4396,12256,-0.00762775,0.0453996,-0.99894,0
5946,0,204,251,1916,50,146,8513,5576,14089,-0.0109141,0.046383,-0.998864,0
4266,0,141,173,1355,36,99,6070,3941,10011,0.6312,0.0788323,-0.771604,0
6624,0,206,257,1981,49,155,9272,6861,16133,0.672053,0.0933893,-0.734591,0
6025,0,206,259,1998,49,147,8684,7761,16445,0.670731,0.0956721,-0.735504,0
4150,0,141,180,1387,40,97,5995,4296,10291,0.650672,0.112337,-0.751004,0
4078,0,141,171,1339,33,100,5862,3625,9487,-0.00843761,0.0456192,-0.998923,0
2566,0,132,131,811,22,60,3722,2237,5959,-0.0106914,0.0491045,-0.998736,0
5975,0,213,274,1911,46,144,8563,6880,15443,0.660319,0.112289,-0.742543,0
5779,0,205,251,1939,47,143,8364,5070,13434,0.654857,0.0991868,-0.749216,0
3772,0,131,161,1235,68,91,5458,2675,8133,0.661533,0.0850732,-0.745075,0
5772,0,202,245,1919,41,126,8305,5634,13939,0.665516,0.0981932,-0.739897,0
5151,0,183,230,1763,40,137,7504,4750,12254,0.653302,0.0751291,-0.753361,0
4919,0,223,201,1506,36,133,7018,3946,10964,0.648358,0.1054,-0.754005,0
5218,0,179,239,1684,40,127,7487,5623,13110,0.643329,0.096233,-0.759518,0
5154,0,178,265,1652,40,148,7437,7396,14833,0.641288,0.0946901,-0.761435,0
4707,0,174,212,1530,39,122,6784,4733,11517,0.66209,0.0517674,-0.747634,0
5795,0,214,250,1881,46,127,8313,4646,12959,-0.0176852,0.00622309,-0.999824,0
5374,0,190,250,1809,47,142,7812,1899,9711,-0.0216614,0.00121637,-0.999764,0
5808,0,197,236,1875,54,138,8308,1341,9649,-0.0288107,0.0187072,-0.999409,0
6220,0,227,295,2189,57,161,9149,1476,10625,-0.0401332,0.00505605,-0.999182,0
6651,0,233,289,2261,51,162,9647,1396,11043,-0.0266635,-0.0124082,-0.999568,0
5663,0,249,283,2106,47,150,8498,1314,9812,-0.0216948,-0.00142057,-0.999764,0
6430,0,238,294,2344,73,170,9549,1371,10920,-0.0182612,0.0110656,-0.999772,0
6198,0,267,303,2446,58,200,9472,1461,10933,-0.0267644,0.0168459,-0.9995,0
6501,0,245,303,2443,58,175,9725,1369,11094,-0.0146713,0.0192952,-0.999706,0
6439,0,264,333,2468,72,176,9752,1448,11200,-0.013286,0.0138705,-0.999816,0
6242,0,249,299,2399,76,173,9438,1373,10811,-0.00169577,0.00731588,-0.999972,0
6351,0,296,308,2496,65,177,9693,1415,11108,-0.00642274,0.011221,-0.999916,0
6260,0,250,304,2358,57,156,9385,1301,10686,-0.0122484,0.0614239,-0.998037,0
6280,0,246,357,2453,57,157,9550,1355,10905,-0.0149436,0.0682817,-0.997554,0
5691,0,216,266,2086,50,151,8460,1235,9695,-0.00915538,0.0389847,-0.999198,0
6246,0,245,296,2359,63,155,9364,1397,10761,0.00329574,0.0140082,-0.999896,0
6325,0,245,299,2320,56,168,9413,1414,10827,0.00114465,-0.0113619,-0.999935,0
6851,0,248,375,2407,70,175,10126,1427,11553,-0.0010308,-0.0450587,-0.998984,0
6316,0,252,306,2406,64,173,9517,1305,10822,0.000142002,-0.0242415,-0.999706,0
5755,0,229,279,2341,53,163,8820,1306,10126,-0.00637169,-0.0161356,-0.99985,0
6316,0,258,312,2576,56,179,9697,1426,11123,-0.00550925,0.00603996,-0.999967,0
6346,0,259,315,2669,56,182,9827,1389,11216,-0.00642421,0.0213964,-0.999751,0
6229,0,262,320,2551,54,196,9612,1366,10978,-0.0161385,0.0250135,-0.999557,0
6142,0,259,315,2540,56,180,9492,1362,10854,-0.021578,0.0177423,-0.99961,0
6316,0,258,312,2544,62,179,9671,1421,11092,-0.0296221,0.024583,-0.999259,0
4309,0,193,221,1760,43,124,6650,1153,7803,-0.0307013,0.0137567,-0.999434,0
4434,0,177,278,1747,40,124,6800,950,7750,-0.027328,0.0128147,-0.999544,0
6300,0,230,344,2359,53,162,9448,1245,10693,-0.0165816,0.0140759,-0.999763,0
5501,0,225,270,2203,57,157,8413,1245,9658,-0.020708,0.0107076,-0.999728,0
7028,0,277,336,2534,59,175,10409,1384,11793,-0.0256096,0.0138092,-0.999577,0
6285,0,244,300,2085,37,116,9067,983,10050,-0.0295416,0.00919065,-0.999521,0
4416,0,168,205,1759,43,120,6711,954,7665,-0.02922,0.0108212,-0.999514,0
6823,0,239,299,2353,54,168,9936,1477,11413,-0.0258519,0.0210323,-0.999445,0
6332,0,238,344,2419,91,169,9593,1491,11084,-0.0248998,0.0264663,-0.99934,0
4308,0,164,201,1647,42,115,6477,959,7436,-0.0204564,0.0304241,-0.999328,0
6620,0,351,411,2365,95,189,10031,1409,11440,-0.0187004,0.0147596,-0.999716,0
5997,0,227,276,2255,70,162,8987,1361,10348,-0.0220924,0.0112148,-0.999693,0
6063,0,250,289,2225,53,159,9039,1146,10185,-0.0180227,0.0170012,-0.999693,0
4072,0,154,200,1500,53,108,6087,981,7068,-0.022506,-0.00106954,-0.999746,0
5931,0,216,264,2168,52,154,8785,1740,10525,-0.0242595,-0.00667149,-0.999684,0
6105,0,321,350,2589,69,156,9590,1415,11005,-0.0202136,0.0136356,-0.999703,0
5847,0,213,260,2117,63,152,8652,1546,10198,-0.0214406,0.0321232,-0.999254,0
6041,0,213,261,2063,51,147,8776,1480,10256,-0.0190714,0.0312221,-0.999331,0
5792,0,211,259,2131,83,151,8627,1701,10328,-0.0224664,0.0202029,-0.999543,0
5369,0,189,233,1819,55,132,7797,1415,9212,-0.0170314,0.040782,-0.999023,0
6465,0,208,256,2066,53,150,9198,1533,10731,-0.0364225,0.046976,-0.998232,0
5934,0,209,256,1975,60,148,8582,1772,10354,-0.0391823,0.0560314,-0.99766,0
6172,0,209,257,1959,67,146,8810,1499,10309,-0.0231503,0.0680126,-0.997416,0
5332,0,186,227,1728,47,127,7647,1571,9218,-0.0121503,0.0624045,-0.997977,0
6068,0,225,253,1934,94,145,8719,1491,10210,-0.00229477,0.0810203,-0.99671,0
5835,0,203,247,1953,63,142,8443,1635,10078,0.0216183,0.126191,-0.99177,0
5419,0,134,163,1289,36,93,7134,956,8090,0.0313708,0.104741,-0.994005,0
3046,0,101,124,972,37,71,4351,754,5105,-0.00153489,0.0593061,-0.998239,0
5843,0,182,236,1776,65,127,8229,1460,9689,0.0303847,0.0993112,-0.994592,0
5792,0,169,208,1624,66,117,7976,1423,9399,0.0141264,0.0857531,-0.996216,0
5743,0,157,199,1458,78,112,7747,1402,9149,0.0357904,0.129773,-0.990898,0
5637,0,147,186,1340,75,103,7488,1391,8879,0.0284215,0.118274,-0.992574,0
5654,0,142,188,1264,61,101,7410,1396,8806,0.0262734,0.135419,-0.99044,0
5570,0,135,172,1195,65,95,7232,1832,9064,0.018195,0.131949,-0.99109,0
5624,0,128,167,1161,59,91,7230,1866,9096,-0.0110989,0.147586,-0.988987,0
5627,0,127,171,1168,55,103,7251,2223,9474,-0.0203403,0.132755,-0.99094,0
5759,0,125,157,1139,54,87,7321,2457,9778,-0.0240468,0.131465,-0.991029,0
5696,0,130,159,1121,48,95,7249,3164,10413,-0.0175164,0.123175,-0.99223,0
5593,0,132,161,1191,71,96,7244,2988,10232,-0.0202766,0.082004,-0.996426,0
5927,0,126,162,1166,65,92,7538,4812,12350,-0.0159349,0.105837,-0.994256,0
4074,0,104,108,804,36,58,5184,3952,9136,0.0100011,0.0900881,-0.995884,0
4898,0,100,127,910,40,74,6149,4041,10190,0.0123514,0.0961398,-0.995291,0
5616,0,125,140,912,45,75,6913,4190,11103,-0.00758238,0.25127,-0.967888,0
6183,0,104,164,873,45,84,7453,2622,10075,0.0109821,0.164118,-0.98638,0
3673,0,65,88,584,55,48,4513,1789,6302,0.0323216,0.16084,-0.986451,0
6704,0,95,179,874,44,71,7967,3028,10995,0.0310683,0.189101,-0.981466,0
5301,0,91,122,811,41,69,6435,2364,8799,-0.000942362,0.326111,-0.945331,0
5363,0,93,123,814,40,68,6501,2710,9211,-0.0128649,0.121012,-0.992568,0
3231,0,51,69,461,22,37,3871,961,4832,-0.0285248,0.20493,-0.978361,0
2362,0,45,58,397,25,32,2919,698,3617,-0.0304899,0.147225,-0.988633,0
5792,0,110,144,989,42,82,7159,1476,8635,0.0013638,0.154441,-0.988001,0
5609,0,115,152,1024,40,83,7023,1437,8460,0.00713417,0.2206,-0.975339,0
5620,0,119,158,1046,43,85,7071,1538,8609,-0.00762191,0.226664,-0.973943,0
5991,0,128,179,1133,43,91,7565,1399,8964,0.003482,0.194491,-0.980898,0
5683,0,135,174,1209,46,96,7343,1439,8782,0.000252305,0.173176,-0.984891,0
5888,0,148,191,1370,45,105,7747,1394,9141,-0.00148806,0.128587,-0.991698,0
5255,0,148,188,1418,52,146,7207,1364,8571,0.0164995,0.157615,-0.987363,0
5867,0,178,220,1666,43,128,8102,1442,9544,0.0386912,0.14282,-0.988992,0
6056,0,189,235,1853,51,139,8523,1425,9948,0.0321888,0.130815,-0.990884,0
6123,0,206,252,2004,66,146,8797,1361,10158,0.0196674,0.13442,-0.990729,0
5586,0,220,300,1968,71,142,8287,1280,9567,0.0100982,0.15816,-0.987362,0
5633,0,206,257,2098,82,148,8424,1271,9695,0.0023879,0.143877,-0.989593,0
6887,0,251,288,2341,77,164,10008,1400,11408,0.00519324,0.128621,-0.99168,0
6103,0,220,271,2156,97,155,9002,1459,10461,0.023973,0.120223,-0.992457,0
6029,0,248,273,1959,118,147,8774,1785,10559,0.0149719,0.147296,-0.988979,0
5913,0,188,232,1767,70,131,8301,1874,10175,-0.00329237,0.122764,-0.99243,0
5241,0,171,189,1380,76,118,7175,1589,8764,0.00036932,0.115055,-0.993359,0
5708,0,146,186,1294,56,103,7493,1609,9102,0.00390699,0.0921242,-0.99574,0
6530,0,142,202,1308,71,108,8361,1617,9978,-0.0116824,0.0709254,-0.997413,0
5591,0,110,141,954,46,79,6921,1388,8309,-0.0195241,0.0433575,-0.998869,0
6300,0,116,157,1145,76,110,7904,1450,9354,-0.0379625,0.0470938,-0.998169,0
5607,0,120,157,1059,45,85,7073,1691,8764,-0.0558415,0.0532973,-0.997016,0
5890,0,117,153,1029,48,84,7321,1875,9196,-0.141046,0.167864,-0.975668,0
6453,0,139,178,1264,57,125,8216,1996,10212,-0.0708995,0.130819,-0.988868,0
5704,0,126,163,1151,47,96,7287,2284,9571,-0.148845,0.21702,-0.964753,0
6315,0,187,194,1311,50,106,8163,2584,10747,-0.0172343,0.221515,-0.975005,0
5898,0,173,190,1169,43,96,7569,3603,11172,-0.00947876,0.268469,-0.963242,0
4066,0,89,116,805,31,65,5172,1454,6626,-0.00942074,0.225285,-0.974248,0
6556,0,220,198,1310,53,98,8435,2611,11046,0.00657199,0.298419,-0.954413,0
5605,0,135,169,1254,47,99,7309,3079,10388,0.00400326,0.295119,-0.955452,0
5044,0,140,162,1139,43,90,6618,3318,9936,0.0296793,0.342244,-0.939143,0
6478,0,168,211,1575,57,122,8611,2807,11418,0.0407479,0.314171,-0.948492,0
5988,0,164,206,1633,53,121,8165,2184,10349,0.0468168,0.304631,-0.951319,0
4111,0,225,162,1141,37,85,5761,1612,7373,0.0349274,0.267967,-0.962795,0
8881,0,195,247,1877,52,136,11388,1415,12803,0.00413009,0.27448,-0.961584,0
5995,0,208,257,2002,50,144,8656,1453,10109,-0.00825176,0.26394,-0.964504,0
6013,0,209,278,1817,47,139,8503,1922,10425,-0.00831714,0.261462,-0.965178,0
5908,0,183,228,1711,48,128,8206,1869,10075,-0.0470169,0.276937,-0.959737,0
5693,0,173,217,1634,60,122,7899,1655,9554,-0.0738567,0.354297,-0.932212,0
5668,0,161,142,1087,36,81,7175,1962,9137,-0.061717,0.289123,-0.9553,0
2458,0,70,88,636,26,49,3327,1185,4512,-0.0178733,0.188063,-0.981994,0
3911,0,113,139,1062,51,82,5358,4321,9679,-0.067732,0.23272,-0.970183,0
5677,0,146,184,1295,49,106,7457,8416,15873,-0.0730425,0.268305,-0.960561,0
5531,0,128,163,1131,47,95,7095,11901,18996,-0.0692337,0.378134,-0.923158,0
2905,0,75,63,418,22,35,3518,3988,7506,-0.0501707,0.242146,-0.968942,0
1686,0,30,41,266,16,22,2061,3941,6002,-0.0744442,0.315828,-0.945892,0
2242,0,38,51,338,22,29,2720,2434,5154,-0.0769998,0.275432,-0.958232,0
5412,0,79,108,678,54,61,6392,8377,14769,-0.0867816,0.309883,-0.946806,0
5332,0,66,95,574,58,69,6194,7400,13594,-0.14441,0.408014,-0.901482,0
3629,0,42,59,355,33,32,4150,3366,7516,-0.17709,0.275205,-0.944934,0
5380,0,61,93,552,48,53,6187,2682,8869,-0.164578,0.258607,-0.951859,0
5286,0,59,86,469,50,45,5995,2440,8435,-0.134511,0.200711,-0.970372,0
5364,0,66,95,554,63,50,6192,2051,8243,-0.126779,0.225045,-0.966065,0
5570,0,77,120,667,62,62,6558,1773,8331,-0.105549,0.193771,-0.975352,0
5515,0,84,114,706,85,64,6568,1624,8192,-0.0679619,0.148588,-0.986561,0
5518,0,93,126,768,68,70,6643,1419,8062,-0.0732609,0.141623,-0.987206,0
6003,0,106,141,912,74,81,7317,1474,8791,-0.047692,0.157755,-0.986326,0
5641,0,124,163,1063,71,90,7152,1405,8557,-0.0117498,0.130469,-0.991383,0
5874,0,143,181,1300,61,107,7666,1427,9093,0.00347022,0.140162,-0.990123,0
6101,0,234,319,1608,78,118,8458,1479,9937,-0.0200393,0.117914,-0.992822,0
5151,0,189,194,1370,74,110,7088,1278,8366,-0.0316711,0.140666,-0.989551,0
6056,0,179,224,1611,93,125,8288,1456,9744,-0.0467478,0.137329,-0.989422,0
5904,0,186,251,1712,51,134,8238,1447,9685,-0.0600025,0.128517,-0.989891,0
6069,0,221,245,1850,47,138,8570,1364,9934,-0.0492258,0.119685,-0.991591,0
5978,0,213,260,2033,97,149,8730,1423,10153,-0.0396118,0.126186,-0.991215,0
6078,0,229,282,2201,49,160,8999,1364,10363,-0.0196486,0.105289,-0.994247,0
6059,0,244,306,2396,60,173,9238,1454,10692,-0.013977,0.112675,-0.993534,0
6092,0,239,294,2284,74,168,9151,1488,10639,-0.00263645,0.0821007,-0.996621,0
6189,0,236,291,2203,97,162,9178,1451,10629,0.000461361,0.0738376,-0.99727,0
6086,0,212,260,2035,75,153,8821,1509,10330,0.0167398,0.087643,-0.996011,0
6117,0,232,225,1645,91,124,8434,1601,10035,0.0143891,0.0840057,-0.996361,0
5825,0,147,187,1349,104,106,7718,1637,9355,-0.00189407,0.0682833,-0.997664,0
5713,0,137,162,1077,73,90,7252,1559,8811,-0.0197208,0.0775467,-0.996793,0
5763,0,101,133,854,86,73,7010,1375,8385,-0.0335779,0.0645269,-0.997351,0
8812,0,119,168,985,112,98,10294,1234,11528,-0.0685696,0.105338,-0.99207,0
3799,0,44,68,379,47,34,4371,1204,5575,-0.0652996,0.0695282,-0.995441,0
5940,0,55,78,465,56,45,6639,2009,8648,-0.143055,0.151445,-0.978059,0
5327,0,81,93,513,45,48,6107,2235,8342,-0.155771,0.149795,-0.976369,0
5991,0,76,119,658,44,62,6950,2471,9421,-0.0817138,0.219344,-0.97222,0
5321,0,77,103,666,44,58,6269,3374,9643,-0.173281,0.238649,-0.955521,0
5444,0,78,109,671,61,86,6449,3006,9455,-0.208345,0.194917,-0.958436,0
5415,0,81,114,705,51,63,6429,4005,10434,-0.200591,0.220014,-0.95465,0
5500,0,83,113,754,52,68,6570,3450,10020,-0.205366,0.23979,-0.948855,0
5690,0,89,129,775,81,68,6832,3064,9896,-0.0557364,0.202313,-0.977734,0
6374,0,110,148,931,95,108,7766,3327,11093,-0.0185451,0.265941,-0.963811,0
5900,0,115,170,1101,85,92,7463,2416,9879,-0.0264312,0.225743,-0.973828,0
5759,0,136,170,1219,45,109,7438,3805,11243,-0.0058279,0.369252,-0.929311,0
5774,0,161,203,1477,44,115,7774,2673,10447,-0.011381,0.325547,-0.945457,0
5205,0,170,208,1668,46,124,7421,2271,9692,-0.031819,0.396965,-0.917282,0
5303,0,190,230,1923,48,137,7831,2595,10426,-0.0102801,0.330844,-0.943629,0
5861,0,193,237,1913,58,141,8403,2812,11215,-0.0414336,0.316728,-0.947611,0
6375,0,177,220,1629,45,123,8569,2590,11159,-0.0331736,0.264555,-0.9638,0
3844,0,112,138,1076,45,78,5293,1107,6400,-0.0156389,0.237588,-0.97124,0
6485,0,160,201,1435,53,114,8448,3276,11724,-0.00399865,0.2863,-0.958132,0
6474,0,145,191,1303,61,104,8278,6001,14279,-0.02315,0.320841,-0.94685,0
4908,0,99,131,874,45,71,6128,7197,13325,-0.0361876,0.193474,-0.980438,0
3790,0,58,81,499,33,43,4504,4759,9263,-0.0286212,0.216519,-0.975859,0
5634,0,73,101,626,41,56,6531,-1000,-1000,-1,-1,-1,0
3666,0,44,62,382,33,35,4222,10544,14766,-0.0188733,0.277387,-0.960573,0
2733,0,31,43,247,27,23,3104,4710,7814,-0.0286579,0.297595,-0.954262,0
5534,0,57,84,459,52,44,6230,11030,17260,-0.194159,0.342908,-0.919085,0
3604,0,38,55,307,34,29,4067,2712,6779,-0.172125,0.223726,-0.959333,0
5919,0,59,87,481,55,48,6649,6418,13067,-0.167316,0.296009,-0.940417,0
3876,0,35,50,283,25,27,4296,2309,6605,-0.099593,0.209435,-0.972738,0
2368,0,31,43,257,19,23,2741,1205,3946,-0.0932167,0.148897,-0.984449,0
4410,0,62,89,520,37,47,5165,1981,7146,-0.0885291,0.163385,-0.982582,0
6299,0,96,131,816,65,95,7502,2261,9763,-0.100853,0.177546,-0.978931,0
6244,0,102,138,879,58,76,7497,1924,9421,-0.073929,0.160925,-0.984194,0
6324,0,112,174,979,95,110,7794,1736,9530,-0.0287132,0.146061,-0.988859,0
6678,0,123,163,1060,66,90,8180,1782,9962,-0.0302854,0.134755,-0.990416,0
6496,0,134,136,764,37,64,7631,1045,8676,-0.0151945,0.129339,-0.991484,0
5895,0,129,165,1116,70,124,7499,1649,9148,-0.00734176,0.194634,-0.980849,0
5927,0,142,225,1280,54,107,7735,1485,9220,0.00691891,0.170358,-0.985358,0
5860,0,126,154,955,38,79,7212,952,8164,0.0122286,0.161838,-0.986741,0
4590,0,116,150,1071,39,84,6050,987,7037,0.0164638,0.157784,-0.987337,0
6715,0,203,256,1867,89,142,9272,1266,10538,0.0262768,0.152646,-0.987931,0
4592,0,144,181,1393,52,101,6463,1100,7563,0.0248422,0.111823,-0.993418,0
6920,0,369,328,2359,76,171,10223,1621,11844,0.00616749,0.127309,-0.991844,0
6915,0,248,373,2459,78,179,10252,1599,11851,-0.00181913,0.12182,-0.992551,0
4452,0,254,308,1835,48,125,7022,1038,8060,0.00238707,0.104018,-0.994573,0
6706,0,260,319,2510,69,196,10060,1590,11650,-0.000844787,0.0954593,-0.995433,0
6799,0,277,362,2440,68,138,10084,1103,11187,-0.00356327,0.0867373,-0.996225,0
4433,0,164,200,1512,70,114,6493,1232,7725,0.00277437,0.0655626,-0.997845,0
5808,0,198,242,1840,61,140,8289,1682,9971,0.0136298,0.0666981,-0.99768,0
6406,0,184,226,1888,60,136,8900,1606,10506,0.0140665,0.0708042,-0.997391,0
5994,0,229,309,1592,75,114,8313,1794,10107,0.0169358,0.0614888,-0.997964,0
5587,0,129,166,1110,67,92,7151,1667,8818,0.0123379,0.0768344,-0.996968,0
5592,0,115,150,999,65,86,7007,1529,8536,-0.00921611,0.0348248,-0.999351,0
5482,0,94,127,788,89,69,6649,1390,8039,-0.0119633,0.0238575,-0.999644,0
5603,0,81,112,698,75,69,6638,1452,8090,-0.00575121,0.0273726,-0.999609,0
5478,0,85,103,601,75,55,6397,1509,7906,-0.00918782,0.073995,-0.997217,0
5367,0,66,92,542,68,49,6184,2017,8201,-0.0130323,0.0371558,-0.999224,0
5753,0,61,105,543,84,54,6600,2093,8693,-0.129456,0.0934714,-0.98717,0
5360,0,58,85,466,63,45,6077,1698,7775,-0.13525,0.092542,-0.98648,0
6000,0,74,108,581,68,56,6887,1789,8676,-0.13622,0.157864,-0.97802,0
5437,0,71,100,579,59,54,6300,2108,8408,-0.132586,0.156016,-0.978815,0
6305,0,111,135,762,62,71,7446,3443,10889,-0.142198,0.157939,-0.977157,0
5601,0,78,110,669,61,61,6580,2864,9444,-0.159071,0.156341,-0.97481,0
3751,0,56,75,474,41,42,4439,2847,7286,-0.160519,0.20725,-0.965029,0
6319,0,82,115,821,90,70,7497,4292,11789,-0.0208468,0.155357,-0.987638,0
5977,0,86,122,764,80,66,7095,3448,10543,-0.0469943,0.0922923,-0.994622,0
5436,0,96,130,834,84,71,6651,3079,9730,-0.000867489,0.249768,-0.968305,0
5563,0,108,143,1060,85,87,7046,2671,9717,0.00427584,0.260277,-0.965524,0
5656,0,122,158,1080,86,93,7195,3234,10429,0.0190976,0.314264,-0.949144,0
5691,0,142,183,1260,64,101,7441,2883,10324,-0.00611936,0.284855,-0.958551,0
3994,0,112,141,1047,36,81,5411,2631,8042,0.00530472,0.298284,-0.954462,0
6040,0,189,235,1812,94,133,8503,2735,11238,0.0280909,0.301178,-0.953154,0
5937,0,209,258,2072,55,146,8677,2550,11227,0.02403,0.259909,-0.965334,0
5862,0,197,255,1855,52,136,8357,2643,11000,0.0193943,0.270827,-0.962433,0
5813,0,170,214,1649,118,126,8090,2696,10786,-0.0138509,0.277699,-0.960569,0
5796,0,212,235,1398,88,116,7845,3995,11840,-0.00146501,0.271903,-0.962324,0
5572,0,125,161,1135,56,90,7139,3704,10843,-0.0124229,0.227067,-0.9738,0
5967,0,115,157,1006,87,83,7415,3436,10851,-0.0244041,0.21939,-0.975332,0
4970,0,94,122,820,47,68,6121,3719,9840,-0.018384,0.227659,-0.973567,0
6379,0,111,168,965,51,83,7757,8212,15969,-0.0294153,0.217104,-0.975705,0
5733,0,90,124,763,49,67,6826,5335,12161,-0.0302877,0.275179,-0.960916,0
5553,0,73,104,589,48,54,6421,6751,13172,-0.0569925,0.219214,-0.974011,0
3750,0,43,61,337,34,32,4257,6693,10950,-0.033046,0.317298,-0.94775,0
4646,0,48,68,393,42,37,5234,7325,12559,-0.030777,0.318212,-0.94752,0
4276,0,45,65,408,34,41,4869,8374,13243,-0.157181,0.2021,-0.96667,0
3352,0,32,49,287,28,28,3776,1993,5769,-0.13475,0.14089,-0.980812,0
5269,0,58,84,492,45,45,5993,2546,8539,-0.116067,0.190156,-0.974869,0
5200,0,64,89,542,43,49,5987,2280,8267,-0.113683,0.226968,-0.967244,0
5307,0,69,126,653,50,59,6264,2535,8799,-0.0934326,0.151623,-0.984013,0
5313,0,72,120,706,48,62,6321,2964,9285,-0.102612,0.157686,-0.982144,0
5482,0,77,124,728,51,64,6526,2453,8979,-0.0703456,0.152684,-0.985768,0
5457,0,81,111,675,50,61,6435,1954,8389,-0.0575625,0.15437,-0.986335,0
5529,0,87,120,713,58,64,6571,1895,8466,-0.0606481,0.110615,-0.992011,0
5657,0,91,124,758,56,67,6753,2472,9225,-0.0402366,0.104197,-0.993743,0
6124,0,96,127,889,72,80,7388,1611,8999,-0.00714316,0.153391,-0.98814,0
5737,0,99,131,852,82,73,6974,1538,8512,-0.0202941,0.141086,-0.989789,0
5494,0,74,97,626,41,54,6386,1024,7410,-0.0333719,0.0909789,-0.995293,0
5813,0,111,150,965,57,84,7180,1504,8684,-0.0520683,0.0942606,-0.994185,0
6601,0,119,157,990,56,86,8009,1581,9590,-0.0258075,0.0822597,-0.996277,0
5782,0,121,204,1067,65,114,7353,1471,8824,-0.0226728,0.107136,-0.993986,0
5660,0,134,164,1110,68,91,7227,1454,8681,-0.025841,0.105957,-0.994035,0
5734,0,149,173,1212,63,101,7432,1586,9018,-0.000429433,0.138394,-0.990377,0
5743,0,141,183,1272,64,107,7510,1364,8874,-0.00778188,0.125416,-0.992074,0
5796,0,152,192,1387,87,115,7729,1400,9129,-0.00993962,0.121996,-0.992481,0
5854,0,165,206,1464,59,117,7865,1417,9282,-0.00888214,0.119252,-0.992824,0
6308,0,183,270,1701,102,130,8694,1463,10157,-0.0128231,0.118058,-0.992924,0
5824,0,184,241,1715,59,130,8153,1415,9568,-0.0126647,0.135564,-0.990688,0
5977,0,198,248,2061,62,146,8692,1484,10176,-0.00223674,0.0960796,-0.995371,0
6242,0,216,272,2140,74,155,9099,1452,10551,0.00749567,0.0747963,-0.997171,0
5979,0,227,307,2158,70,161,8902,1383,10285,-0.000108753,0.0738823,-0.997267,0
5963,0,238,343,2147,81,164,8936,1417,10353,-0.0113955,0.0756174,-0.997072,0
5992,0,227,281,2380,74,161,9115,1528,10643,-0.00503636,0.0811714,-0.996688,0
5901,0,213,285,2047,69,154,8669,1514,10183,0.0142134,0.0642632,-0.997832,0
6444,0,188,256,1759,98,133,8878,1583,10461,0.00761327,0.088335,-0.996062,0
5848,0,204,213,1542,60,116,7983,1575,9558,0.00164263,0.106493,-0.994312,0
5708,0,138,176,1330,117,105,7574,1502,9076,0.0103854,0.0882352,-0.996046,0
5561,0,121,155,1067,64,90,7058,1361,8419,0.0170024,0.0435279,-0.998908,0
5669,0,103,137,882,84,74,6949,1459,8408,0.00629905,0.0146837,-0.999873,0
5592,0,90,121,763,69,65,6700,1842,8542,0.00721639,-0.00547554,-0.999959,0
6315,0,76,105,605,84,55,7240,3196,10436,0.00324803,0.0558836,-0.998432,0
5537,0,66,105,554,78,54,6394,3756,10150,0.127615,0.210997,-0.96912,0
5624,0,67,97,560,72,54,6474,3390,9864,0.131987,0.254989,-0.957894,0
2853,0,29,39,242,25,22,3210,6897,10107,-0.0336845,-0.0246387,-0.999129,0
1453,0,19,27,156,16,14,1685,4969,6654,-0.214842,-0.0083515,-0.976613,0
2701,0,36,51,298,30,28,3144,4708,7852,-0.0910744,-0.104585,-0.990337,0
5552,0,75,106,655,59,62,6509,-1000,-1000,-1,-1,-1,0
2868,0,39,55,320,25,30,3337,1397,4734,-0.0177541,0.196447,-0.980354,0
5642,0,78,110,658,55,60,6603,4731,11334,-0.0531461,0.11498,-0.991945,0
5463,0,84,131,731,73,65,6547,-1000,-1000,-1,-1,-1,0
4101,0,67,89,574,33,51,4915,1746,6661,-0.0342407,0.171215,-0.984639,0
5777,0,130,148,1032,77,85,7249,-1000,-1000,-1,-1,-1,0
5662,0,137,166,1109,61,93,7228,2678,9906,-0.0426405,0.185786,-0.981665,0
5662,0,161,189,1312,101,104,7529,-1000,-1000,-1,-1,-1,0
6194,0,172,215,1686,57,128,8452,2301,10753,0.0353712,0.320506,-0.946586,0
4089,0,134,166,1349,36,96,5870,3293,9163,0.00668977,0.289821,-0.957057,0
6321,0,210,258,2100,81,151,9121,4394,13515,0.0299696,0.317423,-0.947811,0
6023,0,201,276,2015,66,146,8727,3266,11993,0.0167502,0.289626,-0.956994,0
3014,0,99,122,921,34,69,4259,1431,5690,0.0305618,0.280243,-0.959443,0
5799,0,168,211,1580,81,117,7956,2279,10235,0.0213719,0.278915,-0.960078,0
5641,0,142,180,1278,97,103,7441,-1000,-1000,-1,-1,-1,0
3821,0,87,112,800,35,65,4920,-1000,-1000,-1,-1,-1,0
5963,0,109,142,932,56,97,7299,-1000,-1000,-1,-1,-1,0
5514,0,94,126,801,48,69,6652,-1000,-1000,-1,-1,-1,0
4053,0,94,141,518,48,45,4899,-1000,-1000,-1,-1,-1,0
3749,0,50,70,416,42,38,4365,-1000,-1000,-1,-1,-1,0
5501,0,65,98,610,51,56,6381,-1000,-1000,-1,-1,-1,0
3758,0,42,60,331,37,32,4260,-1000,-1000,-1,-1,-1,0
3641,0,36,65,325,32,31,4130,-1000,-1000,-1,-1,-1,0
5279,0,54,80,433,62,42,5950,-1000,-1000,-1,-1,-1,0
2734,0,27,40,227,35,21,3084,-1000,-1000,-1,-1,-1,0
5265,0,52,77,441,64,44,5943,-1000,-1000,-1,-1,-1,0
5313,0,55,81,442,54,43,5988,8641,14629,-0.0560327,0.523727,-0.850041,0
2360,0,25,37,230,35,22,2709,3878,6587,-0.0278207,0.378921,-0.925011,0
1795,0,19,29,161,19,15,2038,-1000,-1000,-1,-1,-1,0
2387,0,30,43,268,27,26,2781,7369,10150,0.00108108,0.21957,-0.975596,0
5888,0,74,107,613,60,56,6798,14846,21644,-0.118907,0.22021,-0.968178,0
2691,0,39,54,331,33,29,3177,5204,8381,-0.0439139,0.29123,-0.955645,0
5682,0,83,114,713,64,67,6723,7523,14246,0.217258,0.226008,-0.949589,0
5621,0,88,119,730,59,64,6681,5684,12365,-0.19815,0.0609163,-0.978277,0
4940,0,81,110,684,64,61,5940,3741,9681,-0.168753,0.0952436,-0.981046,0
5790,0,96,132,870,84,82,7054,4155,11209,-0.111402,0.0851288,-0.990123,0
6030,0,99,131,834,61,73,7228,2189,9417,-0.124518,0.0754498,-0.989344,0
5549,0,105,140,920,64,80,6858,2160,9018,-0.137439,0.106338,-0.984785,0
5694,0,111,156,941,66,80,7048,1662,8710,-0.0831317,0.0927094,-0.992217,0
5643,0,117,156,1133,93,124,7266,1950,9216,-0.0873869,0.0726637,-0.993521,0
5700,0,130,169,1137,70,93,7299,1964,9263,0.138816,0.122915,-0.982661,0
5741,0,140,178,1246,106,106,7517,1808,9325,0.00198765,0.148705,-0.98888,0
5797,0,152,192,1351,65,109,7666,1577,9243,0.0142373,0.115377,-0.99322,0
5841,0,158,200,1403,120,112,7834,1532,9366,0.0127924,0.139973,-0.990073,0
5921,0,172,216,1555,62,121,8047,1403,9450,0.00529514,0.144343,-0.989514,0
6005,0,186,233,1694,71,129,8318,1385,9703,0.0136597,0.126927,-0.991818,0
6003,0,204,285,2055,66,181,8794,1389,10183,0.0216567,0.124007,-0.992045,0
5959,0,224,275,2174,68,159,8859,1415,10274,0.00345909,0.0949962,-0.995472,0
6116,0,241,308,2174,137,163,9139,1426,10565,-0.0049965,0.107248,-0.99422,0
5985,0,232,286,2210,123,165,9001,1435,10436,0.00245698,0.08077,-0.99673,0
6103,0,210,256,1976,79,149,8773,1519,10292,-0.00101595,0.104874,-0.994485,0
6212,0,187,233,1821,89,136,8678,1582,10260,0.0130464,0.0836388,-0.996411,0
6138,0,168,211,1664,81,124,8386,1574,9960,0.0274571,0.0944671,-0.995149,0
5801,0,152,228,1348,111,105,7745,1425,9170,0.0174139,0.104521,-0.99437,0
5779,0,135,197,1319,92,152,7674,1610,9284,0.0227903,0.0874393,-0.995909,0
5644,0,118,154,1048,73,85,7122,1524,8646,0.0243196,0.0703784,-0.997224,0
5629,0,103,136,890,58,77,6893,1621,8514,0.010153,0.0896053,-0.995926,0
5423,0,88,116,786,60,68,6541,2026,8567,-0.00487673,0.0994298,-0.995033,0
5380,0,75,113,633,62,58,6321,2363,8684,-0.0336587,0.0905192,-0.995326,0
5950,0,74,105,652,67,58,6906,2856,9762,-0.101547,0.101419,-0.989648,0
5640,0,81,151,679,78,62,6691,6317,13008,-0.0856116,0.137863,-0.986744,0
5605,0,86,119,748,68,63,6689,5994,12683,-0.113196,0.109783,-0.987489,0
4951,0,103,139,944,96,89,6322,8017,14339,-0.0493897,0.116052,-0.992015,0
4898,0,82,109,711,74,61,5935,3958,9893,-0.12251,-0.0320154,-0.991951,0
5738,0,93,127,808,82,88,6936,3232,10168,-0.0290819,0.139366,-0.989814,0
4641,0,69,90,602,44,51,5497,1787,7284,0.0955566,0.263648,-0.959875,0
2375,0,47,62,410,29,34,2957,950,3907,0.00950862,0.144293,-0.98949,0
2633,0,59,77,527,31,43,3370,1030,4400,0.00356637,0.138827,-0.99031,0
5884,0,146,188,1316,60,104,7698,2253,9951,0.0202459,0.151652,-0.988226,0
5879,0,191,214,1541,60,121,8006,2305,10311,0.153401,0.24893,-0.956296,0
5823,0,194,237,1830,77,137,8298,2211,10509,0.174793,0.256594,-0.950582,0
6047,0,217,272,2238,105,154,9033,2280,11313,0.250174,0.299954,-0.920565,0
5487,0,160,196,1626,48,113,7630,1732,9362,0.25107,0.295681,-0.921703,0
2544,0,85,103,831,27,58,3648,927,4575,0.181222,0.229549,-0.956277,0
2671,0,104,135,1019,54,71,4054,684,4738,0.145006,0.206122,-0.967723,0
5891,0,238,284,2176,68,155,8812,1604,10416,0.238362,0.347072,-0.907041,0
5933,0,221,281,2049,160,150,8794,1298,10092,0.187998,0.298829,-0.935606,0
2737,0,99,106,790,35,58,3825,631,4456,0.154586,0.221144,-0.962912,0
2723,0,88,108,831,59,61,3870,799,4669,0.113332,0.176368,-0.977778,0
5674,0,158,206,1538,175,117,7868,6425,14293,0.118235,0.189248,-0.974785,0
5039,0,129,180,1156,90,93,6687,5332,12019,0.103406,0.217138,-0.970649,0
4590,0,110,140,993,64,97,5994,5992,11986,0.0949491,0.235767,-0.96716,0
5633,0,146,195,1417,122,123,7636,-1000,-1000,-1,-1,-1,0
2906,0,57,74,492,50,41,3620,5956,9576,0.0802715,0.230566,-0.96974,0
3674,0,62,84,526,66,45,4457,7933,12390,0.0684458,0.212247,-0.974816,0
5372,0,86,114,721,72,63,6428,13545,19973,0.0690931,0.231353,-0.970413,0
2828,0,40,55,337,36,30,3326,11475,14801,0.0474919,0.0981223,-0.994041,0
3390,0,46,80,412,40,37,4005,6683,10688,0.0341024,0.276172,-0.960503,0
4303,0,52,73,427,58,40,4953,9234,14187,-0.00122247,0.331253,-0.943541,0
5252,0,58,84,555,66,53,6068,8399,14467,0.0103918,0.209405,-0.977774,0
5296,0,79,87,447,64,44,6017,7988,14005,0.0213929,0.242368,-0.969949,0
2755,0,29,41,227,33,22,3107,3549,6656,0.0100884,0.180051,-0.983606,0
5504,0,54,82,426,64,42,6172,11172,17344,0.0282003,0.152619,-0.987882,0
5187,0,54,78,427,63,42,5851,10862,16713,0.011425,0.271311,-0.962424,0
2206,0,23,33,186,24,18,2490,4128,6618,0.203135,0.292835,-0.934336,0
5237,0,56,82,452,58,44,5929,8387,14316,0.016521,0.180995,-0.983345,0
3638,0,40,58,317,40,31,4124,3651,7775,0.194946,0.265803,-0.944111,0
5411,0,60,88,522,73,55,6209,7552,13761,0.215646,0.317283,-0.923487,0
3781,0,44,72,405,37,38,4377,2953,7330,0.0221286,0.187579,-0.982,0
1913,0,23,43,192,19,17,2207,1084,3291,-0.0140087,0.0811484,-0.996603,0
2423,0,32,45,261,24,23,2808,1348,4156,-0.0766904,0.151019,-0.985552,0
5448,0,83,112,691,50,61,6445,3850,10295,0.0228902,0.210773,-0.977267,0
5688,0,89,124,747,51,67,6766,3668,10434,0.0492571,0.153005,-0.986997,0
5464,0,100,129,868,53,72,6686,2345,9031,-0.0655247,0.148892,-0.98668,0
6034,0,152,150,1014,50,85,7485,2047,9532,-0.0828896,0.148128,-0.985488,0
5782,0,124,165,1063,41,89,7264,1742,9006,0.0211352,0.114854,-0.993157,0
5930,0,135,176,1208,53,100,7602,1477,9079,0.0133458,0.127948,-0.991691,0
5849,0,152,190,1340,55,106,7692,1456,9148,0.0120657,0.109455,-0.993919,0
6023,0,163,209,1462,56,114,8027,1499,9526,-0.00346371,0.125731,-0.992059,0
5871,0,180,220,1662,69,128,8130,1446,9576,-0.0318724,0.143647,-0.989116,0
5961,0,198,242,1865,82,162,8510,1422,9932,-0.0355689,0.128273,-0.991101,0
5960,0,210,256,2061,50,148,8685,1370,10055,-0.00831688,0.101942,-0.994756,0
6151,0,230,284,2332,94,168,9259,1410,10669,-0.0173411,0.106542,-0.994157,0
6298,0,248,313,2491,129,174,9653,1389,11042,-0.0222509,0.0952929,-0.995201,0
6284,0,284,326,2707,93,188,9882,1375,11257,-0.0244536,0.0924251,-0.995419,0
3238,0,143,237,1639,37,108,5402,832,6234,0.000615661,0.0681823,-0.997673,0
6217,0,273,332,2732,75,189,9818,1369,11187,-0.0298224,0.0671594,-0.997296,0
6389,0,271,329,2676,52,188,9905,1373,11278,-0.0306339,0.068972,-0.997148,0
6161,0,268,326,2713,74,188,9730,1347,11077,-0.0218627,0.0794592,-0.996598,0
4184,0,176,213,1661,48,120,6402,1030,7432,-0.0241266,0.0680541,-0.99739,0
6010,0,237,289,2317,72,192,9117,1546,10663,-0.0265144,0.0713279,-0.997101,0
5963,0,226,278,2164,70,157,8858,1611,10469,-0.0249451,0.0756362,-0.996824,0
5956,0,207,254,2107,65,149,8738,1664,10402,-0.0264913,0.0697407,-0.997213,0
5843,0,189,232,1810,78,132,8284,1799,10083,-0.0231885,0.055251,-0.998203,0
5909,0,166,212,1521,47,138,7993,1618,9611,-0.0283583,0.0414001,-0.99874,0
5684,0,144,181,1296,55,111,7471,1524,8995,-0.00124745,0.0296237,-0.99956,0
5752,0,127,188,1139,54,98,7358,1385,8743,0.00881921,0.0339503,-0.999385,0
5681,0,109,141,938,58,104,7031,1395,8426,0.00288636,0.0307478,-0.999523,0
5726,0,100,142,846,44,73,6931,1528,8459,-0.0290127,0.0295974,-0.999141,0
5680,0,96,127,863,46,71,6883,1779,8662,-0.0241619,0.010623,-0.999652,0
5705,0,93,123,822,63,87,6893,1648,8541,-0.0551257,0.0191783,-0.998295,0
5421,0,90,118,787,46,68,6530,1947,8477,-0.0210267,-0.0307582,-0.999306,0
5784,0,92,125,893,45,72,7011,2241,9252,-0.0442027,0.0178727,-0.998863,0
5547,0,95,128,792,44,69,6675,3197,9872,-0.0316856,-0.0134654,-0.999407,0
5607,0,100,133,866,47,73,6826,3612,10438,-0.0622135,0.0086128,-0.998026,0
5579,0,160,202,1023,51,88,7103,3396,10499,-0.0726503,0.0283403,-0.996955,0
5816,0,176,215,1065,55,92,7419,3438,10857,-0.0730171,0.0448196,-0.996323,0
5701,0,124,161,1086,62,92,7226,2999,10225,-0.153233,0.0757095,-0.985286,0
6143,0,140,180,1311,63,105,7942,2050,9992,-0.106567,0.0634966,-0.992276,0
5834,0,152,192,1395,65,108,7746,2855,10601,-0.160155,0.072664,-0.984413,0
5812,0,164,206,1526,59,118,7885,2330,10215,-0.162467,0.0752123,-0.983843,0
5254,0,162,195,1801,60,118,7590,2147,9737,-0.206818,0.099828,-0.973273,0
5932,0,188,232,1776,85,132,8345,2711,11056,-0.214247,0.0967757,-0.971974,0
6358,0,230,254,1973,79,186,9080,2760,11840,-0.221495,0.0994616,-0.970076,0
5430,0,192,235,1855,57,154,7923,1746,9669,-0.243576,0.130607,-0.961048,0
6008,0,229,282,2272,67,158,9016,1568,10584,-0.240376,0.149179,-0.959148,0
6358,0,250,313,2452,53,124,9550,983,10533,-0.235191,0.143104,-0.961357,0
5452,0,238,289,2446,86,164,8675,1239,9914,-0.218963,0.121053,-0.968195,0
7043,0,260,319,2603,61,182,10468,1376,11844,-0.264984,0.0913153,-0.95992,0
6089,0,258,315,2567,73,179,9481,1206,10687,-0.250432,0.0995693,-0.963001,0
5607,0,246,307,2436,65,168,8829,1284,10113,-0.286214,0.0663232,-0.955867,0
6525,0,293,380,3105,61,206,10570,1411,11981,-0.25711,0.0508993,-0.965041,0
6571,0,342,375,3182,57,213,10740,1157,11897,-0.25251,0.0256402,-0.967255,0
4715,0,219,263,2239,40,150,7626,963,8589,-0.224391,0.0151946,-0.974381,0
6210,0,334,377,3794,74,234,11023,1484,12507,-0.22341,0.00904507,-0.974683,0
3139,0,154,186,1209,31,92,4811,576,5387,-0.197363,0.00337544,-0.980325,0
6648,0,338,360,3070,72,214,10702,2045,12747,-0.175702,0.000341913,-0.984444,0
6007,0,278,356,2684,54,192,9571,1719,11290,-0.153203,-0.00446773,-0.988185,0
5907,0,266,342,2634,78,189,9416,2269,11685,-0.163421,-0.0136292,-0.986462,0
6580,0,254,311,2512,88,175,9920,1933,11853,-0.207813,-0.0280534,-0.977766,0
5840,0,238,291,2061,29,113,8572,1790,10362,-0.170067,-0.0138446,-0.985335,0
3225,0,92,112,859,22,63,4373,879,5252,-0.154695,-0.0214517,-0.98773,0
5759,0,190,234,1766,53,133,8135,2454,10589,-0.191653,-0.0642063,-0.979361,0
5722,0,173,215,1602,56,85,7853,1252,9105,-0.200524,-0.079597,-0.97645,0
3039,0,87,104,783,31,60,4104,1239,5343,-0.147535,-0.052509,-0.987662,0
5723,0,152,191,1389,68,109,7632,1569,9201,-0.119714,-0.0561553,-0.991219,0
6095,0,159,231,1742,72,144,8443,1645,10088,-0.135051,-0.0698413,-0.988374,0
5729,0,135,172,1182,49,97,7364,1813,9177,-0.101858,-0.0484616,-0.993618,0
5679,0,125,168,1090,47,113,7222,1624,8846,-0.0954447,-0.0589692,-0.993687,0
6047,0,114,156,1095,60,89,7561,1688,9249,-0.0836695,-0.0415119,-0.995629,0
5634,0,103,136,886,67,75,6901,2034,8935,-0.0912461,-0.0452389,-0.9948,0
5550,0,95,126,794,56,69,6690,2149,8839,-0.0839613,-0.0446843,-0.995467,0
5507,0,86,116,710,56,64,6539,3398,9937,-0.0519247,-0.0516155,-0.997316,0
5460,0,80,109,677,57,63,6446,2707,9153,-0.0728963,-0.0635837,-0.995311,0
6253,0,76,116,607,52,56,7160,2449,9609,-0.0795218,-0.0988555,-0.991919,0
5519,0,75,110,617,49,56,6426,2714,9140,-0.05639,-0.085098,-0.994776,0
6050,0,78,108,640,47,57,6980,2829,9809,-0.0454151,-0.0995131,-0.993999,0
5650,0,83,112,706,59,63,6673,2676,9349,-0.0290711,-0.129962,-0.991093,0
5634,0,91,122,749,59,66,6721,2256,8977,-0.0708695,-0.188859,-0.979444,0
5587,0,69,91,601,41,54,6443,1588,8031,-0.037388,-0.140428,-0.989385,0
3860,0,79,102,684,28,44,4797,995,5792,-0.0816774,-0.0907647,-0.992517,0
3600,0,81,103,711,45,59,4599,1046,5645,-0.0690704,-0.0934508,-0.993225,0
5753,0,148,184,1253,53,100,7491,1582,9073,-0.0816171,-0.154017,-0.984692,0
5697,0,151,192,1367,54,109,7570,1644,9214,-0.0655865,-0.0698702,-0.995398,0
6831,0,166,213,1479,54,118,8861,1456,10317,-0.0795292,-0.159001,-0.98407,0
5920,0,174,238,1576,87,124,8119,1478,9597,-0.0497057,-0.133178,-0.989845,0
5971,0,188,280,1800,69,160,8468,1389,9857,-0.0532925,-0.136039,-0.989269,0
5922,0,200,245,1864,56,167,8454,1415,9869,-0.0553892,-0.0950891,-0.993926,0
5536,0,192,239,1867,81,139,8054,1246,9300,-0.0405659,-0.0885806,-0.995243,0
6575,0,242,272,2073,73,154,9389,1390,10779,-0.0333697,-0.0919431,-0.995205,0
6204,0,209,257,2000,82,151,8903,1402,10305,-0.0293781,-0.117397,-0.99265,0
5947,0,197,239,1833,101,142,8459,1482,9941,-0.036951,-0.10282,-0.994013,0
6674,0,177,223,1597,61,148,8880,1563,10443,-0.0556351,-0.102633,-0.993162,0
4084,0,106,141,982,60,74,5447,1058,6505,-0.0437119,-0.0903912,-0.994947,0
6206,0,125,176,1271,60,132,7970,1474,9444,-0.033223,-0.103984,-0.994024,0
5567,0,106,140,939,69,79,6900,1111,8011,-0.0180297,-0.0826162,-0.996419,0
5495,0,90,120,766,58,66,6595,1620,8215,-0.0416846,-0.149902,-0.987822,0
5384,0,73,102,613,45,55,6272,1688,7960,-0.0440094,-0.173063,-0.983927,0
2788,0,33,46,300,30,28,3225,1245,4470,-0.042071,-0.0561391,-0.997536,0
2501,0,29,41,242,25,22,2860,888,3748,-0.0460294,-0.0651641,-0.996812,0
5548,0,64,90,524,46,51,6323,2697,9020,-0.0454613,-0.0943563,-0.9945,0
5441,0,69,96,567,50,52,6275,4440,10715,-0.0208499,0.00371687,-0.999776,0
5643,0,73,110,607,46,55,6534,5253,11787,0.0615677,-0.161617,-0.984931,0
5367,0,79,108,674,49,60,6337,5655,11992,-0.00406992,-0.00179006,-0.99999,0
5622,0,83,117,725,46,63,6656,4354,11010,-0.195424,-0.124474,-0.972787,0
5380,0,95,116,738,46,65,6440,4172,10612,-0.0898043,-0.0987335,-0.991053,0
5659,0,94,126,787,43,70,6779,4302,11081,-0.0561281,-0.00374555,-0.998417,0
5569,0,103,137,945,45,82,6881,5510,12391,-0.0878952,-0.162591,-0.982771,0
3818,0,80,105,697,29,58,4787,3953,8740,-0.0537268,-0.27961,-0.95861,0
5586,0,134,174,1194,43,97,7228,4227,11455,0.0595158,0.178271,-0.98218,0
5826,0,160,204,1449,48,113,7800,3853,11653,-0.043595,-0.337665,-0.940256,0
5746,0,177,219,1596,61,124,7923,4564,12487,0.0142687,-0.204761,-0.978708,0
6002,0,191,274,1772,57,132,8428,4638,13066,0.0128017,-0.358627,-0.933393,0
3927,0,123,150,1251,35,90,5576,3856,9432,0.0251276,-0.309339,-0.95062,0
5871,0,164,209,1476,55,116,7891,5393,13284,0.00903716,-0.301945,-0.953283,0
6131,0,210,230,1505,50,109,8235,4860,13095,-0.0310848,-0.29841,-0.953932,0
3821,0,81,105,730,33,59,4829,7009,11838,0.048454,-0.454448,-0.889454,0
5041,0,94,124,841,43,72,6215,7671,13886,0.0791162,-0.567128,-0.819821,0
5491,0,91,128,774,46,67,6597,-1000,-1000,-1,-1,-1,0
2373,0,35,48,295,22,26,2799,4196,6995,-0.125006,-0.343395,-0.930835,0
5847,0,65,101,635,45,54,6747,12568,19315,-0.0306473,-0.378383,-0.925142,0
3433,0,44,61,378,32,33,3981,9319,13300,-0.0511677,-0.241845,-0.968965,0
3205,0,38,54,309,25,29,3660,5244,8904,-0.070161,-0.313787,-0.946898,0
5430,0,63,90,494,46,47,6170,9386,15556,-0.0417537,-0.462565,-0.885602,0
3715,0,42,79,416,32,37,4321,4764,9085,-0.0102376,-0.44907,-0.893438,0
6257,0,58,84,473,46,45,6963,3856,10819,-0.0314133,-0.283055,-0.958589,0
3672,0,41,64,349,34,32,4192,3598,7790,-0.024741,-0.20638,-0.978159,0
5317,0,97,135,806,77,73,6505,7596,14101,0.0103292,-0.229561,-0.973239,0
5341,0,75,109,687,45,62,6319,4664,10983,0.0753242,-0.228091,-0.970722,0
5621,0,83,114,694,45,62,6619,4207,10826,0.0650222,-0.248936,-0.966335,0
5443,0,122,136,872,57,90,6720,3074,9794,0.0235892,-0.227837,-0.973413,0
5502,0,102,133,864,50,75,6726,2562,9288,0.031573,-0.202217,-0.978832,0
6258,0,116,163,1017,49,81,7684,2849,10533,-0.00300552,-0.205842,-0.978581,0
6007,0,184,209,1506,70,144,8120,2478,10598,-0.00893158,-0.172911,-0.984897,0
6020,0,139,177,1248,46,104,7734,1869,9603,-0.0143656,-0.168855,-0.985536,0
9112,0,239,325,2109,68,174,12027,2112,14139,-0.0299292,-0.138249,-0.989945,0
4418,0,117,154,1059,70,85,5903,1166,7069,-0.022053,-0.132204,-0.990977,0
5836,0,184,228,1692,49,133,8122,1739,9861,-0.0179963,-0.16805,-0.985614,0
6203,0,200,250,2207,71,226,9157,1698,10855,0.0118652,-0.19569,-0.980594,0
6071,0,217,281,2141,48,154,8912,1493,10405,0.0163028,-0.176272,-0.984206,0
4138,0,172,304,1862,56,111,6643,1293,7936,0.0166116,-0.172741,-0.984827,0
5897,0,221,271,2082,53,157,8681,3200,11881,0.0186069,-0.172895,-0.984765,0
5879,0,216,262,1986,60,151,8554,1563,10117,0.00877464,-0.120223,-0.992708,0
5758,0,200,258,1851,79,139,8285,1361,9646,0.0284905,-0.225924,-0.973728,0
5716,0,122,161,1102,33,85,7219,962,8181,0.0216325,-0.161134,-0.986695,0
2927,0,62,77,540,24,42,3672,615,4287,0.00978147,-0.0778768,-0.996915,0
3303,0,64,84,541,44,46,4082,967,5049,-0.00149044,-0.0471077,-0.998889,0
5393,0,85,112,702,59,63,6414,1507,7921,-0.0199303,-0.0576235,-0.99814,0
5261,0,69,94,555,56,51,6086,1711,7797,-0.0210444,0.00749354,-0.999751,0
5453,0,62,93,506,50,49,6213,1918,8131,-0.0122594,-0.0940214,-0.995495,0
5381,0,60,87,483,51,48,6110,2679,8789,0.0113223,-0.135872,-0.990661,0
5354,0,65,91,516,52,50,6128,4425,10553,0.00460332,-0.113621,-0.993514,0
5460,0,67,98,580,65,70,6340,6340,12680,0.0817983,-0.174548,-0.981245,0
5703,0,70,106,623,44,58,6604,5612,12216,-0.0160478,-0.0275835,-0.999491,0
2825,0,39,54,328,24,30,3300,2276,5576,-0.0251119,0.0335465,-0.999122,0
6181,0,78,110,661,46,61,7137,3431,10568,-0.0621291,-0.262607,-0.962901,0
5585,0,85,116,716,57,66,6625,2410,9035,-0.0762081,-0.195,-0.977838,0
3414,0,49,64,410,20,36,3993,1480,5473,-0.0565384,-0.0870151,-0.994601,0
3530,0,69,89,594,36,63,4381,1841,6222,-0.0881284,-0.151646,-0.984498,0
5612,0,125,163,1083,46,90,7119,2414,9533,-0.0469745,-0.0565858,-0.997292,0
5837,0,144,189,1321,40,107,7638,2435,10073,-0.151881,-0.164075,-0.974686,0
5836,0,161,204,1538,71,163,7973,2528,10501,-0.0431083,-0.200906,-0.978662,0
5788,0,179,222,1607,43,126,7965,2302,10267,-0.0971472,-0.281391,-0.954663,0
6714,0,195,246,1861,57,137,9210,2781,11991,-0.0557062,-0.229666,-0.971674,0
5783,0,197,236,1796,50,133,8195,3200,11395,-0.090594,-0.243496,-0.965662,0
3937,0,144,154,1148,54,90,5527,1490,7017,-0.137611,-0.229964,-0.963421,0
6246,0,251,245,1709,76,128,8655,2272,10927,-0.033829,-0.197429,-0.979733,0
5801,0,154,194,1396,49,121,7715,1991,9706,-0.0417578,-0.170296,-0.984508,0
6301,0,128,170,1146,60,106,7911,3806,11717,-0.00749738,-0.181837,-0.9833,0
5548,0,116,153,1028,46,83,6974,3249,10223,-0.0333309,-0.148065,-0.988416,0
5628,0,106,159,954,42,83,6972,5408,12380,0.002547,-0.317264,-0.948334,0
3709,0,63,86,537,31,46,4472,4805,9277,-0.0418052,-0.208912,-0.97704,0
5898,0,80,115,680,45,60,6878,6568,13446,-0.0385432,-0.250578,-0.967329,0
5346,0,74,102,631,48,56,6257,7765,14022,-0.0735342,-0.127408,-0.989121,0
2765,0,37,72,312,23,29,3238,6294,9532,0.01334,-0.334484,-0.942307,0
5525,0,69,101,608,52,56,6411,15058,21469,-0.0873483,-0.109293,-0.990164,0
2254,0,27,39,226,36,21,2603,8688,11291,-0.0699438,-0.182963,-0.980629,0
2445,0,29,42,244,23,22,2805,3569,6374,-0.0195565,-0.25138,-0.967691,0
5332,0,66,94,559,45,52,6148,10956,17104,-0.019946,-0.212537,-0.976949,0
2764,0,31,44,275,23,24,3161,10502,13663,-0.0164349,-0.187264,-0.982172,0
2628,0,28,42,233,23,22,2976,-1000,-1000,-1,-1,-1,0
2607,0,32,46,261,24,24,2994,6059,9053,0.0765135,-0.186944,-0.979386,0
5519,0,71,100,656,49,58,6453,6402,12855,0.00940287,-0.186205,-0.982466,0
5411,0,79,108,689,46,64,6397,4492,10889,0.0520272,-0.183121,-0.981713,0
3872,0,60,81,527,59,47,4646,2102,6748,0.0205386,-0.195862,-0.980416,0
5630,0,96,128,799,46,70,6769,1890,8659,0.0626521,-0.183718,-0.98098,0
5773,0,102,142,852,50,75,6994,2038,9032,0.0383771,-0.209057,-0.97715,0
5623,0,113,147,814,50,56,6803,1131,7934,-0.014468,-0.108109,-0.994034,0
2952,0,62,81,563,24,46,3728,988,4716,-0.00761833,-0.135352,-0.990768,0
5719,0,126,163,1106,40,91,7245,1757,9002,-0.00252102,-0.141306,-0.989963,0
5590,0,135,184,1180,42,98,7229,1746,8975,0.00018615,-0.177754,-0.984075,0
5709,0,150,192,1329,44,107,7531,1616,9147,0.00241197,-0.166762,-0.985994,0
5726,0,166,209,1486,45,120,7752,1706,9458,0.00189469,-0.164907,-0.986307,0
5696,0,177,223,1617,47,126,7886,1657,9543,-0.02059,-0.142385,-0.989598,0
5810,0,202,236,1749,49,136,8182,1555,9737,0.00451821,-0.166947,-0.985955,0
5761,0,205,248,1907,46,143,8310,1441,9751,-0.00952992,-0.157341,-0.987498,0
6001,0,226,282,2259,53,189,9010,1608,10618,-0.00794678,-0.162571,-0.986665,0
6045,0,233,288,2253,84,165,9068,1513,10581,-0.00448992,-0.155856,-0.98777,0
6023,0,237,291,2278,59,168,9056,1709,10765,-0.007079,-0.222406,-0.974929,0
6092,0,233,286,2216,38,113,8978,1240,10218,-0.00769471,-0.172589,-0.984964,0
3043,0,94,114,885,25,67,4228,578,4806,-0.00795271,-0.0834644,-0.996479,0
5975,0,202,248,1901,70,144,8540,1441,9981,0.0144687,-0.113078,-0.993481,0
5824,0,183,226,1766,54,135,8188,1490,9678,0.0132788,-0.103777,-0.994512,0
5789,0,156,196,1434,58,115,7748,1570,9318,-0.00812872,-0.0892451,-0.995977,0
5807,0,133,172,1196,65,102,7475,1613,9088,-0.0130144,-0.0630766,-0.997924,0
5651,0,113,148,1011,75,85,7083,1407,8490,-0.00392356,-0.0708124,-0.997482,0
5621,0,88,120,799,54,72,6754,1381,8135,0.00836209,-0.0566526,-0.998359,0
5406,0,68,98,579,52,66,6269,1366,7635,0.0177637,-0.0623047,-0.997899,0
5349,0,58,83,473,48,49,6060,1433,7493,0.00384147,-0.115445,-0.993306,0
5279,0,50,93,395,46,42,5905,1498,7403,-0.0103844,-0.0745837,-0.997161,0
5321,0,63,80,413,46,41,5964,1928,7892,-0.00558095,-0.113511,-0.993521,0
6165,0,58,85,446,45,45,6844,2828,9672,0.00981637,-0.0629111,-0.997971,0
5372,0,62,91,519,45,51,6140,4859,10999,0.0245203,-0.104428,-0.99423,0
5363,0,65,90,536,65,53,6172,5341,11513,0.0110407,-0.0590804,-0.998192,0
3712,0,52,70,434,30,39,4337,5206,9543,-0.0109404,-0.0665749,-0.997722,0
4775,0,65,91,541,40,52,5564,2897,8461,0.00848822,-0.0841669,-0.996416,0
3594,0,49,67,425,29,40,4204,1804,6008,0.0112298,-0.140191,-0.990061,0
5436,0,81,113,672,44,62,6408,2397,8805,0.00405495,-0.142484,-0.989789,0
5467,0,91,124,766,44,70,6562,2625,9187,-0.020434,-0.168845,-0.985431,0
5616,0,106,164,922,45,80,6933,2598,9531,-0.0310663,-0.161913,-0.986316,0
3976,0,88,116,774,27,63,5044,1624,6668,-0.0324758,-0.0820702,-0.996097,0
5646,0,155,195,1370,45,113,7524,2249,9773,-0.0618141,-0.179267,-0.981857,0
6067,0,210,228,1667,46,168,8386,2365,10751,-0.0176381,-0.266707,-0.963616,0
5810,0,200,246,1825,30,96,8207,1832,10039,-0.0211909,-0.236882,-0.971307,0
5456,0,241,267,1695,50,129,7838,3012,10850,-0.061372,-0.332911,-0.940959,0
3776,0,135,149,1111,27,82,5280,1575,6855,-0.0874545,-0.262472,-0.960968,0
5883,0,163,206,1487,48,118,7905,2179,10084,-0.0942728,-0.282406,-0.954652,0
5813,0,143,183,1303,59,102,7603,1824,9427,-0.0883145,-0.248247,-0.964662,0
5736,0,155,163,1159,48,94,7355,1931,9286,0.0620831,-0.236053,-0.969755,0
5747,0,127,143,932,60,81,7090,2010,9100,0.063327,-0.217467,-0.974011,0
6137,0,103,138,916,61,79,7434,3724,11158,-0.0207323,-0.150846,-0.988339,0
5383,0,94,125,830,47,72,6551,2936,9487,-0.0524702,-0.107896,-0.992777,0
5621,0,92,137,917,53,74,6894,3546,10440,-0.0919176,-0.118373,-0.988706,0
6060,0,86,116,808,51,72,7193,4276,11469,-0.0365224,-0.0978259,-0.994533,0
5550,0,83,114,709,56,61,6573,5264,11837,0.0388243,-0.145302,-0.988626,0
4780,0,73,98,624,43,55,5673,4238,9911,-0.108072,-0.0741422,-0.991374,0
5389,0,80,123,704,54,63,6413,6290,12703,0.0467899,-0.144056,-0.988463,0
5855,0,116,136,845,60,71,7083,5105,12188,0.0268849,-0.118457,-0.992595,0
3821,0,55,76,470,39,41,4502,9097,13599,-0.101335,-0.0670576,-0.99259,0
5695,0,71,106,604,53,53,6582,4691,11273,0.00193015,-0.111847,-0.993724,0
4921,0,70,95,609,39,52,5786,6793,12579,0.0395561,-0.176566,-0.983494,0
4445,0,61,84,514,37,47,5188,5119,10307,0.0552662,-0.206976,-0.976784,0
6024,0,79,112,660,50,61,6986,5542,12528,0.0403879,-0.175921,-0.983575,0
5273,0,67,94,546,58,51,6089,4438,10527,-0.00505618,-0.193277,-0.981131,0
5577,0,56,82,469,48,44,6276,5120,11396,-0.0208479,-0.115578,-0.993079,0
4966,0,85,115,641,91,72,5970,5373,11343,0.00565358,-0.17876,-0.983876,0
5047,0,61,89,519,44,48,5808,3495,9303,-0.0152732,-0.159116,-0.987142,0
4890,0,67,94,562,47,50,5710,3412,9122,0.00705729,-0.219375,-0.975615,0
6021,0,91,124,774,53,68,7131,3715,10846,0.00522837,-0.169834,-0.985459,0
6493,0,101,139,839,57,76,7705,2977,10682,0.0154365,-0.10816,-0.994014,0
6234,0,96,135,819,55,71,7410,2024,9434,0.0149133,-0.144664,-0.989369,0
6236,0,104,135,926,62,110,7573,2141,9714,0.0113386,-0.171786,-0.985069,0
4019,0,80,116,725,41,60,5041,1223,6264,-0.000376312,-0.135068,-0.990836,0
5528,0,150,170,1133,45,93,7119,1479,8598,-0.00279841,-0.131237,-0.991347,0
5698,0,145,185,1252,48,103,7431,1366,8797,0.0170512,-0.164378,-0.98625,0
5641,0,161,224,1445,53,115,7639,1376,9015,-0.000246351,-0.139502,-0.990222,0
5885,0,170,213,1617,46,125,8056,1435,9491,0.00125152,-0.138938,-0.9903,0
6437,0,273,252,1811,46,137,8956,1434,10390,0.0170341,-0.15608,-0.987597,0
5930,0,198,245,1802,64,139,8378,1124,9502,0.0119427,-0.137375,-0.990447,0
5418,0,188,231,1740,44,134,7755,1360,9115,0.0233605,-0.127369,-0.99158,0
6469,0,219,273,2128,65,193,9347,1450,10797,0.0270986,-0.13217,-0.990856,0
6074,0,231,281,2356,59,166,9167,1270,10437,0.00916861,-0.12684,-0.991881,0
6244,0,237,332,2320,59,166,9358,1407,10765,0.0174234,-0.11151,-0.993611,0
6089,0,241,295,2682,75,174,9556,1378,10934,0.0169083,-0.117687,-0.992907,0
4233,0,184,202,1590,48,115,6372,1022,7394,0.00134431,-0.0887629,-0.996052,0
6065,0,320,413,2146,63,186,9193,1521,10714,-0.00611898,-0.0957341,-0.995388,0
5912,0,198,243,1913,60,143,8469,1604,10073,-0.00215637,-0.0948949,-0.995485,0
5855,0,182,226,1700,57,133,8153,1740,9893,0.0165321,-0.0875612,-0.996022,0
5849,0,159,199,1515,56,118,7896,1823,9719,0.031864,-0.0810748,-0.996199,0
5704,0,141,179,1255,66,100,7445,1704,9149,0.0256281,-0.0635923,-0.997647,0
5733,0,125,162,1125,67,90,7302,1540,8842,0.0212206,-0.055675,-0.998224,0
5571,0,107,140,934,86,78,6916,1440,8356,0.0442044,-0.0965697,-0.994344,0
5386,0,90,121,665,50,45,6357,968,7325,0.0212159,-0.0594824,-0.998004,0
3684,0,50,70,424,47,38,4313,1014,5327,0.0199832,-0.0128112,-0.999718,0
5295,0,62,89,550,66,52,6114,1374,7488,0.0180186,-0.0241567,-0.999546,0
6027,0,63,89,490,57,42,6768,1514,8282,0.0139412,0.00234794,-0.9999,0
5511,0,55,91,444,56,46,6203,1612,7815,-0.0107256,0.0250938,-0.999628,0
5972,0,55,78,439,54,43,6641,2278,8919,-0.0711697,-0.0570941,-0.995829,0
5580,0,60,86,528,55,53,6362,3341,9703,-0.010386,-0.0911932,-0.995779,0
5399,0,95,108,542,53,53,6250,3164,9414,-0.0144169,-0.101628,-0.994718,0
6099,0,76,108,614,47,53,6997,5714,12711,-0.103506,-0.107384,-0.988815,0
3693,0,51,72,451,32,41,4340,3142,7482,-0.0275324,-0.118982,-0.992514,0
5456,0,77,109,657,44,59,6402,3853,10255,-0.156879,-0.118398,-0.980495,0
5328,0,81,110,701,43,62,6325,3492,9817,-0.156437,-0.166902,-0.973484,0
5562,0,91,125,837,33,75,6723,2996,9719,-0.0631909,-0.15189,-0.986375,0
5542,0,103,151,940,34,79,6849,2473,9322,-0.0902556,-0.160716,-0.982865,0
5723,0,125,163,1132,34,94,7271,2668,9939,-0.0523144,-0.187221,-0.980924,0
5771,0,147,188,1332,40,106,7584,2766,10350,-0.168861,-0.309783,-0.935693,0
5869,0,168,216,1526,42,119,7940,2576,10516,-0.133103,-0.348451,-0.927828,0
5828,0,193,238,1805,47,140,8251,3145,11396,-0.0242383,-0.356574,-0.933953,0
5288,0,184,241,1766,51,133,7663,2933,10596,-0.0445457,-0.315304,-0.947944,0
5847,0,239,245,1878,58,139,8406,3227,11633,-0.0780686,-0.324438,-0.94268,0
5945,0,171,215,1666,58,124,8179,3229,11408,0.0383422,-0.298384,-0.953676,0
6125,0,198,215,1471,102,138,8249,1591,9840,0.0362987,-0.287743,-0.957019,0
5673,0,149,185,1374,49,107,7537,1387,8924,0.0318752,-0.245076,-0.96898,0
5571,0,155,163,1040,44,86,7059,1513,8572,0.0166771,-0.221414,-0.975037,0
5687,0,99,168,836,50,74,6914,2684,9598,0.0339538,-0.236003,-0.971159,0
5522,0,82,146,739,55,66,6610,3256,9866,-0.0537125,-0.185908,-0.981098,0
5320,0,73,101,592,51,56,6193,4200,10393,0.017558,-0.18233,-0.983081,0
5308,0,66,92,542,51,50,6109,7403,13512,-0.00455546,-0.134226,-0.99094,0
2918,0,34,50,279,29,26,3336,5282,8618,0.0234983,-0.300852,-0.953381,0
5400,0,64,92,529,61,49,6195,15580,21775,-0.00683315,-0.313275,-0.949638,0
6329,0,60,89,485,61,48,7072,7845,14917,-0.0288317,-0.266537,-0.963394,0
5379,0,58,86,467,62,45,6097,6223,12320,-0.0554136,-0.338451,-0.939351,0
5380,0,56,84,395,36,30,5981,4777,10758,-0.212709,-0.299445,-0.930101,0
2222,0,24,35,189,24,18,2512,3127,5639,-0.0715776,-0.145423,-0.986777,0
1615,0,17,26,145,15,13,1831,1396,3227,-0.0809061,-0.166016,-0.982799,0
4319,0,51,121,427,39,40,4997,4254,9251,-0.162222,-0.244347,-0.956023,0
5378,0,71,100,676,38,61,6324,6077,12401,-0.0699602,-0.2135,-0.974435,0
5530,0,78,110,677,37,87,6519,2483,9002,-0.058302,-0.246178,-0.96747,0
4594,0,58,81,537,26,46,5342,2517,7859,-0.055834,-0.226403,-0.972432,0
2878,0,68,91,424,20,43,3524,1577,5101,-0.118315,-0.229326,-0.966132,0
5495,0,100,131,871,50,74,6721,3116,9837,-0.116194,-0.185939,-0.975667,0
6951,0,111,202,957,53,100,8374,2109,10483,-0.10841,-0.183534,-0.977018,0
5563,0,124,162,1131,48,94,7122,1619,8741,-0.0797843,-0.176772,-0.981013,0
6141,0,137,176,1293,40,104,7891,1491,9382,-0.034376,-0.139642,-0.989605,0
5656,0,154,196,1374,40,110,7530,1423,8953,-0.0390667,-0.13393,-0.99022,0
5971,0,171,213,1573,41,123,8092,1396,9488,-0.0417534,-0.152549,-0.987414,0
6664,0,207,257,1968,55,151,9302,1439,10741,-0.0439579,-0.166247,-0.985104,0
4124,0,137,168,1310,51,96,5886,1015,6901,-0.0557561,-0.135525,-0.989204,0
6664,0,213,260,1994,66,155,9352,1425,10777,-0.0437406,-0.147513,-0.988092,0
6975,0,221,276,2141,53,157,9823,1536,11359,-0.0206325,-0.144684,-0.989263,0
6178,0,260,319,2264,108,163,9292,1289,10581,-0.0096049,-0.143069,-0.989666,0
4723,0,156,196,1582,58,111,6826,958,7784,0.00529655,-0.129463,-0.99157,0
6330,0,219,301,2199,75,185,9309,1671,10980,0.00922093,-0.138836,-0.990272,0
6013,0,216,264,2119,81,154,8847,1451,10298,0.00814402,-0.124199,-0.992224,0
6695,0,209,292,2006,97,176,9475,1581,11056,0.0110535,-0.109347,-0.993942,0
5915,0,194,239,1843,59,137,8387,1673,10060,0.0117,-0.103006,-0.994612,0
5340,0,155,194,1430,62,109,7290,1538,8828,0.00276007,-0.101694,-0.994812,0
5944,0,142,180,1343,91,105,7805,1972,9777,0.00690199,-0.0865476,-0.996224,0
6224,0,116,162,1031,68,85,7686,1461,9147,-0.0130518,-0.0577738,-0.998245,0
5762,0,101,130,848,54,71,6966,1500,8466,-0.0312473,-0.0567494,-0.9979,0
5588,0,84,130,706,46,66,6620,1526,8146,-0.0314782,-0.144621,-0.988987,0
5314,0,70,104,624,68,70,6250,1562,7812,-0.0273721,-0.0948496,-0.995116,0
4631,0,43,61,351,38,32,5156,1030,6186,-0.0243474,-0.0518463,-0.998358,0
2795,0,30,43,245,31,23,3167,788,3955,-0.0230421,-0.000421964,-0.999735,0
3553,0,38,55,309,38,47,4040,1230,5270,-0.026165,0.0416335,-0.99879,0
5322,0,68,114,586,44,55,6189,1874,8063,-0.00677428,-0.0161018,-0.999847,0
5608,0,74,105,603,64,58,6512,2851,9363,-0.0120234,-0.0781153,-0.996872,0
6361,0,74,106,634,56,58,7289,4144,11433,-0.0861906,-0.126097,-0.988267,0
3756,0,55,77,475,39,41,4443,4339,8782,-0.0360379,-0.140954,-0.98936,0
5742,0,75,116,695,51,60,6739,2586,9325,-0.0224307,-0.130263,-0.991226,0
4865,0,85,114,772,44,64,5944,2724,8668,-0.0217799,-0.0666786,-0.997537,0
5480,0,106,137,952,49,79,6803,6293,13096,-0.0311789,-0.0879954,-0.995633,0
3901,0,81,122,713,36,60,4913,4694,9607,-0.0077607,-0.104773,-0.994466,0
5724,0,131,178,1140,44,95,7312,6083,13395,-0.00229032,-0.164275,-0.986412,0
5343,0,133,170,1210,41,95,6992,4116,11108,-0.00611216,-0.206587,-0.978409,0
5154,0,149,183,1415,42,108,7051,6843,13894,-0.0253152,-0.292951,-0.955792,0
4960,0,149,184,1404,40,105,6842,3637,10479,-0.0141873,-0.235638,-0.971737,0
6634,0,198,249,1839,43,138,9101,3601,12702,-0.0227987,-0.286947,-0.957675,0
5958,0,209,255,2052,51,151,8676,1777,10453,-0.0142123,-0.251767,-0.967684,0
5437,0,192,235,1897,40,135,7936,1437,9373,-0.00220863,-0.281089,-0.959679,0
5928,0,198,242,1922,49,137,8476,1459,9935,-0.000731465,-0.300015,-0.953934,0
6312,0,171,219,1600,62,119,8483,1423,9906,0.0145797,-0.308492,-0.951115,0
6561,0,150,192,1384,59,108,8454,1457,9911,-0.000719875,-0.260282,-0.965532,0
5763,0,131,168,1259,68,97,7486,1485,8971,0.00134955,-0.28449,-0.958678,0
5769,0,113,149,1004,63,83,7181,1455,8636,0.011545,-0.287384,-0.957746,0
5713,0,155,202,1020,62,84,7236,2352,9588,0.0235326,-0.2957,-0.954991,0
5536,0,93,128,826,52,73,6708,2708,9416,0.0148314,-0.254764,-0.96689,0
5528,0,87,117,744,50,64,6590,3350,9940,0.0198751,-0.276466,-0.960818,0
5568,0,83,113,721,61,64,6610,4214,10824,0.0438809,-0.391075,-0.919312,0
5400,0,90,76,481,45,42,6134,2480,8614,0.0267034,-0.289459,-0.956818,0
2774,0,37,51,307,34,28,3231,2629,5860,0.0254063,-0.229082,-0.973075,0
3996,0,48,70,402,45,37,4598,3925,8523,0.0222559,-0.259145,-0.965582,0
5257,0,59,87,500,54,48,6005,5011,11016,-0.127351,-0.208388,-0.96972,0
5319,0,58,82,488,53,45,6045,3421,9466,-0.114636,-0.234059,-0.96544,0
5909,0,69,101,596,45,53,6773,2540,9313,-0.0880462,-0.314051,-0.945315,0
5312,0,75,115,642,50,58,6252,2017,8269,-0.0793391,-0.252394,-0.964366,0
2806,0,45,60,417,26,35,3389,957,4346,-0.0720855,-0.193349,-0.978478,0
2740,0,52,64,409,25,34,3324,1168,4492,-0.0748025,-0.194949,-0.977957,0
5573,0,112,144,967,54,83,6933,1833,8766,-0.0671779,-0.165347,-0.983945,0
5713,0,128,178,1117,52,92,7280,1699,8979,-0.0772528,-0.173704,-0.981763,0
5810,0,154,197,1477,46,115,7799,1455,9254,-0.0384222,-0.132181,-0.990481,0
5938,0,171,218,1531,50,121,8029,1439,9468,-0.0604466,-0.131804,-0.989431,0
6198,0,205,265,1790,43,135,8636,1416,10052,-0.0328054,-0.195051,-0.980244,0
5862,0,193,237,2502,62,224,9080,1603,10683,-0.0201299,-0.192901,-0.981012,0
2482,0,89,108,858,20,63,3620,631,4251,-0.0215336,-0.140345,-0.989868,0
5928,0,225,276,2247,75,163,8914,1548,10462,-0.0290183,-0.219623,-0.975153,0
6099,0,161,198,1566,53,112,8189,1010,9199,-0.0153828,-0.189261,-0.981807,0
3603,0,126,155,1213,43,88,5228,784,6012,-0.0233188,-0.141889,-0.989608,0
4702,0,180,221,1920,44,127,7194,1097,8291,-0.0117143,-0.153168,-0.988131,0
6268,0,239,292,2395,62,170,9426,1495,10921,-0.00133583,-0.143139,-0.989702,0
7305,0,226,286,2177,76,111,10181,994,11175,-0.00929849,-0.123426,-0.99231,0
4251,0,148,180,1505,68,121,6273,1005,7278,-0.0119968,-0.112231,-0.99361,0
6258,0,238,254,1967,79,143,8939,1578,10517,0.00185481,-0.12449,-0.992219,0
5968,0,180,220,2490,99,135,9092,1328,10420,4.4189e-05,-0.10099,-0.994888,0
4131,0,116,145,1151,54,82,5679,1148,6827,-0.00407769,-0.0957368,-0.995399,0
6644,0,174,201,1477,59,109,8664,1618,10282,-0.0251088,-0.0961347,-0.995052,0
5883,0,140,176,1367,71,103,7740,1630,9370,-0.0234875,-0.0804323,-0.996483,0
5764,0,130,165,1165,65,92,7381,1587,8968,-0.00546717,-0.0705268,-0.997495,0
6405,0,128,169,1203,51,95,8051,1525,9576,-0.00651076,-0.0502682,-0.998715,0
5587,0,125,159,1118,63,88,7140,1420,8560,-0.00904587,-0.0439628,-0.998992,0
5791,0,118,156,1057,67,89,7278,1363,8641,-0.0314782,-0.0856481,-0.995828,0
5576,0,113,146,1023,62,81,7001,1195,8196,-0.0285091,-0.0886891,-0.995651,0
5468,0,138,156,1020,55,82,6919,1659,8578,-0.020457,-0.1255,-0.991883,0
5607,0,118,153,1124,48,91,7141,1444,8585,-0.00916858,-0.129911,-0.991483,0
5637,0,128,164,1205,50,96,7280,1937,9217,0.00920774,-0.135652,-0.990714,0
5840,0,131,173,1248,44,99,7535,1773,9308,-0.00675929,-0.165447,-0.986196,0
5574,0,158,193,1243,52,98,7318,1842,9160,-0.0468084,-0.153553,-0.987031,0
5803,0,127,206,1254,40,99,7529,1700,9229,-0.0483462,-0.149131,-0.987635,0
6309,0,148,166,1151,42,93,7909,2272,10181,-0.0176979,-0.182705,-0.983009,0
5590,0,118,156,1144,40,91,7139,1749,8888,-0.0457229,-0.194661,-0.979804,0
5528,0,122,158,1188,42,93,7131,2701,9832,-0.0240511,-0.186088,-0.982239,0
5569,0,142,168,1237,54,96,7266,3367,10633,-0.0407765,-0.209882,-0.976876,0
5134,0,128,163,1193,50,93,6761,3143,9904,-0.0186233,-0.179213,-0.983634,0
5890,0,234,282,1474,58,117,8055,3932,11987,-0.0308758,-0.167603,-0.985371,0
5778,0,169,210,1567,55,120,7899,2534,10433,-0.0328857,-0.158675,-0.986783,0
5906,0,186,244,1658,56,128,8178,2473,10651,-0.00589134,-0.122462,-0.992456,0
5934,0,186,249,2161,49,139,8718,2129,10847,0.00520376,-0.148633,-0.988879,0
6087,0,192,236,1820,51,138,8524,1687,10211,0.00985067,-0.143742,-0.989566,0
6156,0,192,236,2322,66,192,9164,2238,11402,0.00159589,-0.229089,-0.973404,0
4988,0,137,168,1315,45,97,6750,1118,7868,0.00806412,-0.187201,-0.982288,0
2179,0,73,90,689,23,50,3104,797,3901,0.00955937,-0.141005,-0.989963,0
2017,0,73,87,706,21,52,2956,808,3764,0.0121018,-0.116798,-0.993082,0
6503,0,212,265,1989,60,148,9177,2284,11461,0.00136161,-0.134104,-0.990967,0
5842,0,251,264,1986,81,182,8606,2081,10687,0.00277357,-0.142877,-0.989737,0
4068,0,146,179,1346,36,101,5876,971,6847,0.00834713,-0.114173,-0.993426,0
5892,0,205,253,1969,59,144,8522,1392,9914,0.0188615,-0.152556,-0.988115,0
5901,0,202,262,1900,57,139,8461,1368,9829,0.0159971,-0.128304,-0.991606,0
3933,0,103,139,1042,31,74,5322,782,6104,0.0126077,-0.0993073,-0.994977,0
3536,0,117,144,1176,58,85,5116,822,5938,-0.00155797,-0.0953359,-0.995444,0
5895,0,189,235,1933,67,137,8456,1399,9855,-0.00952181,-0.0960469,-0.995331,0
6304,0,188,235,1910,62,137,8836,1397,10233,-0.0108163,-0.079499,-0.996776,0
3986,0,129,159,1298,53,94,5719,1044,6763,-0.00989669,-0.0733306,-0.997259,0
6359,0,183,260,1903,81,168,8954,1536,10490,-0.0102028,-0.0597616,-0.998161,0
4038,0,149,158,1232,38,88,5703,1112,6815,0.00962123,-0.0508077,-0.998662,0
6088,0,179,241,1785,54,131,8478,1410,9888,0.0165495,-0.0447638,-0.99886,0
5759,0,177,220,1775,56,131,8118,1474,9592,0.0102082,-0.0439095,-0.998984,0
6083,0,178,224,1678,55,123,8341,1534,9875,0.0222399,-0.0374731,-0.99905,0
3959,0,125,188,1243,43,87,5645,1010,6655,0.0210596,-0.0457777,-0.99873,0
6155,0,172,222,1683,58,133,8423,1500,9923,0.0190062,-0.0405444,-0.998997,0
5748,0,177,237,1715,60,129,8066,1577,9643,0.00972739,-0.0575631,-0.998294,0
5724,0,173,218,1778,70,128,8091,1491,9582,0.00300632,-0.05253,-0.998615,0
5833,0,174,245,1780,61,129,8222,1509,9731,0.0100746,-0.050162,-0.99869,0
5919,0,176,225,1705,60,127,8212,1505,9717,-0.00197984,-0.0610968,-0.99813,0
5774,0,173,276,1665,59,126,8073,1644,9717,0.00421232,-0.05642,-0.998398,0
6177,0,166,213,1556,65,116,8293,1476,9769,0.0086145,-0.0549967,-0.99845,0
5726,0,164,207,1564,69,137,7867,1191,9058,0.00983376,-0.0515622,-0.998622,0
4971,0,174,188,1388,74,105,6900,1257,8157,0.00871468,-0.0467162,-0.99887,0
5827,0,162,205,1522,56,113,7885,1393,9278,0.00139606,-0.0399307,-0.999201,0
6249,0,164,216,1592,57,120,8398,1369,9767,-0.00124623,-0.0378848,-0.999281,0
5497,0,162,202,1515,58,113,7547,1394,8941,-0.00370697,-0.0291285,-0.999569,0
5630,0,164,206,1653,52,119,7824,1410,9234,-0.00451973,-0.0274047,-0.999614,0
5570,0,164,206,1545,61,119,7665,1602,9267,-0.00717811,-0.0242073,-0.999681,0
5645,0,165,208,1547,60,115,7740,1612,9352,0.0072964,-0.0284614,-0.999568,0
6482,0,167,214,1553,54,117,8587,1487,10074,0.00107252,-0.0318383,-0.999492,0
5702,0,169,211,1830,78,146,8136,1671,9807,0.00048901,-0.0399188,-0.999203,0
5606,0,171,212,1669,56,124,7838,1393,9231,-0.000853083,-0.038065,-0.999275,0
5554,0,167,209,1615,75,121,7741,1460,9201,-0.0115183,-0.0342336,-0.999348,0
5584,0,167,208,1555,61,116,7691,1418,9109,0.00408096,-0.0390224,-0.99923,0
5637,0,188,245,1612,60,121,7863,1397,9260,-0.00994723,-0.0290023,-0.99953,0
5559,0,167,207,1543,58,116,7650,1410,9060,0.00636942,-0.0378663,-0.999263,0
5670,0,169,213,1570,80,118,7820,1384,9204,0.000323961,-0.0294429,-0.999567,0
5547,0,169,211,1596,61,119,7703,1457,9160,0.00680802,-0.0289838,-0.999557,0
5586,0,169,210,1604,60,122,7751,1450,9201,-0.0100212,-0.0283954,-0.999546,0
5753,0,170,223,1636,74,136,7992,1410,9402,-0.00694516,-0.0299632,-0.999527,0
6022,0,170,220,1746,62,125,8345,1617,9962,-4.20927e-05,-0.0367694,-0.999324,0
5781,0,168,216,1645,54,124,7988,1392,9380,0.00577911,-0.0361733,-0.999329,0
6068,0,168,213,1638,54,142,8283,1400,9683,0.00236544,-0.0338783,-0.999423,0
5695,0,166,210,1571,62,128,7832,1399,9231,0.00138338,-0.035366,-0.999374,0
5859,0,166,240,1604,73,121,8063,1502,9565,0.00758222,-0.0396931,-0.999183,0
5743,0,166,209,1599,69,121,7907,1510,9417,-0.00516247,-0.0335341,-0.999424,0
5724,0,150,192,1478,54,109,7707,1271,8978,0.0018474,-0.0321472,-0.999481,0
5686,0,165,210,1585,56,121,7823,1481,9304,0.0080803,-0.0274824,-0.99959,0
5789,0,169,216,1605,56,121,7956,1426,9382,0.00660684,-0.0275333,-0.999599,0
5703,0,169,212,1680,87,131,7982,1423,9405,-0.0010459,-0.0290039,-0.999579,0
3929,0,138,148,1101,39,85,5440,982,6422,-0.000302745,-0.0296427,-0.99956,0
5655,0,170,215,1685,65,125,7915,1359,9274,0.00328744,-0.0365246,-0.999327,0
6081,0,169,215,1706,53,125,8349,1362,9711,0.00253456,-0.0381079,-0.99927,0
5673,0,169,213,1654,56,129,7894,1370,9264,0.00144428,-0.0415526,-0.999135,0
6023,0,168,214,1640,60,124,8229,1383,9612,0.0015247,-0.0352684,-0.999376,0
5621,0,168,211,1602,74,120,7796,1412,9208,-0.00374274,-0.0316025,-0.999493,0
5687,0,167,209,1658,62,123,7906,1344,9250,0.00859228,-0.0280757,-0.999569,0
5210,0,151,189,1428,49,108,7135,1258,8393,0.00548419,-0.0298363,-0.99954,0
5683,0,190,232,1665,58,137,7965,1444,9409,0.00387275,-0.035982,-0.999345,0
5602,0,169,213,1628,54,123,7789,1274,9063,0.00484582,-0.0402051,-0.99918,0
5613,0,170,212,1592,55,140,7782,1401,9183,-0.00362086,-0.0336715,-0.999426,0
5833,0,166,227,1416,43,101,7786,974,8760,-8.57165e-05,-0.0318264,-0.999494,0
3842,0,89,111,838,28,80,4988,760,5748,0.00516492,-0.0373566,-0.999289,0
