Downsample[ns],BuildFilTree[ns],SearchFil[ns],DeleteFil[ns],BuildTreeSub[ns],SearchSub[ns],DeleteSub[ns],PreProcTotal[ns],Plane[ns],Total[ns],nx,ny,nz,planeCount
7085,0,0,0,0,1225,358,8668,346,9014,-0.163193,0.256654,-0.952626,0
4510,0,0,0,0,832,204,5546,305,5851,0.000824987,0.0392508,-0.999229,0
8552,0,0,0,0,1245,307,10104,432,10536,0.00753318,0.0344674,-0.999377,0
5997,0,0,0,0,1101,301,7399,566,7965,0.00909686,0.0337693,-0.999388,0
6050,0,0,0,0,1152,276,7478,573,8051,0.00794131,0.0331118,-0.99942,0
8220,0,0,0,0,1098,272,9590,604,10194,0.00621962,0.0332581,-0.999427,0
6176,0,0,0,0,1164,276,7616,522,8138,0.00438844,0.0344979,-0.999395,0
6067,0,0,0,0,1137,279,7483,519,8002,0.00504907,0.0359145,-0.999342,0
4192,0,0,0,0,753,191,5136,351,5487,0.00571168,0.0366828,-0.999311,0
6967,0,0,0,0,1329,333,8629,594,9223,0.00600944,0.0382143,-0.999251,0
6378,0,0,0,0,860,221,7459,389,7848,0.0058289,0.0413034,-0.99913,0
4561,0,0,0,0,821,206,5588,374,5962,0.00631818,0.0440473,-0.99901,0
4549,0,0,0,0,856,222,5627,330,5957,0.00559479,0.0475649,-0.998852,0
7076,0,0,0,0,1296,331,8703,492,9195,0.00771332,0.0524862,-0.998592,0
6125,0,0,0,0,1192,274,7591,479,8070,0.0134494,0.0594861,-0.998139,0
5985,0,0,0,0,1203,281,7469,497,7966,0.0121882,0.0578906,-0.998249,0
5944,0,0,0,0,812,191,6947,310,7257,0.0118248,0.0643074,-0.99786,0
4725,0,0,0,0,829,203,5757,341,6098,0.00959328,0.0627317,-0.997984,0
4125,0,0,0,0,796,192,5113,345,5458,0.01156,0.064706,-0.997837,0
6837,0,0,0,0,1334,324,8495,601,9096,0.0153423,0.066048,-0.997698,0
6387,0,0,0,0,1127,273,7787,582,8369,0.0182418,0.0690429,-0.997447,0
7422,0,0,0,0,1236,311,8969,720,9689,0.0174632,0.0684366,-0.997503,0
6846,0,0,0,0,1269,302,8417,766,9183,0.0187096,0.0756733,-0.996957,0
6921,0,0,0,0,1320,307,8548,767,9315,0.0118841,0.0807917,-0.99666,0
7101,0,0,0,0,1309,304,8714,744,9458,0.0142989,0.0843635,-0.996332,0
7035,0,0,0,0,1359,325,8719,819,9538,0.0231389,0.0850435,-0.996109,0
7110,0,0,0,0,1364,325,8799,910,9709,0.0170911,0.079503,-0.996688,0
7466,0,0,0,0,1219,224,8909,510,9419,0.0206178,0.0780608,-0.996735,0
6672,0,0,0,0,1199,297,8168,746,8914,0.0201161,0.0844172,-0.996227,0
7074,0,0,0,0,1356,361,8791,776,9567,0.024668,0.0892081,-0.995707,0
7184,0,0,0,0,1319,331,8834,766,9600,0.0196605,0.0841182,-0.996262,0
6670,0,0,0,0,1268,288,8226,671,8897,0.0196864,0.0897914,-0.995766,0
6547,0,0,0,0,1221,293,8061,617,8678,0.0289767,0.0864558,-0.995834,0
6641,0,0,0,0,1082,289,8012,708,8720,0.0281312,0.0836363,-0.996099,0
6575,0,0,0,0,1091,299,7965,646,8611,0.0199903,0.0908906,-0.99566,0
6481,0,0,0,0,1072,274,7827,590,8417,0.023881,0.0983356,-0.994867,0
6121,0,0,0,0,960,242,7323,647,7970,0.00975081,0.0950282,-0.995427,0
5995,0,0,0,0,925,230,7150,632,7782,0.00507373,0.0970915,-0.995263,0
5928,0,0,0,0,879,221,7028,631,7659,-0.00144955,0.0965983,-0.995322,0
5995,0,0,0,0,875,216,7086,676,7762,-0.000211653,0.0957219,-0.995408,0
6027,0,0,0,0,919,214,7160,651,7811,0.0126703,0.0852787,-0.996277,0
6755,0,0,0,0,795,206,7756,808,8564,0.0172284,0.082513,-0.996441,0
5988,0,0,0,0,850,205,7043,731,7774,0.0162859,0.0820981,-0.996491,0
5787,0,0,0,0,580,141,6508,504,7012,0.0176424,0.0679792,-0.997531,0
5994,0,0,0,0,849,222,7065,791,7856,0.0213095,0.0776317,-0.996754,0
6238,0,0,0,0,861,212,7311,768,8079,0.0223059,0.0792607,-0.996604,0
6144,0,0,0,0,893,238,7275,728,8003,0.0224296,0.0817735,-0.996399,0
5858,0,0,0,0,796,200,6854,700,7554,0.022692,0.0750323,-0.996923,0
6001,0,0,0,0,787,198,6986,689,7675,0.0224624,0.0774887,-0.99674,0
6035,0,0,0,0,732,195,6962,675,7637,0.0159935,0.0781727,-0.996812,0
6089,0,0,0,0,681,175,6945,612,7557,0.0126772,0.0795241,-0.996752,0
6135,0,0,0,0,613,155,6903,596,7499,0.0107815,0.0751761,-0.997112,0
5841,0,0,0,0,577,150,6568,584,7152,0.0132069,0.106041,-0.994274,0
7624,0,0,0,0,802,184,8610,652,9262,0.0170325,0.0848612,-0.996247,0
6012,0,0,0,0,587,140,6739,485,7224,0.0197162,0.106511,-0.994116,0
5974,0,0,0,0,503,136,6613,479,7092,0.0192233,0.101516,-0.994648,0
6010,0,0,0,0,520,145,6675,548,7223,0.0237962,0.0781151,-0.99666,0
6127,0,0,0,0,591,150,6868,512,7380,0.0272818,0.085577,-0.995958,0
6115,0,0,0,0,633,169,6917,503,7420,0.0200864,0.109117,-0.993826,0
6257,0,0,0,0,777,196,7230,388,7618,0.0259745,0.095476,-0.995093,0
6265,0,0,0,0,833,207,7305,425,7730,0.0200813,0.0680902,-0.997477,0
6346,0,0,0,0,870,228,7444,480,7924,0.0564368,0.053367,-0.996979,0
6433,0,0,0,0,947,240,7620,458,8078,0.026621,0.065271,-0.997512,0
6618,0,0,0,0,983,255,7856,484,8340,0.0314367,0.0361156,-0.998853,0
6628,0,0,0,0,1071,259,7958,519,8477,0.0331684,0.0607444,-0.997602,0
6810,0,0,0,0,1012,261,8083,503,8586,0.016104,0.0515331,-0.998541,0
6739,0,0,0,0,1045,265,8049,482,8531,0.0131274,0.0576773,-0.998249,0
6766,0,0,0,0,1040,275,8081,513,8594,0.00737308,0.0563827,-0.998382,0
6032,0,0,0,0,714,180,6926,411,7337,0.0133554,0.0548469,-0.998405,0
6050,0,0,0,0,1046,255,7351,536,7887,0.0323064,0.0742081,-0.996719,0
6933,0,0,0,0,1244,322,8499,640,9139,0.0431487,0.142084,-0.988914,0
3880,0,0,0,0,660,154,4694,295,4989,0.0455539,0.131407,-0.990281,0
2737,0,0,0,0,447,111,3295,203,3498,0.0258142,0.0896394,-0.99564,0
3102,0,0,0,0,784,148,4034,289,4323,0.0305818,0.0953281,-0.994976,0
7240,0,0,0,0,1371,349,8960,674,9634,0.0264839,0.102818,-0.994348,0
7364,0,0,0,0,1449,346,9159,683,9842,0.00801797,0.199754,-0.979813,0
3895,0,0,0,0,711,172,4778,279,5057,-0.00171146,0.139482,-0.990223,0
2732,0,0,0,0,542,131,3405,270,3675,0.00778739,0.0946085,-0.995484,0
7134,0,0,0,0,1362,359,8855,692,9547,0.0111458,0.105317,-0.994376,0
5885,0,0,0,0,894,216,6995,558,7553,0.00218673,0.0997305,-0.995012,0
3543,0,0,0,0,703,162,4408,493,4901,-0.00088856,0.0858781,-0.996305,0
6949,0,0,0,0,1346,328,8623,1094,9717,-0.00576458,0.101081,-0.994862,0
8856,0,0,0,0,1985,429,11270,1082,12352,-0.00461718,0.122333,-0.992478,0
4087,0,0,0,0,686,162,4935,673,5608,-0.00801005,0.0926082,-0.99567,0
7252,0,0,0,0,1363,331,8946,1415,10361,0.00572204,0.093961,-0.995559,0
7508,0,0,0,0,1381,352,9241,1536,10777,0.0116682,0.0906122,-0.995818,0
7457,0,0,0,0,1368,373,9198,1183,10381,0.0172558,0.0743076,-0.997086,0
4796,0,0,0,0,891,211,5898,958,6856,0.0118826,0.0570125,-0.998303,0
7318,0,0,0,0,1366,311,8995,1492,10487,0.01502,0.100325,-0.994841,0
7222,0,0,0,0,1270,327,8819,1318,10137,0.00392675,0.100332,-0.994946,0
6327,0,0,0,0,1112,275,7714,1037,8751,0.00841495,0.0980479,-0.995146,0
7076,0,0,0,0,1299,345,8720,1091,9811,0.00987355,0.116305,-0.993164,0
6924,0,0,0,0,1164,227,8315,698,9013,-0.00124653,0.126733,-0.991936,0
4643,0,0,0,0,832,203,5678,674,6352,-0.0116542,0.11452,-0.993353,0
7053,0,0,0,0,1304,306,8663,952,9615,-0.0116151,0.131533,-0.991244,0
7014,0,0,0,0,1251,306,8571,938,9509,-0.0135497,0.132757,-0.991056,0
6131,0,0,0,0,817,206,7154,625,7779,-0.0207541,0.12325,-0.992159,0
5479,0,0,0,0,970,242,6691,646,7337,-0.0222023,0.133431,-0.990809,0
6857,0,0,0,0,1250,313,8420,827,9247,-0.0169303,0.148522,-0.988764,0
7981,0,0,0,0,1449,371,9801,850,10651,-0.0138559,0.168642,-0.98558,0
6992,0,0,0,0,1329,320,8641,758,9399,-0.00214211,0.158031,-0.987432,0
6969,0,0,0,0,1384,344,8697,795,9492,0.00941286,0.171097,-0.985209,0
6767,0,0,0,0,1416,351,8534,834,9368,0.0160172,0.178219,-0.98386,0
6840,0,0,0,0,1471,357,8668,673,9341,0.0295742,0.219439,-0.975178,0
6645,0,0,0,0,1461,357,8463,742,9205,0.016806,0.199506,-0.979752,0
6617,0,0,0,0,1480,402,8499,710,9209,0.0149001,0.234622,-0.971972,0
6746,0,0,0,0,1540,407,8693,750,9443,0.00941586,0.246757,-0.969032,0
6647,0,0,0,0,1532,378,8557,708,9265,0.00126889,0.2497,-0.968322,0
6622,0,0,0,0,1491,407,8520,720,9240,-0.0109301,0.272725,-0.96203,0
6668,0,0,0,0,1483,360,8511,791,9302,-0.0147747,0.226845,-0.973819,0
6946,0,0,0,0,1410,349,8705,940,9645,-0.0158878,0.219678,-0.975443,0
7016,0,0,0,0,1387,356,8759,1103,9862,-0.0168061,0.236006,-0.971606,0
6951,0,0,0,0,1347,334,8632,1198,9830,-0.0120355,0.240088,-0.970677,0
4707,0,0,0,0,902,215,5824,542,6366,-0.0023047,0.199784,-0.979837,0
7472,0,0,0,0,1656,348,9476,702,10178,-0.00890005,0.205725,-0.978569,0
7191,0,0,0,0,1466,371,9028,785,9813,-0.00442476,0.192114,-0.981363,0
7224,0,0,0,0,1593,375,9192,844,10036,0.00543045,0.173116,-0.984886,0
7210,0,0,0,0,1668,407,9285,900,10185,0.00229271,0.159044,-0.987269,0
7071,0,0,0,0,1630,394,9095,798,9893,0.00067301,0.145491,-0.989359,0
7956,0,0,0,0,1750,457,10163,774,10937,0.00395622,0.1243,-0.992237,0
6907,0,0,0,0,1608,376,8891,678,9569,0.00787471,0.11411,-0.993437,0
6974,0,0,0,0,1561,392,8927,633,9560,0.00469976,0.107526,-0.994191,0
6865,0,0,0,0,1527,395,8787,694,9481,0.00486337,0.0983349,-0.995142,0
4508,0,0,0,0,997,245,5750,493,6243,0.00634446,0.0740583,-0.997234,0
4499,0,0,0,0,1008,246,5753,517,6270,0.00541586,0.0582479,-0.998287,0
6898,0,0,0,0,1471,364,8733,756,9489,0.00491158,0.0498265,-0.998746,0
6865,0,0,0,0,1483,371,8719,703,9422,0.00819418,0.0483071,-0.998799,0
6775,0,0,0,0,1484,358,8617,791,9408,0.0143376,0.0640093,-0.997846,0
7022,0,0,0,0,1477,362,8861,839,9700,0.0148138,0.0991305,-0.994964,0
7633,0,0,0,0,1459,257,9349,509,9858,0.017975,0.113647,-0.993359,0
4458,0,0,0,0,953,252,5663,439,6102,0.00807762,0.131924,-0.991227,0
7020,0,0,0,0,1506,383,8909,618,9527,0.0143994,0.165139,-0.986165,0
6721,0,0,0,0,1495,390,8606,795,9401,0.0266055,0.165434,-0.985862,0
6547,0,0,0,0,1362,344,8253,591,8844,0.0245329,0.155728,-0.987495,0
6683,0,0,0,0,1397,382,8462,828,9290,0.0178937,0.159866,-0.986976,0
6677,0,0,0,0,1344,339,8360,593,8953,-0.00336981,0.138498,-0.990357,0
6673,0,0,0,0,1300,332,8305,738,9043,0.000376789,0.128024,-0.991771,0
6554,0,0,0,0,1273,318,8145,673,8818,0.00843862,0.114018,-0.993443,0
7532,0,0,0,0,1356,313,9201,715,9916,0.00762392,0.174241,-0.984674,0
6558,0,0,0,0,1175,294,8027,703,8730,0.00904692,0.159195,-0.987206,0
4173,0,0,0,0,533,134,4840,334,5174,0.0135823,0.129911,-0.991433,0
3259,0,0,0,0,480,119,3858,360,4218,0.0147727,0.115648,-0.99318,0
6337,0,0,0,0,851,220,7408,711,8119,0.0116847,0.129931,-0.991454,0
6319,0,0,0,0,754,190,7263,670,7933,0.0114346,0.117152,-0.993048,0
6263,0,0,0,0,679,180,7122,632,7754,0.00967792,0.111492,-0.993718,0
6848,0,0,0,0,622,162,7632,650,8282,0.00970238,0.121769,-0.992511,0
6338,0,0,0,0,605,162,7105,643,7748,0.0148512,0.118792,-0.992808,0
6368,0,0,0,0,695,168,7231,655,7886,0.006345,0.13997,-0.990135,0
6373,0,0,0,0,723,185,7281,736,8017,0.013441,0.121995,-0.99244,0
6335,0,0,0,0,1152,257,7744,754,8498,0.0208304,0.126371,-0.991764,0
6568,0,0,0,0,840,218,7626,550,8176,0.0205394,0.118065,-0.992793,0
6560,0,0,0,0,922,231,7713,611,8324,0.0268331,0.100086,-0.994617,0
8365,0,0,0,0,1005,246,9616,611,10227,0.0229076,0.113508,-0.993273,0
4408,0,0,0,0,658,165,5231,407,5638,0.0239503,0.0929269,-0.995385,0
6692,0,0,0,0,1193,278,8163,600,8763,0.0184665,0.102684,-0.994543,0
6652,0,0,0,0,1039,261,7952,598,8550,0.0170383,0.141771,-0.989753,0
6690,0,0,0,0,1069,274,8033,719,8752,-0.00289792,0.154488,-0.98799,0
4272,0,0,0,0,548,142,4962,316,5278,0.0275028,0.0940673,-0.995186,0
4866,0,0,0,0,810,207,5883,439,6322,0.0299208,0.130053,-0.991055,0
4884,0,0,0,0,834,208,5926,437,6363,0.0266226,0.115683,-0.992929,0
6660,0,0,0,0,1116,279,8055,718,8773,0.0341861,0.113905,-0.992903,0
5811,0,0,0,0,987,247,7045,568,7613,0.0252302,0.133253,-0.990761,0
7647,0,0,0,0,1436,313,9396,666,10062,0.032281,0.147542,-0.988529,0
4272,0,0,0,0,655,166,5093,445,5538,0.0310632,0.16051,-0.986545,0
6846,0,0,0,0,1058,265,8169,709,8878,0.0208041,0.0976806,-0.995,0
7262,0,0,0,0,1081,263,8606,761,9367,0.0308758,0.0952361,-0.994976,0
7423,0,0,0,0,1077,268,8768,957,9725,0.00779931,0.0990334,-0.995054,0
6875,0,0,0,0,1228,322,8425,1217,9642,0.0424794,0.0691425,-0.996702,0
4596,0,0,0,0,810,182,5588,976,6564,0.00210997,-0.0432682,-0.999061,0
8376,0,0,0,0,1256,297,9929,2260,12189,-0.00496994,0.0890702,-0.996013,0
7106,0,0,0,0,1319,308,8733,1275,10008,0.0117713,-0.0298713,-0.999484,0
7408,0,0,0,0,1392,325,9125,2571,11696,0.0267317,0.167538,-0.985503,0
5353,0,0,0,0,916,217,6486,741,7227,0.025743,0.0258947,-0.999333,0
3541,0,0,0,0,681,161,4383,1026,5409,0.0267928,-0.0397588,-0.99885,0
3313,0,0,0,0,617,149,4079,1304,5383,0.0191557,0.00914677,-0.999775,0
7319,0,0,0,0,1271,305,8895,2088,10983,0.00283715,0.0960073,-0.995377,0
7402,0,0,0,0,1072,203,8677,899,9576,-0.00907934,0.123527,-0.9923,0
4663,0,0,0,0,1098,241,6002,834,6836,-0.0164784,0.111471,-0.993631,0
4528,0,0,0,0,727,179,5434,727,6161,-0.0294511,0.125268,-0.991686,0
7011,0,0,0,0,1414,312,8737,957,9694,-0.0334986,0.119033,-0.992325,0
7106,0,0,0,0,1111,274,8491,936,9427,-0.0283555,0.141323,-0.989557,0
6924,0,0,0,0,1133,273,8330,896,9226,-0.0385232,0.143233,-0.988939,0
4601,0,0,0,0,737,229,5567,555,6122,-0.0226806,0.141225,-0.989718,0
6980,0,0,0,0,1095,263,8338,812,9150,-0.0185973,0.145088,-0.989244,0
6698,0,0,0,0,1126,314,8138,802,8940,-0.0168,0.179849,-0.983551,0
4357,0,0,0,0,709,186,5252,511,5763,-0.00929724,0.173689,-0.984757,0
6782,0,0,0,0,1063,271,8116,737,8853,-0.0041532,0.192735,-0.981242,0
6944,0,0,0,0,754,188,7886,454,8340,0.00476621,0.209568,-0.977783,0
4401,0,0,0,0,817,202,5420,478,5898,0.0125066,0.204743,-0.978736,0
6666,0,0,0,0,1380,324,8370,817,9187,0.00685275,0.22459,-0.974429,0
6854,0,0,0,0,1393,339,8586,807,9393,0.0013972,0.248491,-0.968633,0
6692,0,0,0,0,1508,357,8557,699,9256,-0.00624967,0.239405,-0.9709,0
6457,0,0,0,0,1859,350,8666,751,9417,-0.00522928,0.20995,-0.977698,0
6546,0,0,0,0,1361,353,8260,710,8970,-0.00567493,0.191815,-0.981415,0
6438,0,0,0,0,1399,341,8178,778,8956,-0.00323147,0.17073,-0.985313,0
6549,0,0,0,0,1371,331,8251,733,8984,-0.00454201,0.155205,-0.987872,0
6489,0,0,0,0,1357,330,8176,695,8871,-0.00611104,0.148942,-0.988827,0
6421,0,0,0,0,1332,330,8083,727,8810,-0.00622231,0.149806,-0.988696,0
6640,0,0,0,0,1350,319,8309,716,9025,-0.00992685,0.141903,-0.989831,0
6488,0,0,0,0,1351,354,8193,745,8938,-0.00823711,0.134845,-0.990833,0
6605,0,0,0,0,1276,323,8204,838,9042,-0.00438271,0.13079,-0.9914,0
6460,0,0,0,0,1252,307,8019,805,8824,-0.000821931,0.130367,-0.991465,0
6722,0,0,0,0,1739,335,8796,601,9397,-0.000906051,0.127303,-0.991863,0
5374,0,0,0,0,876,217,6467,490,6957,-0.00317032,0.124949,-0.992158,0
3190,0,0,0,0,606,145,3941,374,4315,-0.00536543,0.114787,-0.993376,0
6441,0,0,0,0,1348,298,8087,733,8820,-0.0110604,0.109557,-0.993919,0
6530,0,0,0,0,1183,304,8017,708,8725,-0.0113217,0.0989409,-0.995029,0
6455,0,0,0,0,1179,290,7924,738,8662,-0.00775463,0.0944124,-0.995503,0
6465,0,0,0,0,1245,291,8001,751,8752,-0.00628988,0.0924365,-0.995699,0
6442,0,0,0,0,1217,292,7951,742,8693,-0.00545743,0.0998692,-0.994986,0
6588,0,0,0,0,1329,297,8214,782,8996,-0.00669125,0.105778,-0.994367,0
6643,0,0,0,0,1226,298,8167,803,8970,-0.00728187,0.108822,-0.994035,0
6855,0,0,0,0,1392,319,8566,874,9440,-0.00471587,0.108047,-0.994135,0
6510,0,0,0,0,1226,293,8029,766,8795,-0.00348069,0.104275,-0.994542,0
7757,0,0,0,0,1185,288,9230,835,10065,-0.00496675,0.10161,-0.994812,0
6509,0,0,0,0,1188,293,7990,799,8789,-0.00627819,0.102617,-0.994701,0
5899,0,0,0,0,803,190,6892,507,7399,-0.00984184,0.101737,-0.994763,0
6589,0,0,0,0,1212,334,8135,926,9061,-0.00556431,0.11261,-0.993624,0
6572,0,0,0,0,1183,288,8043,775,8818,-0.00565374,0.112543,-0.993631,0
7486,0,0,0,0,1172,194,8852,562,9414,-0.0059781,0.109099,-0.994013,0
4388,0,0,0,0,797,192,5377,534,5911,-0.00606209,0.109589,-0.993958,0
6757,0,0,0,0,1184,288,8229,776,9005,-0.00840409,0.105175,-0.994418,0
6514,0,0,0,0,1175,286,7975,800,8775,-0.00817091,0.106203,-0.994311,0
6493,0,0,0,0,1210,291,7994,743,8737,-0.0087507,0.105509,-0.99438,0
6913,0,0,0,0,1169,317,8399,754,9153,-0.0103459,0.106974,-0.994208,0
6420,0,0,0,0,1301,288,8009,757,8766,-0.00873598,0.107065,-0.994214,0
6520,0,0,0,0,1186,299,8005,848,8853,-0.0102488,0.111532,-0.993708,0
6353,0,0,0,0,1187,282,7822,756,8578,-0.00984905,0.115767,-0.993228,0
6510,0,0,0,0,1186,286,7982,769,8751,-0.0108686,0.115093,-0.993295,0
6875,0,0,0,0,1145,285,8305,760,9065,-0.0117239,0.112263,-0.993609,0
6652,0,0,0,0,1156,285,8093,745,8838,-0.0105142,0.115064,-0.993302,0
6527,0,0,0,0,1182,280,7989,767,8756,-0.00896992,0.118957,-0.992859,0
6540,0,0,0,0,1128,278,7946,844,8790,-0.00737374,0.120812,-0.992648,0
6465,0,0,0,0,1142,277,7884,718,8602,-0.00670796,0.11956,-0.992804,0
7763,0,0,0,0,1587,331,9681,774,10455,-0.00734691,0.122699,-0.992417,0
6399,0,0,0,0,1268,296,7963,830,8793,-0.00965075,0.118333,-0.992927,0
6405,0,0,0,0,1587,318,8310,858,9168,-0.00903282,0.114081,-0.99343,0
7379,0,0,0,0,1099,305,8783,750,9533,-0.00551355,0.109078,-0.994018,0
6515,0,0,0,0,1106,272,7893,711,8604,-0.00411679,0.11114,-0.993796,0
6742,0,0,0,0,1590,325,8657,816,9473,-0.00656679,0.106717,-0.994268,0
6654,0,0,0,0,1104,275,8033,797,8830,-0.00889142,0.105502,-0.994379,0
6568,0,0,0,0,1110,280,7958,814,8772,-0.0119603,0.0972378,-0.995189,0
7021,0,0,0,0,1646,354,9021,959,9980,-0.0113013,0.101,-0.994822,0
6485,0,0,0,0,1121,266,7872,723,8595,-0.0111372,0.100993,-0.994825,0
6503,0,0,0,0,1159,275,7937,735,8672,-0.01119,0.10012,-0.994912,0
6510,0,0,0,0,1147,278,7935,763,8698,-0.0100105,0.0996929,-0.994968,0
6546,0,0,0,0,1134,276,7956,773,8729,-0.00852288,0.101079,-0.994842,0
6618,0,0,0,0,1173,277,8068,741,8809,-0.00976299,0.101767,-0.99476,0
6686,0,0,0,0,1204,275,8165,766,8931,-0.0108636,0.103559,-0.994564,0
6658,0,0,0,0,1654,321,8633,779,9412,-0.00933191,0.10714,-0.9942,0
6728,0,0,0,0,1177,279,8184,806,8990,-0.00933785,0.104427,-0.994489,0
6572,0,0,0,0,1132,291,7995,778,8773,-0.00875584,0.108604,-0.994047,0
6483,0,0,0,0,1252,294,8029,774,8803,-0.0074563,0.10936,-0.993974,0
6495,0,0,0,0,1139,277,7911,746,8657,-0.00794155,0.109716,-0.993931,0
7458,0,0,0,0,1339,305,9102,740,9842,-0.00963155,0.110822,-0.993794,0
6607,0,0,0,0,1141,283,8031,752,8783,-0.00915658,0.103906,-0.994545,0
7282,0,0,0,0,1240,316,8838,775,9613,-0.00858522,0.108296,-0.994082,0
7999,0,0,0,0,1141,283,9423,789,10212,-0.00664286,0.109588,-0.993955,0
7148,0,0,0,0,1230,282,8660,798,9458,-0.00839464,0.111517,-0.993727,0
6716,0,0,0,0,1295,308,8319,818,9137,-0.0111211,0.11181,-0.993667,0
6508,0,0,0,0,1199,281,7988,762,8750,-0.0110319,0.114881,-0.993318,0
6410,0,0,0,0,1157,281,7848,778,8626,-0.0099799,0.116394,-0.993153,0
6346,0,0,0,0,1173,288,7807,736,8543,-0.0107789,0.112266,-0.99362,0
6510,0,0,0,0,1159,273,7942,734,8676,-0.0110481,0.11186,-0.993663,0
6583,0,0,0,0,1525,356,8464,936,9400,-0.0089564,0.119141,-0.992837,0
6496,0,0,0,0,1163,277,7936,748,8684,-0.010124,0.115782,-0.993223,0
6422,0,0,0,0,1178,315,7915,773,8688,-0.0108557,0.115133,-0.993291,0
7237,0,0,0,0,1238,283,8758,781,9539,-0.0107137,0.11518,-0.993287,0
6594,0,0,0,0,1138,282,8014,1028,9042,-0.0100363,0.115336,-0.993276,0
6661,0,0,0,0,1123,277,8061,815,8876,-0.0107756,0.113613,-0.993467,0
6743,0,0,0,0,1223,276,8242,775,9017,-0.00802075,0.110906,-0.993799,0
6767,0,0,0,0,1187,285,8239,742,8981,-0.0098641,0.114358,-0.993391,0
6918,0,0,0,0,1183,313,8414,827,9241,-0.00982242,0.115802,-0.993224,1
7359,0,0,0,0,791,186,8336,501,8837,-0.0070234,0.116248,-0.993195,1
4294,0,0,0,0,742,178,5214,532,5746,-0.00826823,0.114517,-0.993387,1
7459,0,0,0,0,1227,292,8978,681,9659,-0.0139824,0.112852,-0.993513,1
6485,0,0,0,0,1139,326,7950,683,8633,-0.0185054,0.102162,-0.994596,1
6630,0,0,0,0,1083,271,7984,607,8591,-0.0164181,0.106498,-0.994177,1
6390,0,0,0,0,1108,277,7775,587,8362,-0.0105377,0.108411,-0.99405,1
6450,0,0,0,0,1098,282,7830,632,8462,-0.0077118,0.110561,-0.993839,1
6496,0,0,0,0,1082,256,7834,697,8531,-0.00820181,0.114791,-0.993356,1
6405,0,0,0,0,1091,261,7757,694,8451,-0.00816296,0.113608,-0.993492,1
6712,0,0,0,0,1096,266,8074,689,8763,-0.00902113,0.116826,-0.993111,1
6293,0,0,0,0,734,171,7198,586,7784,-0.0117154,0.115855,-0.993197,1
6549,0,0,0,0,1106,264,7919,601,8520,-0.0115192,0.115401,-0.993252,1
6399,0,0,0,0,1062,255,7716,651,8367,-0.00843612,0.114533,-0.993384,1
6592,0,0,0,0,1132,260,7984,706,8690,-0.00619643,0.112788,-0.9936,1
8893,0,0,0,0,1506,257,10656,653,11309,-0.00453131,0.114352,-0.99343,1
6784,0,0,0,0,1350,292,8426,628,9054,-0.00444093,0.115602,-0.993286,1
6558,0,0,0,0,1055,256,7869,604,8473,-0.00724653,0.129275,-0.991582,1
6590,0,0,0,0,1047,292,7929,685,8614,-0.0051853,0.118833,-0.992901,1
6460,0,0,0,0,1042,256,7758,707,8465,-0.00566338,0.118538,-0.992933,1
6531,0,0,0,0,1073,272,7876,684,8560,-0.00731816,0.119174,-0.992846,1
6514,0,0,0,0,1039,251,7804,675,8479,-0.00663332,0.118193,-0.992969,1
6680,0,0,0,0,1099,258,8037,668,8705,-0.00824992,0.133537,-0.991009,1
6419,0,0,0,0,1064,244,7727,667,8394,-0.00611135,0.131866,-0.991249,1
6506,0,0,0,0,1040,264,7810,618,8428,-0.00413179,0.145773,-0.989309,1
7598,0,0,0,0,1012,246,8856,674,9530,0.00224471,0.125096,-0.992142,1
6766,0,0,0,0,1144,251,8161,659,8820,0.00233301,0.126663,-0.991943,1
6627,0,0,0,0,1051,244,7922,626,8548,0.000707277,0.123207,-0.992381,1
6574,0,0,0,0,1044,244,7862,651,8513,0.000545332,0.123834,-0.992303,1
6714,0,0,0,0,1021,242,7977,728,8705,0.00196761,0.129963,-0.991517,1
6830,0,0,0,0,1054,245,8129,662,8791,0.00354112,0.133576,-0.991032,1
6747,0,0,0,0,1403,285,8435,789,9224,0.00664418,0.138457,-0.990346,1
6541,0,0,0,0,989,235,7765,707,8472,0.00597783,0.140945,-0.989999,1
6480,0,0,0,0,1414,263,8157,864,9021,0.00217035,0.134825,-0.990867,1
6694,0,0,0,0,953,227,7874,946,8820,0.0035025,0.106749,-0.99428,1
6701,0,0,0,0,984,231,7916,750,8666,0.00352614,0.0980967,-0.995171,1
6976,0,0,0,0,1118,232,8326,464,8790,0.00219885,0.113591,-0.993525,1
6727,0,0,0,0,975,228,7930,697,8627,0.00722478,0.128134,-0.991731,1
6417,0,0,0,0,1006,276,7699,851,8550,0.00914488,0.131805,-0.991234,1
6544,0,0,0,0,987,226,7757,884,8641,0.00439691,0.138591,-0.99034,1
6610,0,0,0,0,932,215,7757,966,8723,0.00500542,0.156279,-0.9877,1
6707,0,0,0,0,911,221,7839,1009,8848,0.00747193,0.170114,-0.985396,1
6774,0,0,0,0,909,214,7897,1068,8965,0.00895713,0.164172,-0.986391,1
6556,0,0,0,0,921,219,7696,894,8590,0.0222389,0.214364,-0.976501,1
5927,0,0,0,0,916,167,7010,615,7625,0.0176074,0.173372,-0.984699,1
3302,0,0,0,0,511,122,3935,401,4336,0.00834082,0.143971,-0.989547,1
6785,0,0,0,0,1126,254,8165,820,8985,-9.57133e-05,0.151889,-0.988398,1
6953,0,0,0,0,1092,260,8305,787,9092,-0.000877878,0.140572,-0.99007,1
7642,0,0,0,0,1339,273,9254,857,10111,0.00087653,0.131714,-0.991287,1
6953,0,0,0,0,1199,277,8429,808,9237,0.011409,0.129881,-0.991464,1
6829,0,0,0,0,1215,290,8334,805,9139,0.0190185,0.128847,-0.991482,1
4564,0,0,0,0,849,204,5617,545,6162,0.0254755,0.123928,-0.991964,1
6067,0,0,0,0,1137,281,7485,672,8157,0.0268007,0.132801,-0.99078,1
6779,0,0,0,0,1307,342,8428,690,9118,0.0287709,0.132135,-0.990814,1
7013,0,0,0,0,1345,331,8689,673,9362,0.0231478,0.12555,-0.991817,1
6610,0,0,0,0,1731,379,8720,814,9534,0.0139743,0.142743,-0.989661,1
6550,0,0,0,0,1263,327,8140,631,8771,0.00342829,0.132961,-0.991115,1
6669,0,0,0,0,1181,287,8137,617,8754,0.00271513,0.124511,-0.992215,1
6575,0,0,0,0,1222,330,8127,606,8733,0.000505626,0.122291,-0.992494,1
6672,0,0,0,0,1132,285,8089,631,8720,-0.00997543,0.130454,-0.991404,1
6609,0,0,0,0,1273,284,8166,616,8782,7.95068e-05,0.127978,-0.991777,1
7402,0,0,0,0,1264,289,8955,748,9703,0.0148306,0.133291,-0.990966,1
6521,0,0,0,0,1133,342,7996,969,8965,0.0248586,0.118674,-0.992622,1
6671,0,0,0,0,1111,273,8055,752,8807,0.0223199,0.120533,-0.992458,1
6544,0,0,0,0,1095,269,7908,757,8665,0.0111525,0.126344,-0.991924,1
6721,0,0,0,0,1054,266,8041,736,8777,0.0067867,0.0958269,-0.995375,1
7421,0,0,0,0,910,227,8558,835,9393,0.0175787,0.144983,-0.989278,1
6407,0,0,0,0,654,159,7220,828,8048,0.00880661,0.149345,-0.988746,1
6311,0,0,0,0,536,135,6982,946,7928,0.0391611,0.18088,-0.982725,1
6034,0,0,0,0,503,126,6663,838,7501,0.0366254,0.144849,-0.988776,1
6457,0,0,0,0,543,141,7141,1079,8220,0.0307357,0.171635,-0.984681,1
6299,0,0,0,0,718,174,7191,825,8016,0.0404755,0.150511,-0.987779,1
6675,0,0,0,0,792,200,7667,926,8593,0.0388517,0.146558,-0.988439,1
7348,0,0,0,0,956,228,8532,1175,9707,0.0310661,0.130736,-0.99093,1
6542,0,0,0,0,939,233,7714,994,8708,0.0339474,0.153471,-0.98757,1
7163,0,0,0,0,1027,266,8456,631,9087,0.0488028,0.121661,-0.991371,1
4442,0,0,0,0,671,168,5281,478,5759,0.0443432,0.127051,-0.990905,1
6863,0,0,0,0,1039,276,8178,921,9099,0.0404942,0.169679,-0.984667,1
7822,0,0,0,0,1090,253,9165,931,10096,0.044128,0.192718,-0.980261,1
6651,0,0,0,0,952,232,7835,872,8707,0.0890848,0.0403485,-0.995206,1
7179,0,0,0,0,1121,235,8535,1024,9559,0.0447294,0.0608911,-0.997142,1
7394,0,0,0,0,919,217,8530,796,9326,0.034231,0.132227,-0.990628,1
6781,0,0,0,0,910,205,7896,1896,9792,0.0273013,0.390584,-0.920162,1
4428,0,0,0,0,591,127,5146,775,5921,0.106505,0.331329,-0.937485,1
6542,0,0,0,0,820,188,7550,1200,8750,0.101945,0.181779,-0.978041,1
6661,0,0,0,0,864,185,7710,1732,9442,0.0715843,0.084448,-0.993853,1
6726,0,0,0,0,818,191,7735,1532,9267,-0.00569127,-0.0439205,-0.999019,1
7813,0,0,0,0,924,210,8947,4007,12954,0.00431595,0.0800401,-0.996782,1
7113,0,0,0,0,951,219,8283,926,9209,0.0068888,-0.0584687,-0.998265,1
6022,0,0,0,0,896,206,7124,2657,9781,0.00174526,-0.0336222,-0.999433,1
6382,0,0,0,0,947,216,7545,1525,9070,-0.00988604,-0.0429155,-0.99903,1
6081,0,0,0,0,907,213,7201,1249,8450,-0.0110211,-0.0525177,-0.998559,1
6028,0,0,0,0,905,238,7171,1524,8695,-0.0224129,-0.0518428,-0.998404,1
6059,0,0,0,0,887,218,7164,1596,8760,-0.0107888,-0.0458022,-0.998892,1
5993,0,0,0,0,886,242,7121,1258,8379,-0.0122195,-0.0803327,-0.996693,1
6028,0,0,0,0,881,209,7118,947,8065,-0.00788244,-0.0602077,-0.998155,1
5809,0,0,0,0,793,192,6794,874,7668,-0.00451991,-0.0207573,-0.999774,1
6638,0,0,0,0,913,205,7756,855,8611,-0.01445,-0.0132407,-0.999808,1
6553,0,0,0,0,827,222,7602,843,8445,-0.0347668,-0.0178894,-0.999235,1
6911,0,0,0,0,838,205,7954,635,8589,-0.0305992,0.0252411,-0.999213,1
6750,0,0,0,0,972,199,7921,578,8499,-0.0350334,0.0269105,-0.999024,1
6355,0,0,0,0,812,198,7365,792,8157,-0.0241993,0.0596514,-0.997926,1
6642,0,0,0,0,788,203,7633,922,8555,-0.0171587,0.0735867,-0.997141,1
6486,0,0,0,0,936,255,7677,969,8646,-0.0120092,0.101612,-0.994752,1
6676,0,0,0,0,947,255,7878,712,8590,-0.00870414,0.0829342,-0.996517,1
7009,0,0,0,0,1076,265,8350,771,9121,-0.0132826,0.0909181,-0.99577,1
6474,0,0,0,0,1041,262,7777,645,8422,-0.0156591,0.0723062,-0.99726,1
6251,0,0,0,0,1150,265,7666,594,8260,-0.0150861,0.0711684,-0.99735,1
6550,0,0,0,0,1316,299,8165,583,8748,-0.0141971,0.0520008,-0.998546,1
6163,0,0,0,0,1095,257,7515,527,8042,-0.0120826,0.0381595,-0.999199,1
6868,0,0,0,0,1052,275,8195,613,8808,-0.0112045,0.0327219,-0.999402,1
6246,0,0,0,0,1021,248,7515,584,8099,-0.0137401,0.0448233,-0.9989,1
6176,0,0,0,0,1023,239,7438,836,8274,-0.0169342,0.0524664,-0.998479,1
6177,0,0,0,0,914,225,7316,669,7985,-0.0354547,0.060834,-0.997518,1
6320,0,0,0,0,877,214,7411,786,8197,-0.0394858,0.0556024,-0.997672,1
4331,0,0,0,0,819,159,5309,704,6013,-0.0268031,0.055697,-0.998088,1
6474,0,0,0,0,883,233,7590,1533,9123,-0.00567208,0.174693,-0.984607,1
6733,0,0,0,0,950,218,7901,933,8834,0.0059224,0.0694757,-0.997566,1
6513,0,0,0,0,818,195,7526,1375,8901,-0.00511356,0.18309,-0.983083,1
6527,0,0,0,0,861,203,7591,774,8365,-0.0231334,0.0319261,-0.999222,1
7443,0,0,0,0,1011,224,8678,1331,10009,-0.029916,0.171841,-0.98467,1
6776,0,0,0,0,956,232,7964,744,8708,-0.0243078,0.00879073,-0.999666,1
6787,0,0,0,0,1034,241,8062,877,8939,-0.0170741,0.0353429,-0.999229,1
6558,0,0,0,0,1407,318,8283,549,8832,-0.0213995,0.0398118,-0.998978,1
6360,0,0,0,0,1027,248,7635,403,8038,-0.0205574,0.0525201,-0.998408,1
6414,0,0,0,0,959,235,7608,395,8003,-0.018803,0.174869,-0.984412,1
6335,0,0,0,0,970,237,7542,433,7975,0.0182993,0.120795,-0.992509,1
4016,0,0,0,0,507,120,4643,239,4882,-0.0169029,0.0587027,-0.998132,1
4773,0,0,0,0,795,191,5759,410,6169,0.00613291,0.0138914,-0.999885,1
6346,0,0,0,0,974,245,7565,526,8091,-0.0230835,0.0802173,-0.99651,1
6490,0,0,0,0,956,268,7714,580,8294,-0.011416,0.0837046,-0.996425,1
6398,0,0,0,0,937,234,7569,584,8153,-0.0175598,0.0765044,-0.996915,1
6272,0,0,0,0,920,213,7405,865,8270,-0.0230249,0.0937866,-0.995326,1
6766,0,0,0,0,759,234,7759,841,8600,0.0034387,0.0286583,-0.999583,1
6125,0,0,0,0,668,166,6959,1095,8054,-0.00661575,0.0295669,-0.999541,1
7784,0,0,0,0,606,158,8548,1139,9687,-0.0660707,0.0665893,-0.995591,1
6281,0,0,0,0,582,169,7032,1067,8099,-0.0805514,0.0655031,-0.994596,1
6428,0,0,0,0,534,158,7120,1213,8333,-0.0844338,0.0753522,-0.993576,1
7243,0,0,0,0,618,174,8035,1099,9134,-0.0841869,0.104826,-0.990921,1
6406,0,0,0,0,685,173,7264,966,8230,-0.0756524,0.0828206,-0.993689,1
6603,0,0,0,0,770,250,7623,852,8475,-0.0893086,0.0759985,-0.9931,1
6730,0,0,0,0,896,218,7844,713,8557,-0.117256,0.0653839,-0.990947,1
6763,0,0,0,0,906,251,7920,718,8638,-0.125219,0.0695188,-0.989691,1
6670,0,0,0,0,952,263,7885,730,8615,-0.114623,0.0912438,-0.98921,1
6386,0,0,0,0,1012,244,7642,837,8479,-0.0727176,0.0255212,-0.997026,1
7091,0,0,0,0,1002,243,8336,1115,9451,-0.0798784,0.0483824,-0.99563,1
6467,0,0,0,0,982,226,7675,1001,8676,-0.0443118,0.0166562,-0.998879,1
4278,0,0,0,0,585,142,5005,1263,6268,-0.0420165,0.0139989,-0.999019,1
6557,0,0,0,0,932,203,7692,2571,10263,-0.0378921,0.105792,-0.993666,1
6563,0,0,0,0,829,201,7593,3070,10663,0.0163602,0.00892803,-0.999826,1
6510,0,0,0,0,805,185,7500,4663,12163,0.0114949,0.108748,-0.994003,1
6612,0,0,0,0,790,176,7578,4945,12523,0.0522648,0.059122,-0.996882,1
6579,0,0,0,0,783,205,7567,1164,8731,0.0124149,-0.028129,-0.999527,1
6717,0,0,0,0,813,191,7721,1149,8870,0.00872019,-0.0286533,-0.999551,1
6502,0,0,0,0,818,192,7512,1253,8765,0.0240561,-0.00735268,-0.999684,1
6658,0,0,0,0,864,240,7762,1341,9103,0.0206901,-0.0158756,-0.99966,1
6534,0,0,0,0,831,193,7558,1439,8997,0.0259732,-0.0346036,-0.999063,1
6533,0,0,0,0,800,232,7565,1382,8947,-0.00723244,0.0523267,-0.998604,1
6568,0,0,0,0,791,187,7546,1905,9451,-0.0180758,0.0389092,-0.999079,1
3279,0,0,0,0,341,85,3705,555,4260,-0.0149251,-0.0124022,-0.999812,1
3415,0,0,0,0,344,84,3843,701,4544,-0.0196036,-0.034275,-0.99922,1
6301,0,0,0,0,576,158,7035,1402,8437,-0.032137,-0.0695268,-0.997062,1
6267,0,0,0,0,510,131,6908,1251,8159,-0.0322118,-0.0775052,-0.996471,1
6650,0,0,0,0,476,126,7252,1439,8691,-0.0410045,-0.0431238,-0.998228,1
6411,0,0,0,0,526,130,7067,1646,8713,-0.0417621,-0.00385322,-0.99912,1
6668,0,0,0,0,559,137,7364,1762,9126,-0.0357974,-0.0244363,-0.99906,1
6159,0,0,0,0,617,151,6927,1344,8271,-0.107771,-0.0695294,-0.991741,1
6713,0,0,0,0,636,190,7539,779,8318,-0.080239,-0.0382457,-0.996042,1
6723,0,0,0,0,466,120,7309,701,8010,-0.0418301,0.0408138,-0.998291,1
3130,0,0,0,0,394,100,3624,403,4027,-0.05982,0.0370184,-0.997523,1
6701,0,0,0,0,898,221,7820,599,8419,-0.0416822,0.056436,-0.997536,1
6657,0,0,0,0,1008,255,7920,575,8495,-0.0778275,0.0646489,-0.994869,1
6224,0,0,0,0,1032,243,7499,438,7937,-0.0377203,0.105763,-0.993676,1
5409,0,0,0,0,846,211,6466,449,6915,-0.00712943,0.0996685,-0.994995,1
6078,0,0,0,0,934,237,7249,460,7709,-0.00631077,0.113622,-0.993504,1
6048,0,0,0,0,914,227,7189,440,7629,-0.0177988,0.103003,-0.994522,1
6022,0,0,0,0,903,218,7143,488,7631,-0.0133505,0.0877013,-0.996057,1
6371,0,0,0,0,847,204,7422,542,7964,-0.00829826,0.0783035,-0.996895,1
6237,0,0,0,0,1147,237,7621,775,8396,-0.0154009,0.0859959,-0.996176,1
6486,0,0,0,0,749,180,7415,832,8247,-0.0339809,0.0760188,-0.996527,1
7594,0,0,0,0,721,170,8485,898,9383,-0.0414377,0.0670347,-0.99689,1
6247,0,0,0,0,677,156,7080,813,7893,-0.028986,0.0368341,-0.998901,1
7221,0,0,0,0,646,156,8023,719,8742,-0.0292395,0.0323248,-0.99905,1
6926,0,0,0,0,852,181,7959,700,8659,-0.0444585,0.0736738,-0.996291,1
6306,0,0,0,0,729,165,7200,738,7938,-0.0312082,0.0501522,-0.998254,1
7625,0,0,0,0,714,168,8507,725,9232,-0.0324443,0.0379181,-0.998754,1
6296,0,0,0,0,732,166,7194,446,7640,-0.0210487,0.030671,-0.999308,1
6291,0,0,0,0,955,200,7446,575,8021,-0.0243645,-8.69956e-05,-0.999703,1
6003,0,0,0,0,655,151,6809,400,7209,-0.00605194,0.0182593,-0.999815,1
5823,0,0,0,0,636,157,6616,412,7028,0.00118799,-0.0296673,-0.999559,1
6400,0,0,0,0,788,192,7380,456,7836,0.0120069,0.0123807,-0.999851,1
5698,0,0,0,0,717,177,6592,455,7047,0.0061634,-0.00512325,-0.999968,1
5714,0,0,0,0,782,194,6690,482,7172,0.0179138,0.123283,-0.99221,1
5654,0,0,0,0,813,199,6666,460,7126,0.0111148,0.0362439,-0.999281,1
5891,0,0,0,0,861,209,6961,488,7449,0.0105051,0.00974294,-0.999897,1
5799,0,0,0,0,877,213,6889,410,7299,0.000978646,0.00122801,-0.999999,1
5919,0,0,0,0,805,203,6927,358,7285,-0.0507149,0.0218358,-0.998474,1
6006,0,0,0,0,750,178,6934,372,7306,-0.0506557,0.0511266,-0.997407,1
7087,0,0,0,0,695,161,7943,359,8302,-0.0531251,0.00109025,-0.998587,1
6064,0,0,0,0,587,138,6789,394,7183,-0.0325784,-0.0117206,-0.9994,1
6357,0,0,0,0,473,124,6954,539,7493,-0.0283933,-0.00495629,-0.999585,1
6530,0,0,0,0,433,114,7077,574,7651,-0.0625881,0.0289176,-0.99762,1
6046,0,0,0,0,471,146,6663,587,7250,-0.0522193,0.0314483,-0.99814,1
6792,0,0,0,0,405,114,7311,626,7937,-0.0779896,0.0368172,-0.996274,1
5862,0,0,0,0,409,109,6380,674,7054,-0.0275709,0.0760741,-0.996721,1
6048,0,0,0,0,449,116,6613,731,7344,-0.0113355,0.022832,-0.999675,1
6170,0,0,0,0,547,147,6864,773,7637,0.00460202,-0.00139065,-0.999988,1
6186,0,0,0,0,608,192,6986,531,7517,0.0104774,0.022688,-0.999688,1
4072,0,0,0,0,430,110,4612,382,4994,0.00882117,0.041352,-0.999106,1
6425,0,0,0,0,707,184,7316,789,8105,0.00961533,0.0389285,-0.999196,1
6868,0,0,0,0,797,211,7876,788,8664,0.0117829,0.0387479,-0.99918,1
5472,0,0,0,0,548,140,6160,455,6615,0.0147294,0.0419669,-0.99901,1
5105,0,0,0,0,699,179,5983,795,6778,0.00763559,0.0240958,-0.99968,1
6455,0,0,0,0,938,237,7630,847,8477,0.00235214,0.0440981,-0.999024,1
6529,0,0,0,0,959,239,7727,1555,9282,-0.00635411,0.0514381,-0.998656,1
6452,0,0,0,0,968,237,7657,1359,9016,-0.0107355,-0.0210921,-0.99972,1
6493,0,0,0,0,970,238,7701,1549,9250,-0.0367613,-0.0123376,-0.999248,1
7293,0,0,0,0,607,153,8053,754,8807,-0.0322697,-0.0347959,-0.998873,1
4252,0,0,0,0,688,178,5118,1242,6360,-0.0274859,-0.062492,-0.997667,1
6315,0,0,0,0,873,212,7400,1355,8755,-0.0214569,-0.0557372,-0.998215,1
6843,0,0,0,0,896,211,7950,1822,9772,-0.0114152,-0.0599093,-0.998139,1
6224,0,0,0,0,849,202,7275,2866,10141,-0.03323,-0.0748514,-0.996641,1
7307,0,0,0,0,826,201,8334,2108,10442,-0.0312258,-0.0594717,-0.997741,1
6436,0,0,0,0,805,229,7470,1522,8992,-0.0325774,-0.0737946,-0.996741,1
3085,0,0,0,0,323,74,3482,1064,4546,-0.0215627,-0.116152,-0.992997,1
2439,0,0,0,0,307,71,2817,922,3739,-0.0214039,-0.11849,-0.992725,1
6326,0,0,0,0,808,189,7323,1819,9142,-0.0119556,-0.109957,-0.993864,1
6502,0,0,0,0,797,212,7511,2668,10179,-0.0345796,-0.116339,-0.992607,1
6523,0,0,0,0,825,185,7533,1869,9402,-0.0386849,-0.102574,-0.993973,1
6842,0,0,0,0,793,225,7860,2284,10144,-0.0401704,-0.0961886,-0.994552,1
4906,0,0,0,0,582,127,5615,2555,8170,-0.020488,-0.116822,-0.992941,1
6639,0,0,0,0,797,180,7616,3271,10887,-0.0135142,-0.0890867,-0.995932,1
7525,0,0,0,0,788,181,8494,2086,10580,0.0230167,-0.0755062,-0.99688,1
7610,0,0,0,0,796,185,8591,1901,10492,0.00729789,-0.0882045,-0.996076,1
6469,0,0,0,0,797,180,7446,1745,9191,0.0114307,-0.0930103,-0.9956,1
6750,0,0,0,0,803,186,7739,1472,9211,0.0114459,-0.0942843,-0.995479,1
6605,0,0,0,0,817,210,7632,1410,9042,0.00839981,-0.0977183,-0.995179,1
4505,0,0,0,0,706,128,5339,935,6274,0.00337511,-0.0996439,-0.995017,1
7595,0,0,0,0,833,182,8610,1311,9921,0.00165602,-0.099456,-0.995041,1
6555,0,0,0,0,789,179,7523,1392,8915,5.06419e-05,-0.0994496,-0.995043,1
6577,0,0,0,0,866,205,7648,1294,8942,-0.00308052,-0.0995768,-0.995025,1
3187,0,0,0,0,396,91,3674,788,4462,-0.00578186,-0.104459,-0.994512,1
6514,0,0,0,0,888,207,7609,1600,9209,-0.00323912,-0.0892345,-0.996005,1
6693,0,0,0,0,786,180,7659,1555,9214,-0.000331816,-0.0878253,-0.996136,1
6417,0,0,0,0,787,189,7393,1487,8880,0.00658392,-0.0846031,-0.996393,1
6517,0,0,0,0,772,181,7470,1519,8989,0.00781261,-0.0807041,-0.996708,1
6441,0,0,0,0,768,175,7384,1590,8974,0.00541397,-0.0848916,-0.996375,1
6525,0,0,0,0,706,179,7410,1815,9225,3.82168e-05,-0.0850911,-0.996373,1
9239,0,0,0,0,836,170,10245,1918,12163,-0.00955794,-0.0922649,-0.995689,1
6356,0,0,0,0,667,163,7186,2229,9415,-0.0142563,-0.0956004,-0.995318,1
4322,0,0,0,0,515,106,4943,1581,6524,-0.00557552,-0.10128,-0.994842,1
4349,0,0,0,0,431,108,4888,1350,6238,-0.00805216,-0.110684,-0.993823,1
4163,0,0,0,0,384,94,4641,1354,5995,-0.00768824,-0.113921,-0.99346,1
5620,0,0,0,0,525,144,6289,1926,8215,-0.00936521,-0.0950916,-0.995424,1
6412,0,0,0,0,549,136,7097,1710,8807,-0.012109,-0.114131,-0.993392,1
6537,0,0,0,0,600,140,7277,1604,8881,-0.00973453,-0.116211,-0.993177,1
6314,0,0,0,0,605,137,7056,1319,8375,-0.00791264,-0.0907351,-0.995844,1
6387,0,0,0,0,547,142,7076,1450,8526,-0.00607661,-0.140346,-0.990084,1
6385,0,0,0,0,561,142,7088,1328,8416,-0.0124468,-0.0651297,-0.997799,1
6123,0,0,0,0,577,136,6836,1161,7997,-0.0172357,-0.0756507,-0.996985,1
6619,0,0,0,0,561,144,7324,1265,8589,-0.0138044,-0.0689736,-0.997523,1
6475,0,0,0,0,626,151,7252,1158,8410,-0.0161034,-0.0424904,-0.998967,1
6319,0,0,0,0,600,153,7072,930,8002,-0.00862281,-0.0169491,-0.999819,1
6229,0,0,0,0,618,155,7002,733,7735,-0.00126451,0.00208128,-0.999997,1
6174,0,0,0,0,611,151,6936,768,7704,0.0115721,-0.02186,-0.999694,1
6613,0,0,0,0,686,168,7467,629,8096,0.0102978,0.039449,-0.999168,1
6430,0,0,0,0,726,184,7340,799,8139,-0.0236541,0.136876,-0.990306,1
5880,0,0,0,0,526,130,6536,431,6967,-0.0117855,0.0822173,-0.996545,1
4266,0,0,0,0,558,159,4983,367,5350,-0.0172968,0.0642179,-0.997786,1
5664,0,0,0,0,840,203,6707,580,7287,-0.0277625,0.0499098,-0.998368,1
6286,0,0,0,0,948,240,7474,571,8045,-0.0336997,0.0964947,-0.994763,1
6335,0,0,0,0,961,248,7544,517,8061,-0.0428715,0.0816213,-0.995741,1
6353,0,0,0,0,972,237,7562,482,8044,-0.0317084,0.0922223,-0.995233,1
6557,0,0,0,0,1222,266,8045,473,8518,-0.0175578,0.117983,-0.99286,1
6012,0,0,0,0,890,231,7133,493,7626,-0.00433788,0.109503,-0.993977,1
6080,0,0,0,0,871,202,7153,464,7617,0.00483022,0.104636,-0.994499,1
6184,0,0,0,0,1099,254,7537,632,8169,0.010749,0.0872434,-0.996129,1
7090,0,0,0,0,708,172,7970,742,8712,0.00343252,0.0550597,-0.998477,1
7546,0,0,0,0,696,178,8420,610,9030,-0.00525688,0.0541477,-0.998519,1
4196,0,0,0,0,450,100,4746,557,5303,0.00145385,0.025029,-0.999686,1
6242,0,0,0,0,633,144,7019,771,7790,-0.00897805,0.0246834,-0.999655,1
6230,0,0,0,0,690,164,7084,687,7771,-0.00910207,0.0189117,-0.99978,1
6899,0,0,0,0,678,158,7735,671,8406,-0.000946784,0.0413134,-0.999146,1
6779,0,0,0,0,736,194,7709,621,8330,0.00659659,0.0506248,-0.998696,1
6347,0,0,0,0,742,192,7281,582,7863,0.0069742,0.0491735,-0.998766,1
7010,0,0,0,0,741,173,7924,386,8310,-0.00448157,0.0423726,-0.999092,1
6045,0,0,0,0,730,176,6951,328,7279,-0.00449245,0.0463843,-0.998914,1
6978,0,0,0,0,713,176,7867,329,8196,0.0156865,0.0130017,-0.999792,1
5976,0,0,0,0,698,176,6850,349,7199,-0.0159063,0.0114441,-0.999808,1
5822,0,0,0,0,698,177,6697,375,7072,0.00195977,0.0155483,-0.999877,1
5847,0,0,0,0,706,175,6728,376,7104,0.00899706,-0.00562731,-0.999944,1
7097,0,0,0,0,691,174,7962,395,8357,0.0127012,0.00765014,-0.99989,1
5891,0,0,0,0,743,176,6810,384,7194,0.0189991,0.00262369,-0.999816,1
5706,0,0,0,0,840,186,6732,422,7154,0.0144599,-0.0211241,-0.999672,1
5840,0,0,0,0,767,190,6797,464,7261,0.00382097,0.00618046,-0.999974,1
6551,0,0,0,0,809,188,7548,441,7989,0.00275899,-0.017256,-0.999847,1
5811,0,0,0,0,734,177,6722,451,7173,-0.00693929,0.0165062,-0.99984,1
6965,0,0,0,0,768,190,7923,398,8321,-0.00849547,0.0273017,-0.999591,1
6236,0,0,0,0,746,184,7166,488,7654,-0.0133307,0.0158844,-0.999785,1
5955,0,0,0,0,721,177,6853,690,7543,-0.0213994,0.0441822,-0.998794,1
7108,0,0,0,0,758,176,8042,823,8865,-0.000660313,0.0409408,-0.999161,1
5929,0,0,0,0,606,147,6682,596,7278,-0.0113888,0.0728546,-0.997278,1
6234,0,0,0,0,486,130,6850,1015,7865,-0.00793042,0.086736,-0.9962,1
6009,0,0,0,0,428,112,6549,842,7391,-0.00691482,0.0273671,-0.999602,1
6285,0,0,0,0,417,110,6812,972,7784,0.00570853,0.0311869,-0.999497,1
6804,0,0,0,0,495,123,7422,1164,8586,0.018408,0.0061675,-0.999812,1
5960,0,0,0,0,474,124,6558,1087,7645,0.016027,-0.0167531,-0.999731,1
5989,0,0,0,0,498,129,6616,1136,7752,0.00494245,0.0617156,-0.998082,1
6260,0,0,0,0,614,173,7047,1299,8346,0.00462854,0.0463078,-0.998917,1
7351,0,0,0,0,538,106,7995,684,8679,0.0113411,0.0449725,-0.998924,1
4174,0,0,0,0,451,114,4739,744,5483,0.00423465,0.00109351,-0.99999,1
6539,0,0,0,0,798,232,7569,1211,8780,-0.0117631,0.01503,-0.999818,1
6610,0,0,0,0,800,224,7634,1101,8735,-0.00101849,0.0202019,-0.999795,1
4411,0,0,0,0,560,160,5131,816,5947,0.0164091,0.0513419,-0.998546,1
7222,0,0,0,0,910,217,8349,1011,9360,0.011334,0.0542725,-0.998462,1
6645,0,0,0,0,927,251,7823,1437,9260,0.00902369,0.0489728,-0.998759,1
6377,0,0,0,0,935,253,7565,1386,8951,0.0504985,0.0689222,-0.996343,1
6560,0,0,0,0,922,226,7708,1358,9066,0.0644387,0.0225156,-0.997668,1
6680,0,0,0,0,1157,289,8126,1346,9472,0.0328515,0.0193538,-0.999273,1
6488,0,0,0,0,843,205,7536,1761,9297,0.0221627,0.0434447,-0.99881,1
6658,0,0,0,0,824,202,7684,3218,10902,0.00907714,0.102642,-0.994677,1
6498,0,0,0,0,825,199,7522,-1000,-1000,-1,-1,-1,1
2594,0,0,0,0,324,79,2997,-1000,-1000,-1,-1,-1,1
6574,0,0,0,0,825,262,7661,-1000,-1000,-1,-1,-1,1
6505,0,0,0,0,786,180,7471,-1000,-1000,-1,-1,-1,1
3277,0,0,0,0,389,94,3760,1929,5689,0.0466704,-0.0112042,-0.998848,1
6383,0,0,0,0,759,174,7316,1488,8804,-0.00456277,-0.0247085,-0.999684,1
6640,0,0,0,0,796,179,7615,1278,8893,-0.0109092,-0.0293733,-0.999509,1
6410,0,0,0,0,810,180,7400,1285,8685,-0.00874002,-0.0482751,-0.998796,1
6649,0,0,0,0,776,178,7603,1305,8908,-0.0373326,0.0512284,-0.997989,1
6737,0,0,0,0,732,177,7646,1462,9108,-0.032956,0.0453373,-0.998428,1
5390,0,0,0,0,486,130,6006,979,6985,-0.0152061,-0.019861,-0.999687,1
4027,0,0,0,0,411,99,4537,1137,5674,-0.00590349,-0.0318469,-0.999475,1
7037,0,0,0,0,640,157,7834,1960,9794,0.00313968,0.00943931,-0.99995,1
6479,0,0,0,0,624,150,7253,1623,8876,0.0108578,-0.0126847,-0.999861,1
6328,0,0,0,0,615,175,7118,1407,8525,0.00213752,-0.0652166,-0.997869,1
6547,0,0,0,0,567,141,7255,975,8230,-0.00170676,-0.0441445,-0.999024,1
7153,0,0,0,0,544,139,7836,964,8800,-0.0128895,-0.0415485,-0.999053,1
6107,0,0,0,0,571,138,6816,910,7726,-0.0340533,-0.0367859,-0.998743,1
6572,0,0,0,0,538,135,7245,1046,8291,-0.041557,-0.0122646,-0.999061,1
6298,0,0,0,0,545,158,7001,836,7837,-0.0524232,-0.0363603,-0.997963,1
7216,0,0,0,0,572,146,7934,741,8675,-0.0597506,-0.025077,-0.997898,1
7316,0,0,0,0,622,180,8118,736,8854,-0.0687786,-0.0205258,-0.997421,1
6186,0,0,0,0,661,166,7013,764,7777,-0.049975,-0.0799972,-0.995542,1
7196,0,0,0,0,679,174,8049,687,8736,-0.0329655,0.0153847,-0.999338,1
6298,0,0,0,0,731,188,7217,662,7879,-0.0235821,0.0368423,-0.999043,1
6533,0,0,0,0,788,207,7528,534,8062,-0.0164925,-0.00289692,-0.99986,1
6709,0,0,0,0,1113,249,8071,562,8633,-0.0260721,0.0381637,-0.998931,1
7331,0,0,0,0,902,230,8463,541,9004,-0.0135733,-0.0205607,-0.999696,1
7516,0,0,0,0,961,286,8763,503,9266,-0.0384702,0.0286463,-0.998849,1
6045,0,0,0,0,955,228,7228,538,7766,-0.0271526,0.0113042,-0.999567,1
7061,0,0,0,0,929,237,8227,457,8684,-0.0234091,0.0182127,-0.99956,1
6972,0,0,0,0,906,231,8109,438,8547,-0.0193408,0.0387094,-0.999063,1
5923,0,0,0,0,880,219,7022,400,7422,-0.0711003,0.181523,-0.980813,1
6033,0,0,0,0,838,211,7082,397,7479,-0.0667318,0.125867,-0.9898,1
7042,0,0,0,0,771,131,7944,297,8241,-0.0664843,0.0973251,-0.99303,1
4073,0,0,0,0,477,117,4667,310,4977,-0.0806628,0.0887522,-0.992782,1
6362,0,0,0,0,685,165,7212,695,7907,-0.0432949,0.215435,-0.975558,1
6612,0,0,0,0,714,170,7496,780,8276,-0.0313601,0.171362,-0.984709,1
3410,0,0,0,0,307,70,3787,359,4146,-0.0270075,0.073087,-0.99696,1
6424,0,0,0,0,627,146,7197,633,7830,-0.0354784,0.0576272,-0.997708,1
6529,0,0,0,0,648,161,7338,664,8002,-0.0465274,0.0482291,-0.997752,1
6480,0,0,0,0,662,154,7296,658,7954,-0.035235,0.0349551,-0.998768,1
6284,0,0,0,0,651,152,7087,489,7576,-0.00236775,0.0916426,-0.995789,1
6244,0,0,0,0,636,150,7030,375,7405,0.00413025,0.0791811,-0.996852,1
6785,0,0,0,0,435,112,7332,229,7561,-0.00152157,0.0872125,-0.996189,1
3967,0,0,0,0,441,107,4515,224,4739,-0.00447156,0.0228753,-0.999728,1
6141,0,0,0,0,721,225,7087,411,7498,-0.008946,0.062645,-0.997996,1
7465,0,0,0,0,739,184,8388,415,8803,-0.0107172,0.0635821,-0.997919,1
7165,0,0,0,0,844,219,8228,510,8738,-0.0120643,0.0472795,-0.998809,1
6015,0,0,0,0,829,201,7045,478,7523,-0.0110482,0.0354347,-0.999311,1
6170,0,0,0,0,547,137,6854,346,7200,0.00186191,0.0387469,-0.999247,1
4094,0,0,0,0,597,125,4816,285,5101,0.00428163,0.0632451,-0.997989,1
6136,0,0,0,0,740,189,7065,503,7568,-0.01409,0.0905271,-0.995794,1
6107,0,0,0,0,801,187,7095,508,7603,-0.00782911,0.0369414,-0.999287,1
6655,0,0,0,0,650,162,7467,708,8175,0.00567055,0.0167915,-0.999843,1
6250,0,0,0,0,591,154,6995,819,7814,0.00606644,-0.0291551,-0.999556,1
6163,0,0,0,0,524,136,6823,841,7664,0.0165531,0.0046338,-0.999852,1
6554,0,0,0,0,531,131,7216,961,8177,0.0132342,0.00975158,-0.999865,1
6093,0,0,0,0,442,117,6652,888,7540,0.00999891,-0.00742261,-0.999922,1
6207,0,0,0,0,429,128,6764,1000,7764,0.0203503,0.000827527,-0.999793,1
6087,0,0,0,0,399,103,6589,906,7495,0.0130029,0.0198614,-0.999718,1
6007,0,0,0,0,386,103,6496,825,7321,0.00398333,0.104183,-0.99455,1
5560,0,0,0,0,278,72,5910,694,6604,0.00571537,0.0704601,-0.997498,1
2984,0,0,0,0,244,71,3299,436,3735,-0.00149742,-0.000910926,-0.999998,1
6173,0,0,0,0,679,160,7012,974,7986,0.00137003,0.00770363,-0.999969,1
6475,0,0,0,0,683,178,7336,1363,8699,0.0140597,0.00427498,-0.999892,1
7830,0,0,0,0,662,134,8626,1060,9686,0.0155981,0.00370042,-0.999871,1
6788,0,0,0,0,884,219,7891,1897,9788,-0.0073536,0.0730461,-0.997301,1
5914,0,0,0,0,630,154,6698,1190,7888,-0.0456356,0.0593766,-0.997192,1
3226,0,0,0,0,471,116,3813,673,4486,-0.0559241,0.0243751,-0.998137,1
6735,0,0,0,0,962,232,7929,1637,9566,-0.0340975,0.0199327,-0.99922,1
6894,0,0,0,0,930,247,8071,2883,10954,-0.0154534,0.131692,-0.99117,1
5195,0,0,0,0,653,153,6001,1875,7876,0.0677232,0.0353961,-0.997076,1
2574,0,0,0,0,352,81,3007,1485,4492,0.0415568,-0.0303232,-0.998676,1
7980,0,0,0,0,831,202,9013,9119,18132,0.050621,-0.0025746,-0.998715,1
4347,0,0,0,0,543,141,5031,4346,9377,0.0718703,-0.041085,-0.996567,1
6575,0,0,0,0,830,187,7592,3265,10857,0.011565,-0.0179985,-0.999771,1
6571,0,0,0,0,1137,183,7891,2503,10394,-0.014346,0.0179277,-0.999736,1
4741,0,0,0,0,511,117,5369,798,6167,-0.0119845,0.0436353,-0.998976,1
2645,0,0,0,0,469,99,3213,701,3914,0.00381929,-0.00864168,-0.999955,1
2395,0,0,0,0,260,62,2717,441,3158,0.0113717,-0.0419943,-0.999053,1
6850,0,0,0,0,775,174,7799,1395,9194,0.0129558,-0.0268509,-0.999555,1
6527,0,0,0,0,702,167,7396,1587,8983,0.0178126,-0.0246862,-0.999537,1
6506,0,0,0,0,722,166,7394,1507,8901,0.0148501,-0.024015,-0.999601,1
6444,0,0,0,0,753,160,7357,1893,9250,0.000568564,-0.0425305,-0.999095,1
6442,0,0,0,0,622,149,7213,2239,9452,0.00104101,-0.0279717,-0.999608,1
4693,0,0,0,0,429,107,5229,1287,6516,-0.00698942,-0.0711638,-0.99744,1
5573,0,0,0,0,549,134,6256,1821,8077,-0.0196364,-0.0567772,-0.998194,1
6586,0,0,0,0,618,154,7358,1264,8622,-0.0175928,-0.0686176,-0.997488,1
4174,0,0,0,0,460,104,4738,990,5728,-0.0132249,-0.0958394,-0.995309,1
5923,0,0,0,0,556,145,6624,1034,7658,-0.0116298,-0.0938352,-0.99552,1
6164,0,0,0,0,608,152,6924,1100,8024,0.00655645,0.0504965,-0.998703,1
6386,0,0,0,0,461,102,6949,579,7528,0.00395714,0.0135727,-0.9999,1
3704,0,0,0,0,309,75,4088,616,4704,-0.00601641,-0.0565694,-0.998381,1
3627,0,0,0,0,363,91,4081,459,4540,-0.00721232,-0.0502335,-0.998711,1
6383,0,0,0,0,655,164,7202,887,8089,1.86952e-05,-0.00927153,-0.999957,1
6488,0,0,0,0,692,174,7354,739,8093,-0.00107001,0.00787891,-0.999968,1
6474,0,0,0,0,695,179,7348,734,8082,-0.0230313,-0.00383532,-0.999727,1
6367,0,0,0,0,776,189,7332,849,8181,-0.0697072,0.100128,-0.99253,1
4895,0,0,0,0,556,139,5590,476,6066,-0.031052,0.0590933,-0.997769,1
3230,0,0,0,0,420,107,3757,346,4103,-0.0318338,-0.00147789,-0.999492,1
6513,0,0,0,0,913,246,7672,555,8227,-0.0324354,0.0191211,-0.999291,1
6218,0,0,0,0,930,251,7399,553,7952,-0.0166265,0.0792518,-0.996716,1
6171,0,0,0,0,955,237,7363,536,7899,-0.0167992,0.0618873,-0.997942,1
7071,0,0,0,0,932,239,8242,501,8743,-0.0258282,0.0434719,-0.998721,1
6287,0,0,0,0,935,239,7461,484,7945,-0.0387037,0.0413971,-0.998393,1
6587,0,0,0,0,903,230,7720,493,8213,-0.0405367,0.0444493,-0.998189,1
6104,0,0,0,0,896,237,7237,529,7766,-0.0394332,0.042302,-0.998326,1
6275,0,0,0,0,849,212,7336,537,7873,-0.0291698,0.0347837,-0.998969,1
6207,0,0,0,0,760,184,7151,583,7734,-0.0268989,0.0441135,-0.998664,1
6633,0,0,0,0,483,116,7232,428,7660,-0.0171725,0.0636744,-0.997823,1
4176,0,0,0,0,480,115,4771,509,5280,-0.0116432,0.0418976,-0.999054,1
6503,0,0,0,0,625,150,7278,751,8029,-0.00693665,0.0360527,-0.999326,1
5786,0,0,0,0,651,140,6577,764,7341,-0.00629385,0.0247323,-0.999674,1
6455,0,0,0,0,570,133,7158,663,7821,-0.0303919,0.033313,-0.998983,1
6659,0,0,0,0,770,171,7600,703,8303,-0.0446144,0.0357676,-0.998364,1
6364,0,0,0,0,632,145,7141,676,7817,-0.036545,0.0780958,-0.996276,1
5710,0,0,0,0,417,92,6219,529,6748,-0.0147485,0.0205987,-0.999679,1
3116,0,0,0,0,301,67,3484,303,3787,-0.0233338,0.00919898,-0.999685,1
6300,0,0,0,0,615,139,7054,465,7519,0.00448419,0.0129898,-0.999906,1
6879,0,0,0,0,638,161,7678,387,8065,0.0299776,0.0485243,-0.998372,1
6168,0,0,0,0,692,153,7013,363,7376,0.0178669,0.0123111,-0.999765,1
6880,0,0,0,0,674,166,7720,377,8097,0.00664538,-0.0202633,-0.999773,1
6155,0,0,0,0,730,180,7065,381,7446,-0.0037478,0.0624113,-0.998044,1
6089,0,0,0,0,718,130,6937,301,7238,-0.00642071,0.0104575,-0.999925,1
4065,0,0,0,0,558,138,4761,321,5082,-0.00773516,-0.00389934,-0.999962,1
6153,0,0,0,0,883,224,7260,501,7761,-0.00231533,0.0726529,-0.997355,1
6256,0,0,0,0,624,154,7034,340,7374,0.0016558,0.0126804,-0.999918,1
3133,0,0,0,0,463,122,3718,245,3963,0.00723697,-0.0165924,-0.999836,1
6380,0,0,0,0,918,222,7520,437,7957,0.00880203,-0.0113332,-0.999897,1
6681,0,0,0,0,917,241,7839,514,8353,0.00916944,-0.00714831,-0.999932,1
7398,0,0,0,0,889,204,8491,557,9048,-0.015302,0.063823,-0.997844,1
6589,0,0,0,0,713,183,7485,521,8006,-0.00831835,0.0467536,-0.998872,1
4055,0,0,0,0,307,78,4440,371,4811,0.0148326,0.116182,-0.993117,1
2404,0,0,0,0,230,56,2690,329,3019,-0.000373483,-0.0213942,-0.999771,1
6297,0,0,0,0,499,125,6921,756,7677,0.0185189,0.0414805,-0.998968,1
6057,0,0,0,0,444,128,6629,807,7436,0.0111389,0.0204759,-0.999728,1
6131,0,0,0,0,414,110,6655,776,7431,-7.0226e-05,0.0221997,-0.999754,1
5969,0,0,0,0,499,127,6595,1001,7596,-0.0677884,0.0729347,-0.99503,1
6075,0,0,0,0,588,152,6815,1090,7905,-0.0356253,0.0405069,-0.998544,1
6332,0,0,0,0,708,181,7221,1338,8559,-0.0624963,0.0667973,-0.995807,1
7008,0,0,0,0,813,203,8024,1062,9086,-0.0401305,0.0587664,-0.997465,1
7052,0,0,0,0,915,222,8189,1501,9690,-0.037335,0.0406084,-0.998477,1
6882,0,0,0,0,941,233,8056,1545,9601,-0.00500337,-0.0964389,-0.995326,1
4905,0,0,0,0,654,179,5738,1331,7069,-0.022398,0.0105297,-0.999694,1
7119,0,0,0,0,978,239,8336,1784,10120,-0.0201975,0.103476,-0.994427,1
6587,0,0,0,0,620,156,7363,2053,9416,-0.0280701,0.0587134,-0.99788,1
2887,0,0,0,0,371,87,3345,756,4101,-0.017617,-0.0674626,-0.997566,1
3054,0,0,0,0,384,93,3531,775,4306,-0.018318,-0.0414391,-0.998973,1
6554,0,0,0,0,848,200,7602,3129,10731,-0.0331225,0.0208023,-0.999235,1
6346,0,0,0,0,825,187,7358,5347,12705,-0.0748678,0.126979,-0.989076,1
7350,0,0,0,0,1131,192,8673,3239,11912,-0.10074,0.181537,-0.97821,1
7624,0,0,0,0,818,188,8630,-1000,-1000,-1,-1,-1,1
3472,0,0,0,0,422,92,3986,2123,6109,0.0687269,-0.038276,-0.996901,1
6700,0,0,0,0,845,178,7723,1835,9558,0.0128782,-0.0374465,-0.999216,1
6781,0,0,0,0,810,176,7767,1321,9088,0.0116867,-0.0396797,-0.999144,1
7701,0,0,0,0,792,171,8664,1396,10060,0.00717526,-0.0350632,-0.999359,1
6584,0,0,0,0,718,162,7464,1338,8802,0.0093639,-0.0463858,-0.99888,1
6758,0,0,0,0,730,172,7660,1402,9062,0.00956067,-0.0331214,-0.999406,1
6539,0,0,0,0,672,159,7370,1504,8874,0.00442897,-0.0314207,-0.999496,1
6694,0,0,0,0,613,143,7450,1376,8826,0.0077882,-0.0494005,-0.998749,1
6599,0,0,0,0,668,137,7404,1446,8850,0.00931718,-0.0476293,-0.998822,1
6442,0,0,0,0,599,137,7178,1751,8929,0.0073596,-0.0522171,-0.998609,1
6545,0,0,0,0,583,134,7262,2077,9339,0.00167929,-0.0576339,-0.998336,1
6538,0,0,0,0,555,136,7229,2053,9282,-0.00149223,-0.0582135,-0.998303,1
6641,0,0,0,0,576,155,7372,2443,9815,-0.00046057,-0.0595115,-0.998228,1
6621,0,0,0,0,596,173,7390,1669,9059,-0.00645827,-0.0668615,-0.997741,1
4258,0,0,0,0,415,105,4778,917,5695,-0.0225789,-0.107734,-0.993923,1
5679,0,0,0,0,570,142,6391,1149,7540,-0.0183878,-0.035477,-0.999201,1
5502,0,0,0,0,568,142,6212,787,6999,-0.023231,-0.0380945,-0.999004,1
6046,0,0,0,0,576,141,6763,851,7614,0.00508258,-0.0118285,-0.999917,1
5781,0,0,0,0,606,144,6531,752,7283,-0.0067935,-0.0352351,-0.999356,1
6400,0,0,0,0,633,156,7189,878,8067,-0.0134642,-0.00819612,-0.999876,1
6636,0,0,0,0,700,157,7493,629,8122,-0.00694296,0.0093636,-0.999932,1
6172,0,0,0,0,609,156,6937,640,7577,0.00203248,0.0217075,-0.999762,1
6338,0,0,0,0,716,184,7238,658,7896,-0.00626949,0.00985949,-0.999932,1
6405,0,0,0,0,658,168,7231,776,8007,-0.01268,0.0214581,-0.999689,1
6317,0,0,0,0,689,200,7206,713,7919,0.00377489,0.0327495,-0.999456,1
6273,0,0,0,0,800,213,7286,552,7838,-0.0276164,0.0323083,-0.999096,1
6353,0,0,0,0,752,191,7296,629,7925,-0.0415864,0.0387632,-0.998383,1
6272,0,0,0,0,894,203,7369,608,7977,-0.0346366,0.022308,-0.999151,1
6522,0,0,0,0,853,260,7635,547,8182,-0.0282954,0.0461968,-0.998532,1
6131,0,0,0,0,882,221,7234,550,7784,-0.0246468,0.0264482,-0.999346,1
6195,0,0,0,0,887,227,7309,540,7849,-0.0257929,0.00697289,-0.999643,1
5857,0,0,0,0,921,229,7007,545,7552,-0.0202645,0.0413388,-0.99894,1
6211,0,0,0,0,906,230,7347,493,7840,-0.0245392,0.0398599,-0.998904,1
5898,0,0,0,0,922,223,7043,501,7544,-0.0355803,0.0300422,-0.998915,1
5888,0,0,0,0,900,217,7005,519,7524,-0.033344,0.0524278,-0.998068,1
5910,0,0,0,0,881,213,7004,528,7532,-0.0420465,0.045916,-0.99806,1
5854,0,0,0,0,766,196,6816,521,7337,-0.0328873,0.0661604,-0.997267,1
6055,0,0,0,0,704,176,6935,501,7436,-0.0376828,0.0291558,-0.998864,1
6209,0,0,0,0,734,176,7119,571,7690,-0.039052,0.0559642,-0.997669,1
6214,0,0,0,0,678,160,7052,808,7860,-0.0344771,0.0513914,-0.998083,1
6289,0,0,0,0,770,160,7219,752,7971,-0.0395812,0.0669902,-0.996968,1
6186,0,0,0,0,645,145,6976,697,7673,-0.027696,0.0404355,-0.998798,1
6627,0,0,0,0,614,153,7394,671,8065,-0.0315993,0.0335607,-0.998937,1
7359,0,0,0,0,689,147,8195,758,8953,-0.0289308,0.0295296,-0.999145,1
6714,0,0,0,0,636,138,7488,669,8157,-0.0138563,0.0160446,-0.999775,1
6667,0,0,0,0,574,145,7386,586,7972,-0.00234952,0.00419413,-0.999988,1
7193,0,0,0,0,633,132,7958,462,8420,0.00186335,-0.00836936,-0.999963,1
6288,0,0,0,0,562,128,6978,364,7342,0.0135192,0.00251617,-0.999905,1
7030,0,0,0,0,577,145,7752,441,8193,0.0193766,0.0032186,-0.999807,1
5898,0,0,0,0,662,162,6722,374,7096,0.0262899,0.0750167,-0.996836,1
5931,0,0,0,0,918,191,7040,372,7412,0.0173062,0.0769799,-0.996882,1
5911,0,0,0,0,825,209,6945,406,7351,0.0105496,0.0884519,-0.996025,1
5928,0,0,0,0,880,221,7029,440,7469,-0.000592255,0.110375,-0.99389,1
6710,0,0,0,0,869,214,7793,426,8219,0.00870198,0.121464,-0.992558,1
6025,0,0,0,0,844,202,7071,499,7570,-0.0155357,0.103991,-0.994457,1
6535,0,0,0,0,735,181,7451,540,7991,-0.0229596,0.0783616,-0.996661,1
6149,0,0,0,0,551,141,6841,516,7357,-0.0129582,0.0694536,-0.997501,1
6128,0,0,0,0,432,111,6671,618,7289,-0.0231448,0.0964272,-0.995071,1
6084,0,0,0,0,446,135,6665,503,7168,-0.013668,0.0940843,-0.99547,1
5864,0,0,0,0,416,108,6388,658,7046,0.00374488,0.0567192,-0.998383,1
6016,0,0,0,0,464,128,6608,789,7397,0.019946,0.093892,-0.995383,1
6109,0,0,0,0,563,147,6819,875,7694,0.0356812,0.0395875,-0.998579,1
6321,0,0,0,0,678,174,7173,814,7987,0.041736,0.0572403,-0.997488,1
6705,0,0,0,0,751,216,7672,1017,8689,0.0456381,0.17232,-0.983983,1
6722,0,0,0,0,798,202,7722,1210,8932,0.0287115,0.152731,-0.987851,1
4219,0,0,0,0,424,107,4750,693,5443,0.0235773,0.0863289,-0.995988,1
2852,0,0,0,0,353,89,3294,598,3892,0.0198527,0.0591523,-0.998052,1
7067,0,0,0,0,916,230,8213,1350,9563,0.0121691,0.0912795,-0.995751,1
6605,0,0,0,0,936,247,7788,2900,10688,0.0107011,0.309252,-0.95092,1
6429,0,0,0,0,901,165,7495,1525,9020,0.0621988,0.245102,-0.9675,1
3231,0,0,0,0,429,104,3764,850,4614,0.0573265,0.191314,-0.979853,1
7225,0,0,0,0,810,230,8265,2573,10838,0.100305,0.162912,-0.981529,1
6268,0,0,0,0,739,176,7183,2398,9581,0.0530745,0.296465,-0.953568,1
4262,0,0,0,0,508,118,4888,1634,6522,0.0312024,-0.00783549,-0.999482,1
7032,0,0,0,0,829,206,8067,3769,11836,0.0750937,0.00034129,-0.997176,1
6763,0,0,0,0,783,187,7733,1411,9144,0.0483825,-0.00931831,-0.998785,1
6778,0,0,0,0,823,183,7784,1133,8917,0.0357892,-0.0146147,-0.999253,1
6677,0,0,0,0,806,179,7662,1185,8847,0.0239667,-0.0222087,-0.999466,1
6686,0,0,0,0,950,180,7816,1283,9099,-0.062057,0.0279553,-0.997681,1
7496,0,0,0,0,731,170,8397,1060,9457,-0.0634699,-0.00269796,-0.99798,1
3840,0,0,0,0,350,79,4269,721,4990,-0.0263714,-0.0444861,-0.998662,1
3042,0,0,0,0,317,71,3430,694,4124,-0.00646287,-0.0433771,-0.999038,1
6716,0,0,0,0,645,156,7517,1486,9003,-0.00355471,-0.0273948,-0.999618,1
6758,0,0,0,0,654,159,7571,1857,9428,-0.00660947,-0.019189,-0.999794,1
6529,0,0,0,0,677,186,7392,1844,9236,-0.00136644,-0.000151703,-0.999999,1
6381,0,0,0,0,687,166,7234,2340,9574,0.000259778,0.073526,-0.997293,1
6562,0,0,0,0,709,174,7445,1445,8890,-0.00167351,0.0413893,-0.999142,1
6265,0,0,0,0,673,166,7104,1337,8441,0.00463866,0.00506043,-0.999976,1
4002,0,0,0,0,418,103,4523,599,5122,0.00104231,-0.016508,-0.999863,1
5498,0,0,0,0,519,129,6146,716,6862,-0.00132359,-0.028362,-0.999597,1
6327,0,0,0,0,544,141,7012,731,7743,-0.00213148,-0.00716404,-0.999972,1
6344,0,0,0,0,557,142,7043,664,7707,-0.00796776,0.0118066,-0.999899,1
6045,0,0,0,0,581,143,6769,908,7677,-0.000587361,-0.0187633,-0.999824,1
6303,0,0,0,0,584,147,7034,871,7905,-0.0167836,-0.0340183,-0.99928,1
6194,0,0,0,0,614,153,6961,639,7600,-0.0243077,-0.0035461,-0.999698,1
6330,0,0,0,0,653,168,7151,539,7690,-0.0598374,0.108168,-0.99233,1
6419,0,0,0,0,712,184,7315,525,7840,-0.0556311,0.0704765,-0.995961,1
7266,0,0,0,0,778,131,8175,370,8545,-0.0467369,0.0428511,-0.997988,1
3764,0,0,0,0,515,132,4411,319,4730,-0.0369046,0.0492811,-0.998103,1
6051,0,0,0,0,890,234,7175,486,7661,-0.0360938,0.092129,-0.995093,1
5948,0,0,0,0,920,235,7103,477,7580,-0.040783,0.114516,-0.992584,1
5957,0,0,0,0,887,226,7070,424,7494,-0.0414564,0.141294,-0.989099,1
5999,0,0,0,0,868,242,7109,449,7558,-0.0400546,0.123905,-0.991485,1
5834,0,0,0,0,836,203,6873,460,7333,-0.0328072,0.115371,-0.992781,1
5858,0,0,0,0,779,182,6819,514,7333,-0.0347464,0.0994809,-0.994433,1
6342,0,0,0,0,686,186,7214,700,7914,-0.0279324,0.0702066,-0.997141,1
6378,0,0,0,0,698,165,7241,870,8111,-0.0165104,0.192961,-0.981068,1
6545,0,0,0,0,772,166,7483,765,8248,-0.0230587,0.156808,-0.98736,1
4478,0,0,0,0,592,78,5148,377,5525,-0.0215198,0.0868474,-0.995989,1
3192,0,0,0,0,294,69,3555,379,3934,-0.0148446,0.0240817,-0.9996,1
6498,0,0,0,0,603,160,7261,663,7924,-0.0168896,0.0568355,-0.998241,1
7039,0,0,0,0,541,130,7710,616,8326,-0.0159272,0.0606958,-0.998029,1
6077,0,0,0,0,546,127,6750,486,7236,-0.00996654,0.156661,-0.987602,1
6278,0,0,0,0,593,142,7013,376,7389,0.00108656,0.152333,-0.988329,1
4037,0,0,0,0,430,107,4574,269,4843,-0.0305114,0.0963139,-0.994883,1
6978,0,0,0,0,723,185,7886,376,8262,-0.00867597,0.0464048,-0.998885,1
5818,0,0,0,0,843,202,6863,393,7256,-0.0144485,0.0499274,-0.998648,1
5905,0,0,0,0,899,218,7022,429,7451,-0.0200379,0.0317116,-0.999296,1
5934,0,0,0,0,984,249,7167,472,7639,-0.0265383,0.0557956,-0.998089,1
6056,0,0,0,0,896,221,7173,481,7654,-0.00287698,0.0167012,-0.999856,1
6298,0,0,0,0,914,223,7435,588,8023,-0.00739913,0.035805,-0.999331,1
5982,0,0,0,0,849,213,7044,499,7543,0.00479096,0.00662854,-0.999967,1
5950,0,0,0,0,838,208,6996,541,7537,0.005977,-0.00316247,-0.999977,1
6023,0,0,0,0,819,206,7048,694,7742,0.00478588,0.000325868,-0.999989,1
6162,0,0,0,0,783,186,7131,619,7750,0.0147085,-0.0211267,-0.999669,1
6270,0,0,0,0,672,158,7100,637,7737,0.0058884,-0.0374161,-0.999282,1
6410,0,0,0,0,761,183,7354,741,8095,-0.00661024,0.0154829,-0.999858,1
6078,0,0,0,0,471,122,6671,618,7289,0.0140223,-0.0125459,-0.999823,1
5883,0,0,0,0,459,110,6452,607,7059,0.0126647,-0.000286738,-0.99992,1
5987,0,0,0,0,444,108,6539,539,7078,0.0112687,0.0146244,-0.99983,1
5974,0,0,0,0,409,104,6487,720,7207,0.00473344,0.0521157,-0.99863,1
6196,0,0,0,0,426,112,6734,907,7641,4.97842e-05,0.0658523,-0.997829,1
6141,0,0,0,0,480,123,6744,732,7476,0.0103114,0.00180655,-0.999945,1
6110,0,0,0,0,546,137,6793,856,7649,0.00863668,-0.0186559,-0.999789,1
6373,0,0,0,0,604,149,7126,885,8011,0.00782239,0.000716484,-0.999969,1
7202,0,0,0,0,893,136,8231,987,9218,-0.00342416,0.0169884,-0.99985,1
6138,0,0,0,0,683,167,6988,929,7917,0.0117586,-0.00798902,-0.999899,1
10036,0,0,0,0,1049,156,11241,643,11884,0.0149399,0.0208666,-0.999671,1
4413,0,0,0,0,537,132,5082,653,5735,0.015465,0.0203724,-0.999673,1
6770,0,0,0,0,860,215,7845,897,8742,0.0231754,0.00948748,-0.999686,1
7747,0,0,0,0,897,229,8873,1450,10323,0.0345508,-0.00178705,-0.999401,1
6626,0,0,0,0,939,229,7794,1680,9474,0.0337968,0.0150289,-0.999316,1
6624,0,0,0,0,1089,236,7949,1489,9438,0.00777277,0.0585112,-0.998257,1
6560,0,0,0,0,918,283,7761,3648,11409,-0.0229303,0.180465,-0.983314,1
6579,0,0,0,0,811,201,7591,3585,11176,-0.0589961,0.270733,-0.960845,1
6637,0,0,0,0,807,186,7630,2707,10337,-0.0825531,0.247402,-0.96539,1
6401,0,0,0,0,733,176,7310,2932,10242,-0.0718723,0.321416,-0.944207,1
6535,0,0,0,0,756,195,7486,1705,9191,-0.0979693,0.372621,-0.922798,1
6658,0,0,0,0,769,178,7605,1732,9337,-0.0933998,0.438618,-0.893807,1
6616,0,0,0,0,754,171,7541,1544,9085,-0.0607172,0.333777,-0.940695,1
6702,0,0,0,0,732,168,7602,-1000,-1000,-1,-1,-1,1
6583,0,0,0,0,726,163,7472,1353,8825,0.00280206,-0.0267351,-0.999639,1
6626,0,0,0,0,685,152,7463,1419,8882,0.00612854,-0.0296455,-0.999542,1
6513,0,0,0,0,539,125,7177,1414,8591,-0.00282823,-0.0393667,-0.999221,1
6500,0,0,0,0,501,114,7115,1470,8585,-0.00285553,-0.0497472,-0.998758,1
6662,0,0,0,0,513,140,7315,1598,8913,0.00178996,-0.0544969,-0.998512,1
6576,0,0,0,0,561,122,7259,1776,9035,-0.00612854,-0.0470642,-0.998873,1
7032,0,0,0,0,519,123,7674,1792,9466,-0.00509303,-0.0568557,-0.998369,1
4192,0,0,0,0,357,83,4632,1122,5754,-0.00650051,-0.0668002,-0.997745,1
4883,0,0,0,0,298,75,5256,1279,6535,0.00864481,-0.0782813,-0.996894,1
6386,0,0,0,0,450,100,6936,1532,8468,-0.000181834,-0.0662845,-0.997801,1
5890,0,0,0,0,254,63,6207,817,7024,0.00551657,-0.0528681,-0.998586,1
6095,0,0,0,0,400,96,6591,1043,7634,0.0056305,-0.0435009,-0.999037,1
6665,0,0,0,0,355,94,7114,1015,8129,-0.00544169,-0.0587213,-0.99826,1
6094,0,0,0,0,363,93,6550,983,7533,-0.00678185,-0.0598252,-0.998186,1
7187,0,0,0,0,466,103,7756,879,8635,-0.00283332,-0.0585818,-0.998279,1
6287,0,0,0,0,394,127,6808,729,7537,-0.0096472,-0.0660881,-0.997767,1
6507,0,0,0,0,442,109,7058,816,7874,-0.00971814,-0.0813026,-0.996642,1
6241,0,0,0,0,442,111,6794,657,7451,-0.010781,-0.0942457,-0.995491,1
6227,0,0,0,0,482,121,6830,583,7413,-0.0294306,-0.0722539,-0.996952,1
7463,0,0,0,0,552,140,8155,616,8771,-0.0366583,-0.0567566,-0.997715,1
6258,0,0,0,0,591,167,7016,594,7610,-0.0244137,-0.106022,-0.994064,1
6432,0,0,0,0,680,163,7275,630,7905,-0.0278936,-0.0700293,-0.997155,1
6140,0,0,0,0,683,171,6994,566,7560,-0.00789527,-0.0956468,-0.995384,1
6439,0,0,0,0,727,217,7383,514,7897,-0.00773213,-0.0677075,-0.997675,1
6273,0,0,0,0,1038,208,7519,562,8081,-0.0207012,-0.0756854,-0.996917,1
6092,0,0,0,0,826,198,7116,554,7670,-0.029124,-0.0723538,-0.996954,1
6573,0,0,0,0,841,259,7673,561,8234,-0.035803,-0.0715901,-0.996791,1
6096,0,0,0,0,960,224,7280,581,7861,-0.0456272,-0.116647,-0.992125,1
6387,0,0,0,0,890,225,7502,511,8013,-0.0410025,-0.0792021,-0.996015,1
5983,0,0,0,0,962,228,7173,568,7741,-0.0365254,-0.0901745,-0.995256,1
6083,0,0,0,0,915,233,7231,456,7687,-0.0323032,-0.0905482,-0.995368,1
5973,0,0,0,0,955,236,7164,471,7635,-0.0340356,-0.0837907,-0.995902,1
5906,0,0,0,0,946,245,7097,494,7591,-0.0289771,-0.0849974,-0.99596,1
5980,0,0,0,0,974,240,7194,545,7739,-0.0286145,-0.0719351,-0.996999,1
5983,0,0,0,0,999,247,7229,580,7809,-0.0306881,-0.0876577,-0.995678,1
6099,0,0,0,0,1062,253,7414,560,7974,-0.017463,-0.0600591,-0.998042,1
6195,0,0,0,0,1025,256,7476,597,8073,-0.00564982,-0.0560497,-0.998412,1
6003,0,0,0,0,1057,255,7315,612,7927,-0.0209713,-0.0603006,-0.99796,1
6073,0,0,0,0,1032,257,7362,695,8057,-0.000675996,-0.0382223,-0.999269,1
5991,0,0,0,0,1128,257,7376,702,8078,0.011246,-0.0279859,-0.999545,1
6047,0,0,0,0,1035,241,7323,641,7964,0.0176436,-0.0228543,-0.999583,1
6220,0,0,0,0,1117,251,7588,676,8264,0.0248975,-0.0173356,-0.99954,1
6740,0,0,0,0,1031,247,8018,765,8783,0.0383033,-0.0211906,-0.999041,1
6228,0,0,0,0,1017,247,7492,802,8294,0.0539553,-0.0171867,-0.998395,1
7185,0,0,0,0,995,266,8446,814,9260,0.0642958,-0.0154516,-0.997811,1
6252,0,0,0,0,930,219,7401,811,8212,0.0690971,-0.018809,-0.997433,1
6691,0,0,0,0,965,217,7873,869,8742,0.0877432,-0.0183054,-0.995975,1
4155,0,0,0,0,608,136,4899,631,5530,0.07169,-0.0330036,-0.996881,1
6464,0,0,0,0,1016,215,7695,953,8648,0.108191,-0.0401326,-0.99332,1
6445,0,0,0,0,859,190,7494,918,8412,0.10724,-0.0585799,-0.992506,1
6564,0,0,0,0,813,203,7580,821,8401,0.109264,-0.0730853,-0.991322,1
7211,0,0,0,0,907,174,8292,707,8999,0.101128,-0.0777715,-0.991829,1
6607,0,0,0,0,765,183,7555,622,8177,0.097339,-0.0935311,-0.990847,1
6480,0,0,0,0,673,157,7310,590,7900,0.105269,-0.10209,-0.98919,1
6495,0,0,0,0,651,155,7301,589,7890,0.0952005,-0.0931981,-0.991086,1
6454,0,0,0,0,714,156,7324,521,7845,0.0901346,-0.0887281,-0.991969,1
6510,0,0,0,0,700,156,7366,605,7971,0.0756564,-0.0817753,-0.993775,1
6633,0,0,0,0,711,189,7533,596,8129,0.0739354,-0.0843495,-0.993689,1
6742,0,0,0,0,753,172,7667,632,8299,0.0684443,-0.102832,-0.992341,1
6638,0,0,0,0,1180,254,8072,807,8879,0.0653923,-0.120367,-0.990573,1
6682,0,0,0,0,924,187,7793,682,8475,0.0606204,-0.137109,-0.988699,1
6558,0,0,0,0,861,193,7612,635,8247,0.0687491,-0.137562,-0.988104,1
6405,0,0,0,0,853,200,7458,544,8002,0.0690599,-0.152686,-0.985859,1
6402,0,0,0,0,909,199,7510,595,8105,0.0686697,-0.148569,-0.986515,1
6160,0,0,0,0,925,193,7278,506,7784,0.0731773,-0.141355,-0.987251,1
6125,0,0,0,0,854,185,7164,498,7662,0.071046,-0.143616,-0.98708,1
6402,0,0,0,0,774,185,7361,523,7884,0.0747586,-0.146485,-0.986384,1
6006,0,0,0,0,765,187,6958,572,7530,0.0550927,-0.145619,-0.987806,1
5938,0,0,0,0,777,185,6900,669,7569,0.0498593,-0.153332,-0.986916,1
5970,0,0,0,0,772,188,6930,641,7571,0.0443438,-0.156776,-0.986638,1
6040,0,0,0,0,749,180,6969,634,7603,0.0361533,-0.157933,-0.986788,1
5759,0,0,0,0,799,177,6735,559,7294,0.0348447,-0.163846,-0.98587,1
5921,0,0,0,0,731,171,6823,543,7366,0.0285696,-0.167798,-0.985407,1
5638,0,0,0,0,701,183,6522,567,7089,0.0221046,-0.169529,-0.985277,1
5651,0,0,0,0,679,169,6499,480,6979,0.0176993,-0.165958,-0.985974,1
5652,0,0,0,0,689,169,6510,478,6988,0.0312738,-0.174245,-0.984206,1
5985,0,0,0,0,832,226,7043,556,7599,0.0360463,-0.180747,-0.982869,1
5662,0,0,0,0,676,170,6508,401,6909,0.0454537,-0.198428,-0.979061,1
6401,0,0,0,0,792,174,7367,414,7781,0.0494529,-0.204741,-0.977566,1
5710,0,0,0,0,663,164,6537,398,6935,0.0429566,-0.194522,-0.979957,1
5851,0,0,0,0,705,166,6722,418,7140,0.0357351,-0.188527,-0.981418,1
6577,0,0,0,0,676,168,7421,424,7845,0.0343113,-0.190805,-0.981028,1
5792,0,0,0,0,750,162,6704,429,7133,0.0432979,-0.198885,-0.979066,1
5965,0,0,0,0,613,155,6733,449,7182,0.0464635,-0.205704,-0.977511,1
5862,0,0,0,0,637,176,6675,485,7160,0.0425162,-0.2258,-0.973245,1
6026,0,0,0,0,535,134,6695,485,7180,0.0729805,-0.233596,-0.969591,1
6053,0,0,0,0,773,153,6979,525,7504,0.0588735,-0.214688,-0.974907,1
5896,0,0,0,0,566,131,6593,471,7064,0.026891,-0.216865,-0.975831,1
6381,0,0,0,0,496,123,7000,462,7462,0.0354259,-0.207961,-0.977495,1
6020,0,0,0,0,480,121,6621,422,7043,0.023025,-0.220148,-0.975195,1
6918,0,0,0,0,442,116,7476,452,7928,0.0164046,-0.191904,-0.981277,1
5960,0,0,0,0,416,109,6485,405,6890,0.0094215,-0.200808,-0.979585,1
6125,0,0,0,0,481,109,6715,452,7167,0.0449267,-0.217112,-0.975112,1
6036,0,0,0,0,398,106,6540,387,6927,0.046706,-0.209115,-0.976775,1
5956,0,0,0,0,413,107,6476,403,6879,0.0429,-0.196176,-0.97963,1
3999,0,0,0,0,271,71,4341,333,4674,0.050536,-0.189001,-0.980676,1
6320,0,0,0,0,627,155,7102,528,7630,0.0503847,-0.196434,-0.979222,1
6131,0,0,0,0,537,130,6798,506,7304,0.065704,-0.197098,-0.97818,1
7214,0,0,0,0,553,171,7938,445,8383,0.0582439,-0.194,-0.979271,1
6285,0,0,0,0,646,195,7126,367,7493,0.0784264,-0.20453,-0.975713,1
4018,0,0,0,0,459,119,4596,307,4903,0.0830393,-0.202407,-0.975775,1
5997,0,0,0,0,716,180,6893,445,7338,0.0825274,-0.199915,-0.976331,1
6179,0,0,0,0,780,199,7158,590,7748,0.0846166,-0.199321,-0.976274,1
6225,0,0,0,0,851,227,7303,534,7837,0.0650846,-0.20419,-0.976765,1
6239,0,0,0,0,851,246,7336,757,8093,0.0506388,-0.224805,-0.973087,1
6307,0,0,0,0,890,225,7422,716,8138,0.0862854,-0.221893,-0.971246,1
6340,0,0,0,0,910,244,7494,960,8454,0.0262293,-0.194385,-0.980574,1
6542,0,0,0,0,974,240,7756,1068,8824,0.0166989,-0.230107,-0.973022,1
6248,0,0,0,0,931,243,7422,980,8402,0.0289564,-0.181625,-0.982941,1
6758,0,0,0,0,989,254,8001,1467,9468,0.0242508,-0.173804,-0.984482,1
7241,0,0,0,0,1090,264,8595,1025,9620,0.0107533,-0.187325,-0.982239,1
6589,0,0,0,0,995,256,7840,1841,9681,-0.0288696,-0.161716,-0.986415,1
6633,0,0,0,0,1014,284,7931,1483,9414,0.0583661,-0.236352,-0.969913,1
7090,0,0,0,0,1035,261,8386,798,9184,0.039494,-0.210004,-0.976902,1
6583,0,0,0,0,975,253,7811,900,8711,0.0659497,-0.219622,-0.973353,1
6413,0,0,0,0,1000,250,7663,627,8290,0.0577757,-0.22886,-0.971743,1
6366,0,0,0,0,941,240,7547,921,8468,0.0334873,-0.208701,-0.977406,1
6615,0,0,0,0,895,232,7742,956,8698,-0.00260046,-0.226238,-0.974069,1
6620,0,0,0,0,832,226,7678,1885,9563,0.0102952,-0.260071,-0.965535,1
6497,0,0,0,0,764,193,7454,1477,8931,0.0479998,-0.421974,-0.905336,1
6574,0,0,0,0,686,169,7429,-1000,-1000,-1,-1,-1,1
6468,0,0,0,0,672,164,7304,1482,8786,0.0170776,-0.201423,-0.979355,1
6640,0,0,0,0,673,157,7470,-1000,-1000,-1,-1,-1,1
6677,0,0,0,0,719,186,7582,1225,8807,0.00232512,-0.301581,-0.953438,1
6662,0,0,0,0,729,109,7500,685,8185,0.00541127,-0.264532,-0.964362,1
3212,0,0,0,0,369,94,3675,481,4156,-0.00028336,-0.20874,-0.977971,1
6408,0,0,0,0,735,173,7316,1187,8503,0.0144086,-0.229329,-0.973242,1
6575,0,0,0,0,764,182,7521,1356,8877,0.0293108,-0.25343,-0.96691,1
6580,0,0,0,0,832,174,7586,1731,9317,0.0233802,-0.253757,-0.966985,1
6405,0,0,0,0,618,152,7175,1806,8981,0.0382808,-0.262346,-0.964214,1
6169,0,0,0,0,524,126,6819,1490,8309,0.038473,-0.279653,-0.95933,1
6180,0,0,0,0,431,111,6722,1190,7912,0.0402946,-0.257841,-0.965347,1
6006,0,0,0,0,400,100,6506,1055,7561,0.0397895,-0.202316,-0.978512,1
6785,0,0,0,0,432,127,7344,924,8268,0.0328585,-0.228615,-0.972962,1
6364,0,0,0,0,453,114,6931,866,7797,0.0237564,-0.194114,-0.980691,1
6230,0,0,0,0,542,134,6906,704,7610,0.0161116,-0.236557,-0.971484,1
6271,0,0,0,0,642,162,7075,626,7701,0.0146203,-0.269424,-0.962911,1
6293,0,0,0,0,751,184,7228,690,7918,0.00943334,-0.278605,-0.96036,1
6397,0,0,0,0,830,205,7432,636,8068,0.0245423,-0.288115,-0.957281,1
6585,0,0,0,0,895,230,7710,754,8464,0.0242706,-0.244665,-0.969304,1
6716,0,0,0,0,975,236,7927,600,8527,0.0211273,-0.243295,-0.969722,1
6436,0,0,0,0,965,258,7659,513,8172,0.0200162,-0.312217,-0.9498,1
6262,0,0,0,0,977,245,7484,458,7942,0.00134517,-0.316446,-0.948609,1
8200,0,0,0,0,1347,176,9723,291,10014,0.0593722,-0.310991,-0.948556,1
4307,0,0,0,0,679,167,5153,273,5426,0.0599784,-0.293864,-0.953964,1
6059,0,0,0,0,1019,251,7329,405,7734,0.0285798,-0.313193,-0.949259,1
6137,0,0,0,0,1022,244,7403,453,7856,0.0402157,-0.29333,-0.955165,1
3886,0,0,0,0,645,155,4686,274,4960,0.0162772,-0.277556,-0.960571,1
6260,0,0,0,0,935,245,7440,411,7851,-0.0203472,-0.427902,-0.903596,1
6052,0,0,0,0,786,192,7030,451,7481,-0.0147192,-0.423464,-0.905793,1
3888,0,0,0,0,361,85,4334,257,4591,-0.00342534,-0.344276,-0.938862,1
4428,0,0,0,0,442,106,4976,524,5500,-0.00309545,-0.318413,-0.947947,1
6411,0,0,0,0,590,161,7162,818,7980,-0.00756172,-0.429713,-0.902934,1
6468,0,0,0,0,568,131,7167,787,7954,-0.0156839,-0.392358,-0.919679,1
4856,0,0,0,0,375,86,5317,486,5803,-0.0125658,-0.333459,-0.942681,1
3889,0,0,0,0,388,86,4363,427,4790,-0.00886641,-0.29785,-0.954571,1
6453,0,0,0,0,654,146,7253,710,7963,-0.0143103,-0.275345,-0.961239,1
6514,0,0,0,0,680,152,7346,644,7990,-0.0334539,-0.27823,-0.959932,1
6209,0,0,0,0,671,161,7041,516,7557,-0.0475319,-0.273519,-0.960692,1
6162,0,0,0,0,705,186,7053,462,7515,-0.0958209,-0.342637,-0.934568,1
6649,0,0,0,0,760,181,7590,468,8058,-0.115727,-0.34888,-0.929995,1
3812,0,0,0,0,381,93,4286,200,4486,-0.0548518,-0.292365,-0.954732,1
4136,0,0,0,0,490,125,4751,241,4992,-0.0829131,-0.327121,-0.941338,1
5797,0,0,0,0,813,201,6811,400,7211,-0.101611,-0.473228,-0.87506,1
6091,0,0,0,0,800,221,7112,388,7500,-0.0759688,-0.382185,-0.920958,1
5459,0,0,0,0,484,123,6066,268,6334,-0.0419826,-0.308156,-0.950409,1
3934,0,0,0,0,434,104,4472,249,4721,-0.0311059,-0.311336,-0.949791,1
6250,0,0,0,0,493,124,6867,392,7259,-0.0489997,-0.307418,-0.950312,1
6289,0,0,0,0,402,105,6796,432,7228,-0.0533823,-0.30797,-0.949897,1
5775,0,0,0,0,426,107,6308,465,6773,-0.0473894,-0.318304,-0.946804,1
5916,0,0,0,0,510,136,6562,398,6960,-0.0570328,-0.302813,-0.951342,1
6048,0,0,0,0,661,170,6879,542,7421,-0.0211072,-0.316485,-0.948363,1
6252,0,0,0,0,771,196,7219,669,7888,-0.0221389,-0.293164,-0.955806,1
6541,0,0,0,0,866,219,7626,759,8385,-0.0433299,-0.272446,-0.961195,1
6545,0,0,0,0,961,244,7750,881,8631,0.00890522,-0.300567,-0.953719,1
6853,0,0,0,0,1321,284,8458,985,9443,-0.00877016,-0.315114,-0.949013,1
6440,0,0,0,0,924,241,7605,889,8494,-0.0110179,-0.265968,-0.963919,1
6988,0,0,0,0,961,241,8190,964,9154,-0.0123451,-0.253044,-0.967376,1
6323,0,0,0,0,957,233,7513,1207,8720,0.0224638,-0.258203,-0.965829,1
6579,0,0,0,0,867,222,7668,1190,8858,0.0475094,-0.238441,-0.969994,1
5802,0,0,0,0,838,194,6834,749,7583,0.0121765,-0.214766,-0.97659,1
6465,0,0,0,0,902,214,7581,1231,8812,0.0108637,-0.216848,-0.976145,1
6707,0,0,0,0,816,212,7735,1496,9231,0.00516925,-0.214932,-0.976615,1
6552,0,0,0,0,822,204,7578,1349,8927,0.0320679,-0.227251,-0.973308,1
6529,0,0,0,0,743,199,7471,1323,8794,0.0238844,-0.249844,-0.967992,1
6435,0,0,0,0,695,190,7320,1648,8968,0.043376,-0.244277,-0.968735,1
6737,0,0,0,0,637,156,7530,2037,9567,0.0368973,-0.295918,-0.9545,1
4286,0,0,0,0,451,99,4836,-1000,-1000,-1,-1,-1,1
4309,0,0,0,0,430,99,4838,895,5733,-0.0228812,-0.236976,-0.971246,1
6479,0,0,0,0,715,160,7354,1184,8538,-0.0567749,-0.404284,-0.912869,1
6669,0,0,0,0,740,170,7579,1191,8770,-0.0442351,-0.356594,-0.933212,1
6560,0,0,0,0,494,113,7167,862,8029,-0.0321184,-0.293517,-0.955414,1
3190,0,0,0,0,371,88,3649,730,4379,-0.0302425,-0.253191,-0.966943,1
6365,0,0,0,0,732,178,7275,1719,8994,-0.037726,-0.279501,-0.959404,1
6328,0,0,0,0,668,167,7163,1489,8652,-0.0176534,-0.233194,-0.97227,1
6401,0,0,0,0,597,151,7149,1039,8188,-0.0347479,-0.240138,-0.970117,1
6399,0,0,0,0,550,159,7108,721,7829,-0.0261429,-0.240946,-0.970186,1
5733,0,0,0,0,435,111,6279,819,7098,-0.0130723,-0.240954,-0.970449,1
5845,0,0,0,0,419,105,6369,1154,7523,-0.00934263,-0.247837,-0.968757,1
5875,0,0,0,0,465,120,6460,873,7333,0.0276666,-0.246555,-0.968734,1
5373,0,0,0,0,427,105,5905,440,6345,0.00738628,-0.292216,-0.956324,1
2997,0,0,0,0,384,91,3472,366,3838,-0.0108225,-0.282626,-0.959169,1
6620,0,0,0,0,861,216,7697,658,8355,0.0185578,-0.321441,-0.946748,1
6682,0,0,0,0,928,235,7845,582,8427,0.0250755,-0.328149,-0.944293,1
6233,0,0,0,0,636,162,7031,372,7403,0.00412687,-0.354467,-0.935059,1
3793,0,0,0,0,603,151,4547,317,4864,0.00931687,-0.345487,-0.938377,1
4238,0,0,0,0,618,153,5009,339,5348,0.00541834,-0.353492,-0.935422,1
6200,0,0,0,0,967,243,7410,594,8004,0.0122764,-0.353313,-0.935424,1
7102,0,0,0,0,973,255,8330,553,8883,0.0229848,-0.340153,-0.940089,1
5938,0,0,0,0,980,222,7140,548,7688,0.0284962,-0.332756,-0.942582,1
6510,0,0,0,0,795,194,7499,581,8080,0.0384603,-0.342321,-0.938796,1
6185,0,0,0,0,674,166,7025,625,7650,0.0363581,-0.341458,-0.939194,1
6333,0,0,0,0,605,144,7082,782,7864,0.0364597,-0.351523,-0.935469,1
6366,0,0,0,0,574,137,7077,710,7787,0.0524114,-0.345056,-0.937118,1
6550,0,0,0,0,577,136,7263,715,7978,0.044665,-0.338571,-0.93988,1
6322,0,0,0,0,652,149,7123,638,7761,0.0424626,-0.28925,-0.956311,1
6502,0,0,0,0,688,155,7345,577,7922,0.02407,-0.301488,-0.953166,1
6531,0,0,0,0,661,159,7351,583,7934,0.0237802,-0.316404,-0.948326,1
6118,0,0,0,0,764,169,7051,412,7463,0.0229367,-0.311435,-0.949991,1
5951,0,0,0,0,728,175,6854,296,7150,0.0548654,-0.383416,-0.921945,1
5962,0,0,0,0,973,233,7168,354,7522,0.0343151,-0.316004,-0.948137,1
6059,0,0,0,0,817,201,7077,365,7442,0.0168161,-0.276765,-0.960791,1
6668,0,0,0,0,925,219,7812,373,8185,0.00367439,-0.282371,-0.959298,1
5998,0,0,0,0,829,207,7034,420,7454,0.00125519,-0.332717,-0.943026,1
6241,0,0,0,0,1072,266,7579,665,8244,-0.0255459,-0.28913,-0.956949,1
5388,0,0,0,0,511,126,6025,296,6321,-0.0301164,-0.239061,-0.970537,1
6480,0,0,0,0,654,169,7303,466,7769,-0.0324606,-0.264169,-0.96393,1
3931,0,0,0,0,375,109,4415,354,4769,-0.00242794,-0.254475,-0.967076,1
6310,0,0,0,0,488,126,6924,481,7405,-0.00294061,-0.24392,-0.969791,1
6180,0,0,0,0,431,111,6722,554,7276,-0.00864415,-0.239625,-0.970827,1
6170,0,0,0,0,457,116,6743,669,7412,-0.0208051,-0.246455,-0.968931,1
6360,0,0,0,0,463,144,6967,544,7511,-0.0162896,-0.246198,-0.969083,1
3995,0,0,0,0,342,89,4426,339,4765,0.00943325,-0.232495,-0.972552,1
6006,0,0,0,0,656,195,6857,679,7536,0.015872,-0.271304,-0.962363,1
6244,0,0,0,0,745,213,7202,696,7898,0.0423982,-0.288981,-0.956396,1
6523,0,0,0,0,852,210,7585,688,8273,0.044502,-0.292699,-0.955169,1
6388,0,0,0,0,889,224,7501,832,8333,0.0103943,-0.289852,-0.957015,1
6475,0,0,0,0,1000,235,7710,915,8625,0.0279599,-0.269998,-0.962455,1
6245,0,0,0,0,917,246,7408,1431,8839,0.0291141,-0.304134,-0.952184,1
6426,0,0,0,0,870,219,7515,1809,9324,0.0235872,-0.318921,-0.947488,1
6563,0,0,0,0,804,201,7568,2375,9943,0.00478418,-0.461802,-0.88697,1
6427,0,0,0,0,750,178,7355,-1000,-1000,-1,-1,-1,1
4368,0,0,0,0,459,123,4950,965,5915,-0.0209159,-0.224113,-0.974339,1
6616,0,0,0,0,671,153,7440,-1000,-1000,-1,-1,-1,1
4372,0,0,0,0,445,102,4919,990,5909,-0.00548838,-0.225049,-0.974332,1
5874,0,0,0,0,632,141,6647,1280,7927,-0.00122913,-0.28059,-0.959827,1
6531,0,0,0,0,762,172,7465,1247,8712,-0.00306758,-0.256974,-0.966413,1
6512,0,0,0,0,796,184,7492,1385,8877,-0.0113997,-0.233233,-0.972354,1
6486,0,0,0,0,828,190,7504,1442,8946,-0.0108119,-0.2302,-0.973083,1
6525,0,0,0,0,814,192,7531,1733,9264,-0.0114189,-0.214796,-0.976592,1
6608,0,0,0,0,793,198,7599,1742,9341,-0.00145063,-0.220831,-0.975311,1
6284,0,0,0,0,742,186,7212,1520,8732,0.00673374,-0.221087,-0.975231,1
6419,0,0,0,0,707,202,7328,1155,8483,0.0229659,-0.255072,-0.966649,1
6219,0,0,0,0,628,157,7004,790,7794,0.024293,-0.271903,-0.962018,1
6239,0,0,0,0,540,135,6914,683,7597,0.0272076,-0.286536,-0.957683,1
6379,0,0,0,0,539,126,7044,643,7687,0.0349137,-0.29764,-0.95404,1
6314,0,0,0,0,523,129,6966,663,7629,0.0615775,-0.30533,-0.950253,1
6689,0,0,0,0,605,153,7447,715,8162,0.0300678,-0.328483,-0.944031,1
6319,0,0,0,0,729,182,7230,644,7874,0.0341897,-0.331453,-0.942852,1
6823,0,0,0,0,833,206,7862,625,8487,0.0187061,-0.332553,-0.942899,1
6372,0,0,0,0,1247,224,7843,590,8433,0.0114536,-0.352585,-0.93571,1
6480,0,0,0,0,990,237,7707,507,8214,0.0160159,-0.34294,-0.939221,1
6408,0,0,0,0,1033,241,7682,515,8197,0.018489,-0.338286,-0.940862,1
6316,0,0,0,0,1095,248,7659,517,8176,0.00417387,-0.344227,-0.938877,1
7340,0,0,0,0,1015,274,8629,597,9226,-0.0126464,-0.351508,-0.936099,1
6274,0,0,0,0,943,248,7465,545,8010,0.011836,-0.354234,-0.935082,1
6513,0,0,0,0,909,222,7644,554,8198,0.0283824,-0.369968,-0.928611,1
3915,0,0,0,0,403,100,4418,282,4700,0.0310982,-0.342466,-0.939016,1
2768,0,0,0,0,418,88,3274,285,3559,0.0292164,-0.311303,-0.949862,1
6208,0,0,0,0,681,167,7056,686,7742,0.0305301,-0.301917,-0.952845,1
6602,0,0,0,0,635,153,7390,832,8222,0.0369728,-0.295131,-0.954741,1
6367,0,0,0,0,659,153,7179,794,7973,0.0256346,-0.28564,-0.957994,1
6802,0,0,0,0,688,151,7641,906,8547,0.0279643,-0.275696,-0.960838,1
6431,0,0,0,0,642,147,7220,887,8107,0.0298729,-0.263619,-0.964164,1
6516,0,0,0,0,663,153,7332,887,8219,0.0448709,-0.27798,-0.959538,1
6740,0,0,0,0,690,156,7586,728,8314,0.039772,-0.272764,-0.961259,1
4256,0,0,0,0,457,106,4819,420,5239,0.0404517,-0.264926,-0.96342,1
6658,0,0,0,0,821,172,7651,673,8324,0.0283431,-0.298149,-0.954098,1
7488,0,0,0,0,782,170,8440,548,8988,0.0326088,-0.286138,-0.957633,1
6206,0,0,0,0,783,179,7168,420,7588,0.0442414,-0.344348,-0.937799,1
6281,0,0,0,0,762,180,7223,402,7625,0.0307193,-0.314214,-0.948855,1
6538,0,0,0,0,764,188,7490,296,7786,0.0262235,-0.278618,-0.960044,1
4019,0,0,0,0,529,130,4678,248,4926,0.0252564,-0.251568,-0.96751,1
6391,0,0,0,0,899,211,7501,369,7870,0.0240998,-0.24796,-0.96847,1
6157,0,0,0,0,899,216,7272,475,7747,0.0272783,-0.254092,-0.966795,1
6159,0,0,0,0,911,220,7290,492,7782,0.0397362,-0.271492,-0.96162,1
5897,0,0,0,0,850,213,6960,400,7360,0.0388091,-0.26678,-0.962976,1
6187,0,0,0,0,906,211,7304,397,7701,0.050323,-0.287954,-0.956321,1
6069,0,0,0,0,809,204,7082,388,7470,0.0361283,-0.284113,-0.95811,1
6157,0,0,0,0,783,194,7134,438,7572,0.0184205,-0.27213,-0.962084,1
6240,0,0,0,0,697,178,7115,445,7560,0.00797,-0.253695,-0.967251,1
6018,0,0,0,0,626,155,6799,491,7290,0.0175064,-0.245794,-0.969164,1
6254,0,0,0,0,499,142,6895,583,7478,0.033709,-0.251564,-0.967253,1
6312,0,0,0,0,448,114,6874,493,7367,0.053332,-0.283953,-0.957354,1
6191,0,0,0,0,454,122,6767,544,7311,0.0676217,-0.298686,-0.951953,1
6522,0,0,0,0,693,151,7366,627,7993,0.0251517,-0.284577,-0.958323,1
6166,0,0,0,0,519,135,6820,530,7350,0.0135605,-0.273832,-0.961682,1
6357,0,0,0,0,716,162,7235,554,7789,0.013712,-0.276793,-0.960832,1
6343,0,0,0,0,769,187,7299,669,7968,0.0185667,-0.253408,-0.967181,1
6612,0,0,0,0,825,204,7641,885,8526,0.019329,-0.25356,-0.967127,1
7431,0,0,0,0,949,225,8605,793,9398,0.0269357,-0.256608,-0.96614,1
6651,0,0,0,0,965,230,7846,601,8447,0.0206289,-0.248242,-0.968478,1
6467,0,0,0,0,896,253,7616,690,8306,0.0133257,-0.247075,-0.968905,1
6424,0,0,0,0,919,244,7587,741,8328,0.0222371,-0.242638,-0.969862,1
6533,0,0,0,0,890,217,7640,1038,8678,0.031997,-0.240016,-0.970241,1
6407,0,0,0,0,871,205,7483,1292,8775,0.0289867,-0.280016,-0.959558,1
6517,0,0,0,0,728,214,7459,2373,9832,0.0736057,-0.395531,-0.915498,1
4196,0,0,0,0,476,123,4795,2073,6868,0.101042,-0.419174,-0.902266,1
4103,0,0,0,0,426,98,4627,-1000,-1000,-1,-1,-1,1
6440,0,0,0,0,628,141,7209,1760,8969,0.0320083,-0.232378,-0.972099,1
6587,0,0,0,0,658,145,7390,-1000,-1000,-1,-1,-1,1
6587,0,0,0,0,681,175,7443,1501,8944,0.00830282,-0.21879,-0.975737,1
6774,0,0,0,0,787,172,7733,1201,8934,-0.00652596,-0.2265,-0.973989,1
6618,0,0,0,0,747,171,7536,1318,8854,-0.00649508,-0.224693,-0.974408,1
6569,0,0,0,0,792,180,7541,1310,8851,0.0303104,-0.395383,-0.918016,1
6664,0,0,0,0,809,186,7659,1393,9052,0.0309224,-0.346691,-0.93747,1
4198,0,0,0,0,514,92,4804,958,5762,0.0356075,-0.279767,-0.959407,1
3178,0,0,0,0,394,95,3667,764,4431,0.0326274,-0.229072,-0.972862,1
6685,0,0,0,0,771,190,7646,1650,9296,0.00746687,-0.239439,-0.970883,1
7171,0,0,0,0,692,172,8035,1203,9238,0.0197683,-0.24724,-0.968753,1
6805,0,0,0,0,618,151,7574,826,8400,0.017831,-0.260752,-0.965241,1
6344,0,0,0,0,517,131,6992,767,7759,0.0652279,-0.24515,-0.967288,1
6225,0,0,0,0,445,112,6782,651,7433,0.0303454,-0.275282,-0.960885,1
6350,0,0,0,0,527,124,7001,634,7635,0.0419732,-0.274912,-0.960553,1
6285,0,0,0,0,617,149,7051,682,7733,0.0610401,-0.263657,-0.962683,1
6391,0,0,0,0,706,200,7297,523,7820,0.0163453,-0.300609,-0.953607,1
7350,0,0,0,0,788,228,8366,511,8877,0.0221862,-0.342065,-0.939414,1
6664,0,0,0,0,896,223,7783,480,8263,0.0114042,-0.357152,-0.933977,1
6477,0,0,0,0,943,236,7656,423,8079,0.0151292,-0.355163,-0.934682,1
6337,0,0,0,0,1309,243,7889,471,8360,0.0398454,-0.34961,-0.936048,1
6223,0,0,0,0,935,236,7394,460,7854,0.0309286,-0.32839,-0.944036,1
6301,0,0,0,0,924,230,7455,475,7930,0.0262643,-0.332367,-0.942784,1
6066,0,0,0,0,873,215,7154,452,7606,0.033696,-0.42293,-0.905536,1
5964,0,0,0,0,784,196,6944,456,7400,0.0424048,-0.353314,-0.934543,1
5959,0,0,0,0,704,170,6833,483,7316,0.0342174,-0.32946,-0.943549,1
6164,0,0,0,0,661,175,7000,578,7578,0.0168189,-0.354146,-0.935039,1
6240,0,0,0,0,596,137,6973,771,7744,0.0180471,-0.480311,-0.876912,1
6346,0,0,0,0,598,136,7080,804,7884,0.0233837,-0.435931,-0.899676,1
6527,0,0,0,0,603,140,7270,808,8078,0.0174762,-0.365063,-0.930819,1
4347,0,0,0,0,478,102,4927,499,5426,0.0155197,-0.320882,-0.946992,1
6261,0,0,0,0,682,152,7095,636,7731,0.0184993,-0.307182,-0.951471,1
6294,0,0,0,0,723,154,7171,621,7792,0.0212876,-0.29958,-0.953834,1
6229,0,0,0,0,704,164,7097,625,7722,0.0172283,-0.286097,-0.958046,1
6600,0,0,0,0,738,170,7508,475,7983,0.0150775,-0.280185,-0.959828,1
6248,0,0,0,0,727,174,7149,474,7623,0.01773,-0.265673,-0.9639,1
6150,0,0,0,0,738,181,7069,400,7469,0.0701637,-0.30932,-0.948366,1
6621,0,0,0,0,826,195,7642,342,7984,0.0766264,-0.359316,-0.930065,1
6524,0,0,0,0,876,210,7610,279,7889,0.0886363,-0.393876,-0.91488,1
6157,0,0,0,0,947,225,7329,335,7664,0.066162,-0.322633,-0.944209,1
5998,0,0,0,0,893,234,7125,362,7487,0.0580753,-0.279743,-0.958317,1
6080,0,0,0,0,829,210,7119,365,7484,0.0470277,-0.28103,-0.958546,1
6233,0,0,0,0,800,200,7233,366,7599,0.0669323,-0.302597,-0.950766,1
6010,0,0,0,0,797,197,7004,386,7390,0.0716955,-0.308456,-0.948533,1
7068,0,0,0,0,743,194,8005,361,8366,0.0696833,-0.348173,-0.934837,1
5909,0,0,0,0,706,175,6790,356,7146,0.0550922,-0.307053,-0.950097,1
6197,0,0,0,0,700,178,7075,464,7539,0.0570375,-0.304992,-0.950645,1
5990,0,0,0,0,637,148,6775,421,7196,0.0515558,-0.295156,-0.954057,1
5951,0,0,0,0,522,132,6605,391,6996,0.0602763,-0.286434,-0.956202,1
6212,0,0,0,0,502,124,6838,408,7246,0.0434572,-0.270706,-0.961681,1
6080,0,0,0,0,468,128,6676,572,7248,0.107572,-0.322583,-0.940409,1
5905,0,0,0,0,431,110,6446,403,6849,0.0468169,-0.278602,-0.959265,1
7341,0,0,0,0,462,119,7922,561,8483,0.0387613,-0.245835,-0.968536,1
6108,0,0,0,0,510,133,6751,486,7237,0.0244396,-0.268604,-0.962941,1
6105,0,0,0,0,620,161,6886,517,7403,-0.0114788,-0.272294,-0.962146,1
6193,0,0,0,0,728,184,7105,573,7678,-0.00482037,-0.261069,-0.965308,1
6992,0,0,0,0,857,208,8057,799,8856,0.0311931,-0.269143,-0.962595,1
7182,0,0,0,0,849,241,8272,638,8910,0.0247868,-0.24163,-0.970052,1
6549,0,0,0,0,923,228,7700,798,8498,0.0145209,-0.247069,-0.968889,1
6553,0,0,0,0,852,214,7619,880,8499,0.022997,-0.333229,-0.942565,1
6457,0,0,0,0,817,229,7503,938,8441,0.014238,-0.295045,-0.955377,1
6529,0,0,0,0,801,189,7519,1054,8573,0.00168526,-0.228585,-0.973522,1
5794,0,0,0,0,642,159,6595,2136,8731,0.0207505,-0.224618,-0.974226,1
5804,0,0,0,0,594,142,6540,1719,8259,0.0193947,-0.249447,-0.968194,1
5762,0,0,0,0,573,134,6469,-1000,-1000,-1,-1,-1,1
5720,0,0,0,0,580,139,6439,1680,8119,0.00943562,-0.218844,-0.975714,1
6713,0,0,0,0,662,153,7528,-1000,-1000,-1,-1,-1,1
4243,0,0,0,0,459,106,4808,823,5631,-0.00576396,-0.194865,-0.980813,1
6484,0,0,0,0,709,166,7359,3010,10369,-0.0782014,-0.229039,-0.970271,1
6647,0,0,0,0,715,186,7548,1661,9209,-0.000248167,-0.185103,-0.982719,1
6555,0,0,0,0,737,170,7462,1582,9044,-0.000921694,-0.182217,-0.983258,1
6548,0,0,0,0,733,168,7449,1248,8697,0.00470186,-0.161138,-0.986921,1
6398,0,0,0,0,761,169,7328,1496,8824,0.00335681,-0.142459,-0.989795,1
6456,0,0,0,0,755,166,7377,1778,9155,-0.00582072,-0.116958,-0.99312,1
7083,0,0,0,0,738,210,8031,-1000,-1000,-1,-1,-1,1
3507,0,0,0,0,370,83,3960,485,4445,-0.00813231,-0.11603,-0.993212,1
3561,0,0,0,0,418,95,4074,736,4810,-0.0096337,-0.132599,-0.991123,1
6643,0,0,0,0,757,172,7572,1708,9280,-0.0246323,-0.15506,-0.987598,1
6555,0,0,0,0,770,173,7498,1239,8737,-0.0161983,-0.15621,-0.987591,1
3202,0,0,0,0,371,86,3659,785,4444,-0.00169649,-0.146182,-0.989256,1
3561,0,0,0,0,428,97,4086,1015,5101,0.0156087,-0.148573,-0.988778,1
6252,0,0,0,0,784,168,7204,1304,8508,0.0120554,-0.133174,-0.991019,1
7447,0,0,0,0,737,172,8356,2432,10788,0.0138681,-0.122612,-0.992358,1
6506,0,0,0,0,730,172,7408,1192,8600,0.0022607,-0.127822,-0.991795,1
6733,0,0,0,0,732,174,7639,1377,9016,0.0263487,-0.135446,-0.990434,1
6262,0,0,0,0,991,222,7475,1319,8794,0.0333352,-0.128304,-0.991174,1
6438,0,0,0,0,708,180,7326,1317,8643,0.00744283,-0.11955,-0.9928,1
6466,0,0,0,0,773,171,7410,1198,8608,3.0891e-05,-0.109063,-0.994035,1
6538,0,0,0,0,747,172,7457,1265,8722,0.0119151,-0.136348,-0.990589,1
3552,0,0,0,0,355,84,3991,604,4595,0.00795075,-0.149494,-0.988731,1
2549,0,0,0,0,291,72,2912,-1000,-1000,-1,-1,-1,1
6388,0,0,0,0,725,172,7285,948,8233,-0.00267024,-0.141352,-0.989956,1
6368,0,0,0,0,734,187,7289,-1000,-1000,-1,-1,-1,1
6488,0,0,0,0,731,192,7411,1009,8420,0.0106638,-0.152466,-0.988251,1
3323,0,0,0,0,439,98,3860,582,4442,0.0115434,-0.155757,-0.987728,1
3603,0,0,0,0,430,109,4142,731,4873,0.00756074,-0.187446,-0.982246,1
6552,0,0,0,0,756,175,7483,1229,8712,0.000844884,-0.182903,-0.983131,1
7516,0,0,0,0,788,212,8516,1254,9770,7.69831e-05,-0.197151,-0.980373,1
6499,0,0,0,0,762,189,7450,1303,8753,0.00268335,-0.205368,-0.978681,1
7078,0,0,0,0,766,201,8045,1585,9630,0.00496071,-0.217758,-0.97599,1
6704,0,0,0,0,777,184,7665,1396,9061,0.011985,-0.222722,-0.974808,1
6627,0,0,0,0,758,181,7566,1565,9131,0.0148574,-0.224593,-0.974339,1
6582,0,0,0,0,821,187,7590,1633,9223,0.0196967,-0.215767,-0.976246,1
6479,0,0,0,0,713,179,7371,2142,9513,0.0352633,-0.221717,-0.974473,1
6455,0,0,0,0,667,215,7337,1530,8867,0.0264104,-0.207499,-0.977879,1
6846,0,0,0,0,618,180,7644,1333,8977,0.0326972,-0.208168,-0.977546,1
6284,0,0,0,0,560,140,6984,1068,8052,0.0264243,-0.22005,-0.975131,1
6371,0,0,0,0,524,139,7034,974,8008,0.00466201,-0.256309,-0.966584,1
6421,0,0,0,0,481,126,7028,933,7961,0.0503365,-0.245704,-0.968037,1
6553,0,0,0,0,486,122,7161,782,7943,0.0121704,-0.285044,-0.958437,1
6385,0,0,0,0,543,138,7066,777,7843,0.00469463,-0.28963,-0.957127,1
6278,0,0,0,0,624,159,7061,755,7816,0.0186655,-0.298657,-0.954178,1
6572,0,0,0,0,713,179,7464,715,8179,0.02018,-0.307337,-0.951387,1
6298,0,0,0,0,795,198,7291,719,8010,0.0135707,-0.307381,-0.95149,1
6457,0,0,0,0,905,223,7585,705,8290,0.0151226,-0.281351,-0.959486,1
6288,0,0,0,0,927,249,7464,741,8205,0.0272738,-0.285459,-0.958003,1
6303,0,0,0,0,988,241,7532,536,8068,0.0176419,-0.334681,-0.942166,1
6744,0,0,0,0,911,238,7893,472,8365,0.00141005,-0.348933,-0.937147,1
3946,0,0,0,0,604,148,4698,311,5009,0.00249502,-0.366363,-0.930469,1
3925,0,0,0,0,535,147,4607,292,4899,8.97983e-05,-0.355928,-0.934513,1
6060,0,0,0,0,927,226,7213,537,7750,0.0130579,-0.376975,-0.926132,1
6169,0,0,0,0,879,201,7249,519,7768,0.027395,-0.370802,-0.928308,1
6624,0,0,0,0,811,188,7623,583,8206,0.0358213,-0.361273,-0.931772,1
6122,0,0,0,0,703,168,6993,665,7658,0.0425883,-0.319648,-0.946579,1
6463,0,0,0,0,719,168,7350,815,8165,0.0287796,-0.298935,-0.95384,1
6366,0,0,0,0,730,167,7263,894,8157,0.0138085,-0.308507,-0.951122,1
6478,0,0,0,0,717,165,7360,871,8231,0.0227713,-0.32021,-0.947073,1
6838,0,0,0,0,849,174,7861,765,8626,0.0171435,-0.326579,-0.945014,1
6186,0,0,0,0,801,168,7155,718,7873,0.0322148,-0.334398,-0.941881,1
7560,0,0,0,0,834,178,8572,564,9136,0.0310779,-0.307368,-0.951083,1
6162,0,0,0,0,790,183,7135,471,7606,0.017639,-0.28796,-0.95748,1
6744,0,0,0,0,1182,240,8166,467,8633,0.0104401,-0.253658,-0.967238,1
6220,0,0,0,0,814,189,7223,343,7566,0.00998757,-0.281624,-0.959473,1
6142,0,0,0,0,786,204,7132,375,7507,0.0228551,-0.248771,-0.968292,1
6270,0,0,0,0,814,223,7307,284,7591,0.00431681,-0.251707,-0.967794,1
7079,0,0,0,0,949,216,8244,323,8567,0.0238806,-0.255192,-0.966595,1
6297,0,0,0,0,936,232,7465,282,7747,0.0367389,-0.306185,-0.951263,1
7364,0,0,0,0,901,225,8490,253,8743,0.0173341,-0.264007,-0.964365,1
6074,0,0,0,0,894,216,7184,315,7499,0.0123583,-0.235249,-0.971857,1
6304,0,0,0,0,890,218,7412,364,7776,0.0139805,-0.24661,-0.969014,1
6115,0,0,0,0,938,213,7266,393,7659,0.020991,-0.266701,-0.963551,1
5998,0,0,0,0,789,198,6985,400,7385,0.039132,-0.285258,-0.957652,1
6521,0,0,0,0,743,188,7452,417,7869,0.0393353,-0.288389,-0.956705,1
6059,0,0,0,0,685,173,6917,408,7325,0.0299974,-0.273557,-0.961388,1
6220,0,0,0,0,634,159,7013,407,7420,0.0255855,-0.247131,-0.968644,1
5950,0,0,0,0,585,169,6704,540,7244,0.0283764,-0.238881,-0.970634,1
6181,0,0,0,0,532,135,6848,575,7423,0.0469347,-0.243099,-0.968865,1
7302,0,0,0,0,481,128,7911,651,8562,0.0274141,-0.270732,-0.962264,1
5876,0,0,0,0,457,112,6445,701,7146,0.0228087,-0.266562,-0.963548,1
6825,0,0,0,0,430,111,7366,630,7996,0.0388988,-0.27796,-0.959805,1
6317,0,0,0,0,478,127,6922,580,7502,0.0651118,-0.278833,-0.95813,1
6149,0,0,0,0,610,154,6913,591,7504,0.0649856,-0.296979,-0.95267,1
6278,0,0,0,0,748,191,7217,877,8094,0.0736312,-0.279201,-0.957405,1
6292,0,0,0,0,880,216,7388,795,8183,0.0598967,-0.23565,-0.96999,1
7323,0,0,0,0,941,235,8499,783,9282,0.0568046,-0.253629,-0.965632,1
6397,0,0,0,0,1048,237,7682,1204,8886,0.0789297,-0.271038,-0.959327,1
6356,0,0,0,0,887,220,7463,1237,8700,0.0195698,-0.288189,-0.957373,1
7577,0,0,0,0,814,206,8597,-1000,-1000,-1,-1,-1,1
3280,0,0,0,0,402,98,3780,674,4454,0.0406559,-0.281733,-0.958631,1
8156,0,0,0,0,765,188,9109,3267,12376,0.0429979,-0.354667,-0.934003,1
6488,0,0,0,0,784,187,7459,-1000,-1000,-1,-1,-1,1
7803,0,0,0,0,807,187,8797,1630,10427,0.021575,-0.213241,-0.976761,1
6883,0,0,0,0,1089,249,8221,5119,13340,0.0267789,-0.290957,-0.956361,1
4325,0,0,0,0,529,122,4976,1440,6416,-0.0896337,-0.232305,-0.968504,1
6354,0,0,0,0,834,190,7378,1224,8602,0.0141293,-0.235913,-0.971671,1
6342,0,0,0,0,833,186,7361,1282,8643,0.00633917,-0.236388,-0.971638,1
6552,0,0,0,0,828,193,7573,1480,9053,0.0230932,-0.25225,-0.967386,1
6763,0,0,0,0,831,192,7786,1506,9292,0.013626,-0.255258,-0.966777,1
6453,0,0,0,0,824,199,7476,1412,8888,0.014679,-0.280055,-0.959872,1
6494,0,0,0,0,829,203,7526,1663,9189,0.0315378,-0.306972,-0.951196,1
6394,0,0,0,0,836,213,7443,1197,8640,0.0270669,-0.291039,-0.956328,1
6251,0,0,0,0,760,187,7198,840,8038,0.0359473,-0.274296,-0.960973,1
7011,0,0,0,0,618,151,7780,889,8669,0.0364314,-0.270098,-0.962143,1
6325,0,0,0,0,472,120,6917,791,7708,0.0386243,-0.288578,-0.956677,1
6697,0,0,0,0,436,111,7244,670,7914,0.0171098,-0.30008,-0.953761,1
6170,0,0,0,0,542,135,6847,690,7537,0.0241705,-0.293622,-0.955616,1
6670,0,0,0,0,694,172,7536,585,8121,0.0381789,-0.305167,-0.951533,1
6976,0,0,0,0,755,248,7979,493,8472,0.0336578,-0.294003,-0.955212,1
6334,0,0,0,0,823,214,7371,505,7876,0.0353969,-0.307277,-0.950962,1
6627,0,0,0,0,896,222,7745,479,8224,0.0406205,-0.301206,-0.952694,1
6267,0,0,0,0,919,253,7439,493,7932,0.0609462,-0.304828,-0.950455,1
6273,0,0,0,0,933,238,7444,503,7947,0.0427317,-0.304946,-0.951411,1
7015,0,0,0,0,933,237,8185,530,8715,0.0343898,-0.286998,-0.957314,1
6466,0,0,0,0,985,237,7688,550,8238,0.0371392,-0.38971,-0.920188,1
5959,0,0,0,0,988,236,7183,579,7762,0.0276677,-0.334095,-0.942133,1
5912,0,0,0,0,922,236,7070,544,7614,0.0283612,-0.283306,-0.95861,1
5866,0,0,0,0,903,220,6989,510,7499,0.0440236,-0.34329,-0.938197,1
6000,0,0,0,0,875,214,7089,521,7610,0.0357409,-0.28659,-0.957387,1
5893,0,0,0,0,836,204,6933,549,7482,0.0257479,-0.295555,-0.954979,1
6167,0,0,0,0,867,201,7235,567,7802,0.0168248,-0.317768,-0.948019,1
6254,0,0,0,0,815,198,7267,652,7919,0.00761604,-0.310043,-0.950692,1
6576,0,0,0,0,815,197,7588,801,8389,0.0167064,-0.289419,-0.957057,1
6646,0,0,0,0,798,209,7653,784,8437,0.0145247,-0.375119,-0.926863,1
6592,0,0,0,0,874,192,7658,811,8469,0.0258879,-0.404139,-0.914331,1
5005,0,0,0,0,521,119,5645,534,6179,0.0226728,-0.326444,-0.944945,1
3174,0,0,0,0,367,85,3626,323,3949,0.0221197,-0.297185,-0.954564,1
6378,0,0,0,0,726,198,7302,622,7924,0.0284206,-0.309043,-0.950623,1
6313,0,0,0,0,726,168,7207,623,7830,0.0164273,-0.35116,-0.936171,1
6434,0,0,0,0,774,201,7409,510,7919,0.010374,-0.308272,-0.951242,1
4177,0,0,0,0,508,122,4807,247,5054,0.0044429,-0.241814,-0.970312,1
6044,0,0,0,0,806,209,7059,382,7441,-0.000751763,-0.240941,-0.97054,1
6495,0,0,0,0,789,222,7506,341,7847,0.00379317,-0.238268,-0.971192,1
6781,0,0,0,0,829,209,7819,338,8157,-0.00191838,-0.234396,-0.972139,1
5921,0,0,0,0,895,214,7030,368,7398,0.00464103,-0.242949,-0.970028,1
6276,0,0,0,0,917,221,7414,338,7752,0.0071071,-0.230825,-0.972969,1
6204,0,0,0,0,874,218,7296,368,7664,0.0157622,-0.251857,-0.967636,1
6190,0,0,0,0,878,222,7290,369,7659,0.0265934,-0.284406,-0.958335,1
6163,0,0,0,0,916,221,7300,352,7652,0.00455705,-0.27368,-0.96181,1
6098,0,0,0,0,933,208,7239,472,7711,0.0232778,-0.258826,-0.965643,1
4626,0,0,0,0,560,144,5330,261,5591,0.0220323,-0.268792,-0.962946,1
6126,0,0,0,0,822,219,7167,477,7644,0.0326274,-0.290471,-0.956327,1
6295,0,0,0,0,767,191,7253,395,7648,0.0349675,-0.287397,-0.957173,1
6781,0,0,0,0,638,163,7582,520,8102,0.0433343,-0.292731,-0.955213,1
6254,0,0,0,0,523,137,6914,478,7392,0.036614,-0.301613,-0.952727,1
6168,0,0,0,0,463,116,6747,454,7201,0.0548419,-0.300179,-0.952305,1
5936,0,0,0,0,454,115,6505,547,7052,0.0258855,-0.282576,-0.958896,1
6103,0,0,0,0,537,139,6779,608,7387,0.0435366,-0.404718,-0.913405,1
6485,0,0,0,0,710,181,7376,825,8201,0.0413752,-0.397261,-0.916772,1
4248,0,0,0,0,427,118,4793,369,5162,0.0276284,-0.326807,-0.944687,1
2933,0,0,0,0,426,105,3464,295,3759,0.0198077,-0.294324,-0.9555,1
6486,0,0,0,0,900,229,7615,1152,8767,0.0380178,-0.307354,-0.950835,1
6655,0,0,0,0,929,228,7812,1777,9589,0.0149724,-0.391918,-0.919878,1
6732,0,0,0,0,936,230,7898,-1000,-1000,-1,-1,-1,1
6520,0,0,0,0,925,223,7668,815,8483,0.0257765,-0.272047,-0.961939,1
6882,0,0,0,0,965,231,8078,-1000,-1000,-1,-1,-1,1
7529,0,0,0,0,964,248,8741,1223,9964,0.0259202,-0.258315,-0.965713,1
6998,0,0,0,0,1031,233,8262,2638,10900,0.0221664,-0.217675,-0.97577,1
7217,0,0,0,0,641,164,8022,798,8820,0.0223375,-0.300127,-0.953638,1
3040,0,0,0,0,378,88,3506,904,4410,0.0177847,-0.223361,-0.974574,1
3509,0,0,0,0,476,111,4096,1299,5395,0.0178309,-0.211993,-0.977109,1
6611,0,0,0,0,842,199,7652,2004,9656,0.0272612,-0.227748,-0.973338,1
6751,0,0,0,0,823,196,7770,2073,9843,0.0357968,-0.228467,-0.972893,1
6430,0,0,0,0,834,197,7461,2763,10224,0.0566336,-0.333392,-0.941086,1
6561,0,0,0,0,824,203,7588,1754,9342,0.0420846,-0.279275,-0.959288,1
3199,0,0,0,0,324,78,3601,778,4379,0.055253,-0.220264,-0.973874,1
2731,0,0,0,0,302,74,3107,580,3687,0.0614152,-0.196229,-0.978633,1
6517,0,0,0,0,655,183,7355,1107,8462,0.0541705,-0.227862,-0.972185,1
6690,0,0,0,0,609,143,7442,1105,8547,0.0357852,-0.252857,-0.966842,1
3135,0,0,0,0,249,63,3447,549,3996,0.0435418,-0.24151,-0.969421,1
6705,0,0,0,0,452,115,7272,694,7966,0.0403474,-0.246473,-0.968309,1
7220,0,0,0,0,515,123,7858,662,8520,0.0467988,-0.245505,-0.968265,1
6550,0,0,0,0,536,133,7219,522,7741,0.0574654,-0.251479,-0.966155,1
6912,0,0,0,0,601,153,7666,614,8280,0.0647652,-0.24727,-0.96678,1
6155,0,0,0,0,694,171,7020,588,7608,0.0434225,-0.276102,-0.960147,1
6323,0,0,0,0,791,191,7305,484,7789,0.0643945,-0.265653,-0.961916,1
6385,0,0,0,0,864,212,7461,410,7871,0.0646642,-0.273623,-0.959661,1
6487,0,0,0,0,985,244,7716,412,8128,0.0632941,-0.318608,-0.945771,1
6392,0,0,0,0,1102,262,7756,419,8175,0.0623176,-0.335656,-0.939921,1
6253,0,0,0,0,1157,285,7695,418,8113,0.077524,-0.344179,-0.935698,1
6628,0,0,0,0,1183,296,8107,363,8470,0.0505379,-0.360164,-0.931519,1
6250,0,0,0,0,1194,296,7740,412,8152,0.0295513,-0.39028,-0.920222,1
6637,0,0,0,0,1257,314,8208,461,8669,0.0490528,-0.384028,-0.922018,1
6580,0,0,0,0,1228,308,8116,449,8565,0.0397216,-0.372572,-0.927153,1
7115,0,0,0,0,1246,307,8668,584,9252,0.0230207,-0.363398,-0.93135,1
7068,0,0,0,0,1227,290,8585,784,9369,0.0158789,-0.343275,-0.939101,1
7509,0,0,0,0,766,179,8454,529,8983,0.0161657,-0.347318,-0.937608,1
5329,0,0,0,0,707,162,6198,480,6678,0.0220483,-0.336518,-0.941419,1
7073,0,0,0,0,944,203,8220,584,8804,0.0217545,-0.323592,-0.945947,1
5610,0,0,0,0,804,182,6596,578,7174,0.0208174,-0.308717,-0.950926,1
6715,0,0,0,0,990,219,7924,655,8579,0.0312294,-0.301906,-0.952826,1
6356,0,0,0,0,874,203,7433,562,7995,0.0369335,-0.314517,-0.948533,1
7192,0,0,0,0,893,193,8278,451,8729,0.0465225,-0.292371,-0.955173,1
6175,0,0,0,0,821,196,7192,335,7527,0.0411752,-0.293795,-0.954981,1
6436,0,0,0,0,886,238,7560,313,7873,0.0447291,-0.297351,-0.95372,1
7164,0,0,0,0,918,233,8315,338,8653,0.0281694,-0.277707,-0.960253,1
6104,0,0,0,0,851,209,7164,417,7581,0.0405096,-0.316723,-0.947653,1
6399,0,0,0,0,791,202,7392,392,7784,0.0409954,-0.301517,-0.952579,1
6135,0,0,0,0,1061,238,7434,442,7876,0.0395413,-0.289052,-0.956496,1
6200,0,0,0,0,658,164,7022,405,7427,0.0444707,-0.268017,-0.962387,1
7229,0,0,0,0,615,148,7992,393,8385,0.0112982,-0.274608,-0.96149,1
6044,0,0,0,0,522,128,6694,528,7222,0.00649838,-0.260863,-0.965354,1
6155,0,0,0,0,569,126,6850,464,7314,0.0227811,-0.265082,-0.963957,1
6168,0,0,0,0,497,128,6793,400,7193,0.026997,-0.241329,-0.970068,1
5989,0,0,0,0,549,139,6677,435,7112,0.0384616,-0.25848,-0.965251,1
6083,0,0,0,0,636,160,6879,488,7367,-0.0147334,-0.267152,-0.963542,1
6153,0,0,0,0,744,186,7083,590,7673,-0.0132486,-0.261407,-0.965138,1
7453,0,0,0,0,907,215,8575,735,9310,0.0198744,-0.227842,-0.973495,1
6594,0,0,0,0,970,249,7813,664,8477,0.0331581,-0.225503,-0.973678,1
7780,0,0,0,0,1058,341,9179,576,9755,0.0516742,-0.214405,-0.975377,1
7194,0,0,0,0,1162,284,8640,744,9384,-0.0121204,-0.213296,-0.976912,1
7062,0,0,0,0,1218,265,8545,948,9493,-0.0306191,-0.213524,-0.976458,1
4735,0,0,0,0,783,200,5718,1172,6890,-0.0785925,-0.10688,-0.991161,1
6921,0,0,0,0,1203,297,8421,1630,10051,-0.130347,-0.106253,-0.985759,1
6742,0,0,0,0,1109,280,8131,1089,9220,-0.186421,0.115145,-0.975699,1
7231,0,0,0,0,1230,282,8743,734,9477,0.0490772,-0.238618,-0.969873,1
6977,0,0,0,0,1091,273,8341,936,9277,0.0166378,-0.35307,-0.935449,1
7051,0,0,0,0,1144,202,8397,1405,9802,0.0115734,-0.356844,-0.934092,1
3270,0,0,0,0,452,108,3830,-1000,-1000,-1,-1,-1,1
2280,0,0,0,0,362,87,2729,359,3088,0.000732138,-0.204373,-0.978893,1
7019,0,0,0,0,1291,265,8575,884,9459,-0.00977124,-0.0898131,-0.995911,1
6980,0,0,0,0,1166,271,8417,3377,11794,-0.00867201,-0.204195,-0.978892,1
6028,0,0,0,0,1039,222,7289,864,8153,-0.00589287,-0.0874361,-0.996153,1
6802,0,0,0,0,1313,232,8347,2411,10758,0.00704757,-0.211361,-0.977383,1
6739,0,0,0,0,924,210,7873,1760,9633,0.00754676,-0.169296,-0.985536,1
3817,0,0,0,0,425,98,4340,749,5089,0.00397436,-0.105219,-0.994441,1
2601,0,0,0,0,351,79,3031,483,3514,-0.00332793,-0.0652714,-0.997862,1
6786,0,0,0,0,918,211,7915,1340,9255,0.0104904,-0.187503,-0.982208,1
6668,0,0,0,0,915,221,7804,1173,8977,0.00209626,-0.144362,-0.989523,1
6038,0,0,0,0,593,146,6777,846,7623,0.00548006,-0.106922,-0.994252,1
6689,0,0,0,0,888,213,7790,1043,8833,0.0275917,-0.139957,-0.989773,1
6451,0,0,0,0,760,187,7398,907,8305,0.0115589,-0.150598,-0.988528,1
6333,0,0,0,0,630,153,7116,880,7996,0.00704981,-0.162241,-0.986726,1
6718,0,0,0,0,599,141,7458,906,8364,-0.00230323,-0.206463,-0.978452,1
6354,0,0,0,0,617,149,7120,838,7958,-0.00619247,-0.217425,-0.976057,1
6724,0,0,0,0,791,195,7710,1038,8748,0.00337589,-0.223649,-0.974664,1
6591,0,0,0,0,1034,260,7885,775,8660,0.0102711,-0.233598,-0.972279,1
6940,0,0,0,0,1420,310,8670,806,9476,0.0120167,-0.213441,-0.976882,1
7207,0,0,0,0,1376,337,8920,739,9659,0.00972761,-0.200968,-0.97955,1
6867,0,0,0,0,1506,362,8735,828,9563,0.0261907,-0.208709,-0.977627,1
7366,0,0,0,0,1521,391,9278,864,10142,0.029658,-0.215693,-0.976011,1
6981,0,0,0,0,1513,379,8873,1000,9873,0.0192019,-0.186531,-0.982261,1
7022,0,0,0,0,1521,440,8983,845,9828,0.0113609,-0.177778,-0.984005,1
7026,0,0,0,0,1466,369,8861,929,9790,0.0194286,-0.168524,-0.985506,1
6954,0,0,0,0,1437,382,8773,780,9553,0.0397643,-0.277361,-0.959942,1
7011,0,0,0,0,1393,360,8764,546,9310,0.035766,-0.264165,-0.963814,1
6563,0,0,0,0,1293,315,8171,531,8702,0.0405216,-0.282446,-0.958427,1
7034,0,0,0,0,1277,314,8625,515,9140,0.0587588,-0.271806,-0.960557,1
7692,0,0,0,0,1268,312,9272,502,9774,0.0526126,-0.291896,-0.955002,1
6704,0,0,0,0,843,208,7755,349,8104,0.0423526,-0.288449,-0.956558,1
5123,0,0,0,0,879,217,6219,411,6630,0.0409736,-0.289329,-0.956352,1
6762,0,0,0,0,1326,327,8415,774,9189,0.0502937,-0.279367,-0.958866,1
7047,0,0,0,0,1265,292,8604,812,9416,0.0383816,-0.282066,-0.958627,1
6739,0,0,0,0,1181,279,8199,809,9008,0.0310069,-0.26364,-0.964123,1
6755,0,0,0,0,1122,260,8137,762,8899,0.0315985,-0.255888,-0.96619,1
6725,0,0,0,0,1068,255,8048,748,8796,0.0289846,-0.252716,-0.967106,1
6451,0,0,0,0,1045,241,7737,680,8417,0.0312797,-0.248802,-0.968049,1
6635,0,0,0,0,972,232,7839,590,8429,0.0262395,-0.248634,-0.968242,1
6568,0,0,0,0,919,224,7711,639,8350,0.0238711,-0.252464,-0.967312,1
6315,0,0,0,0,903,206,7424,643,8067,0.0258531,-0.258618,-0.965634,1
6974,0,0,0,0,943,238,8155,687,8842,0.0159338,-0.265848,-0.963883,1
6573,0,0,0,0,989,221,7783,750,8533,0.0084169,-0.246836,-0.969021,1
6830,0,0,0,0,933,265,8028,545,8573,0.0346705,-0.226522,-0.973389,1
6389,0,0,0,0,952,225,7566,319,7885,0.00657854,-0.201815,-0.979402,1
6591,0,0,0,0,966,223,7780,404,8184,0.00644918,-0.16468,-0.986326,1
5804,0,0,0,0,834,203,6841,359,7200,0.00660738,-0.131826,-0.991251,1
6297,0,0,0,0,992,231,7520,424,7944,0.0061114,-0.132264,-0.991196,1
6336,0,0,0,0,1044,234,7614,396,8010,0.000238812,-0.135615,-0.990762,1
6338,0,0,0,0,941,227,7506,421,7927,0.00646696,-0.112654,-0.993613,1
6143,0,0,0,0,978,229,7350,403,7753,0.0118577,-0.1206,-0.99263,1
7147,0,0,0,0,1015,231,8393,398,8791,0.0122469,-0.138026,-0.990353,1
6130,0,0,0,0,984,235,7349,406,7755,0.00844022,-0.146665,-0.98915,1
6527,0,0,0,0,1012,243,7782,393,8175,0.0029172,-0.129502,-0.991575,1
6381,0,0,0,0,997,239,7617,418,8035,-3.89723e-05,-0.132587,-0.991171,1
6350,0,0,0,0,1001,262,7613,506,8119,-0.00468604,-0.107816,-0.99416,1
5050,0,0,0,0,701,164,5915,325,6240,-7.78712e-05,-0.0969004,-0.995294,1
3071,0,0,0,0,504,122,3697,299,3996,-0.00204339,-0.0745891,-0.997212,1
6193,0,0,0,0,1006,264,7463,564,8027,-0.00829783,-0.0445014,-0.998975,1
6097,0,0,0,0,1020,249,7366,647,8013,-0.00265637,0.00630959,-0.999977,1
6709,0,0,0,0,992,242,7943,626,8569,-0.00514775,-0.0146014,-0.99988,1
6630,0,0,0,0,987,243,7860,672,8532,-0.00846625,-0.0273299,-0.999591,1
6132,0,0,0,0,1021,245,7398,669,8067,-0.00886701,-0.0217679,-0.999724,1
6560,0,0,0,0,997,242,7799,674,8473,-0.0074948,-0.0116292,-0.999904,1
6124,0,0,0,0,998,242,7364,635,7999,-0.00621169,-0.00130492,-0.99998,1
6340,0,0,0,0,993,245,7578,622,8200,-0.00560277,-0.0035298,-0.999978,1
6272,0,0,0,0,993,240,7505,683,8188,-0.00573029,-0.00424733,-0.999975,1
6620,0,0,0,0,995,246,7861,684,8545,-0.00780543,-0.00974962,-0.999922,1
6520,0,0,0,0,1067,242,7829,628,8457,-0.00868389,0.00196896,-0.99996,1
6443,0,0,0,0,1019,246,7708,627,8335,-0.00969232,-0.0122613,-0.999878,1
6340,0,0,0,0,989,245,7574,631,8205,-0.0106603,-0.00988667,-0.999894,1
6332,0,0,0,0,986,244,7562,639,8201,-0.0149363,-0.0131567,-0.999802,1
6225,0,0,0,0,992,242,7459,702,8161,-0.0112769,-0.00441375,-0.999927,1
6134,0,0,0,0,1023,244,7401,618,8019,-0.0110783,-0.00431697,-0.999929,1
4138,0,0,0,0,682,160,4980,450,5430,-0.0145389,-0.0204779,-0.999685,1
6365,0,0,0,0,989,244,7598,657,8255,-0.0153053,-0.0230023,-0.999618,1
6656,0,0,0,0,1330,253,8239,662,8901,-0.0129467,-0.0108071,-0.999858,1
6489,0,0,0,0,992,246,7727,693,8420,-0.0152903,-0.0212168,-0.999658,1
7055,0,0,0,0,992,243,8290,707,8997,-0.0111176,0.00052774,-0.999938,1
6279,0,0,0,0,992,245,7516,674,8190,-0.0120619,-0.00887866,-0.999888,1
6284,0,0,0,0,989,239,7512,746,8258,-0.0141772,-0.0178759,-0.99974,1
6407,0,0,0,0,992,246,7645,673,8318,-0.0124444,-0.0332136,-0.999371,1
7409,0,0,0,0,1022,262,8693,764,9457,-0.0109973,-0.0115161,-0.999873,1
6182,0,0,0,0,1135,242,7559,644,8203,-0.0105669,0.00346066,-0.999938,1
6188,0,0,0,0,1023,244,7455,718,8173,-0.0149136,-0.0198583,-0.999692,1
6131,0,0,0,0,999,241,7371,743,8114,-0.0142879,-0.00859312,-0.999861,1
6330,0,0,0,0,1060,258,7648,694,8342,-0.0137208,-0.0127139,-0.999825,1
6664,0,0,0,0,1035,245,7944,725,8669,-0.0113142,0.00122648,-0.999935,1
6200,0,0,0,0,1030,281,7511,654,8165,-0.0120677,-0.0144294,-0.999823,1
6169,0,0,0,0,1024,245,7438,695,8133,-0.00974473,-0.0116475,-0.999885,1
6271,0,0,0,0,1035,246,7552,619,8171,-0.00985243,-0.00549435,-0.999937,1
6239,0,0,0,0,1005,245,7489,648,8137,-0.00972492,-0.0253311,-0.999632,1
6282,0,0,0,0,1033,245,7560,650,8210,-0.00857836,-0.00101925,-0.999963,1
4189,0,0,0,0,679,176,5044,409,5453,-0.0145031,-0.00866646,-0.999857,1
4048,0,0,0,0,672,166,4886,431,5317,-0.0160265,-0.0028864,-0.999867,1
6252,0,0,0,0,1039,244,7535,697,8232,-0.0150445,0.000128939,-0.999887,1
6500,0,0,0,0,1014,259,7773,705,8478,-0.0117411,-0.0219598,-0.99969,1
6238,0,0,0,0,1027,267,7532,662,8194,-0.00805514,-0.0094259,-0.999923,1
6085,0,0,0,0,1354,335,7774,797,8571,-0.0118039,-0.0212918,-0.999704,1
6140,0,0,0,0,1439,280,7859,742,8601,-0.0117235,-0.0194304,-0.999742,1
6292,0,0,0,0,1019,247,7558,534,8092,-0.0233904,-0.0372177,-0.999033,1
6206,0,0,0,0,1077,261,7544,573,8117,-0.0193715,-0.0567375,-0.998201,1
6374,0,0,0,0,1115,267,7756,594,8350,-0.0153559,-0.0921204,-0.99563,1
7314,0,0,0,0,1103,309,8726,571,9297,-0.0283632,-0.0993965,-0.994644,1
6404,0,0,0,0,1110,273,7787,611,8398,-0.0207734,-0.120347,-0.992515,1
6471,0,0,0,0,1078,269,7818,508,8326,-0.0168947,-0.140362,-0.989956,1
6255,0,0,0,0,1033,255,7543,567,8110,-0.0238685,-0.129227,-0.991328,1
6330,0,0,0,0,944,254,7528,525,8053,-0.0215841,-0.126813,-0.991692,1
6959,0,0,0,0,877,241,8077,499,8576,-0.0113706,-0.179381,-0.983714,1
6497,0,0,0,0,844,213,7554,499,8053,0.0081416,-0.208437,-0.978002,1
6521,0,0,0,0,850,208,7579,603,8182,0.00939565,-0.20157,-0.979429,1
6743,0,0,0,0,834,258,7835,615,8450,-0.00212148,-0.209934,-0.977713,1
6446,0,0,0,0,774,191,7411,685,8096,-0.011483,-0.164071,-0.986382,1
6535,0,0,0,0,789,192,7516,693,8209,-0.0103228,-0.136399,-0.9906,1
6450,0,0,0,0,805,197,7452,744,8196,-0.00454876,-0.118947,-0.99289,1
6721,0,0,0,0,852,216,7789,721,8510,0.00192312,-0.135757,-0.99074,1
6906,0,0,0,0,993,237,8136,823,8959,-0.00254577,-0.114408,-0.993431,1
6839,0,0,0,0,1100,253,8192,884,9076,-0.00976424,-0.100754,-0.994863,1
7306,0,0,0,0,1065,283,8654,845,9499,-0.0161223,-0.111591,-0.993623,1
4520,0,0,0,0,739,187,5446,568,6014,-0.0199159,-0.10236,-0.994548,1
6871,0,0,0,0,1168,284,8323,862,9185,-0.0163109,-0.111679,-0.99361,1
6968,0,0,0,0,1722,380,9070,1088,10158,-0.0120822,-0.113368,-0.99348,1
6913,0,0,0,0,1164,315,8392,859,9251,-0.00546436,-0.120565,-0.99269,1
6825,0,0,0,0,1191,301,8317,853,9170,-0.0033297,-0.131559,-0.991303,1
6861,0,0,0,0,1154,286,8301,952,9253,0.016451,-0.224014,-0.974447,1
6991,0,0,0,0,1022,188,8201,693,8894,0.0105875,-0.204101,-0.978893,1
4542,0,0,0,0,796,190,5528,1374,6902,0.0184908,-0.201624,-0.979288,1
5280,0,0,0,0,812,212,6304,2148,8452,0.124672,-0.348197,-0.929094,1
6974,0,0,0,0,1247,343,8564,1750,10314,0.175829,-0.471744,-0.864026,1
8056,0,0,0,0,1123,246,9425,671,10096,-0.0210551,-0.0814543,-0.996455,2
4662,0,0,0,0,921,222,5805,1368,7173,0.00374483,-0.176694,-0.984259,2
7085,0,0,0,0,1385,345,8815,1136,9951,0.00713951,-0.0838549,-0.996452,2
7117,0,0,0,0,1442,357,8916,4504,13420,0.00384363,-0.193824,-0.981029,2
7249,0,0,0,0,1383,326,8958,828,9786,0.00281688,-0.0639477,-0.997949,2
7106,0,0,0,0,1404,324,8834,2436,11270,-0.00428482,-0.0670191,-0.997743,2
7012,0,0,0,0,1339,308,8659,2438,11097,-0.0226935,-0.13833,-0.990126,2
6988,0,0,0,0,1261,288,8537,1915,10452,-0.01202,-0.10999,-0.99386,2
3437,0,0,0,0,581,105,4123,1179,5302,-0.00682023,-0.0671318,-0.997721,2
3652,0,0,0,0,685,174,4511,1227,5738,-0.00246727,-0.0502699,-0.998733,2
6887,0,0,0,0,1131,270,8288,1682,9970,0.00504139,-0.0608777,-0.998132,2
7117,0,0,0,0,1100,245,8462,1531,9993,0.0115032,-0.0616381,-0.998032,2
6845,0,0,0,0,1158,242,8245,1494,9739,0.0195199,-0.0859316,-0.99611,2
6906,0,0,0,0,1119,243,8268,1832,10100,0.0177941,-0.0705222,-0.997351,2
6887,0,0,0,0,1124,243,8254,1650,9904,0.0338291,-0.111306,-0.99321,2
4272,0,0,0,0,496,121,4889,599,5488,0.0238332,-0.0528008,-0.998321,2
3810,0,0,0,0,572,137,4519,667,5186,0.0185851,-0.0607084,-0.997982,2
6495,0,0,0,0,976,241,7712,1069,8781,0.0228975,-0.0788255,-0.996625,2
8152,0,0,0,0,922,229,9303,1104,10407,0.0192829,-0.0950825,-0.995283,2
6696,0,0,0,0,861,210,7767,994,8761,0.0112271,-0.114443,-0.993366,2
6754,0,0,0,0,868,195,7817,899,8716,0.0163185,-0.104895,-0.994349,2
6448,0,0,0,0,508,126,7082,713,7795,0.0365464,-0.107946,-0.993485,2
3249,0,0,0,0,393,99,3741,550,4291,0.0382155,-0.0805539,-0.996017,2
6688,0,0,0,0,882,216,7786,848,8634,0.0539217,-0.225659,-0.972713,2
7336,0,0,0,0,1009,248,8593,841,9434,0.0594706,-0.213794,-0.975067,2
7148,0,0,0,0,1158,280,8586,754,9340,0.0498478,-0.183129,-0.981824,2
4622,0,0,0,0,841,156,5619,392,6011,0.0519564,-0.159086,-0.985897,2
3418,0,0,0,0,656,173,4247,383,4630,0.0537958,-0.147529,-0.987594,2
6934,0,0,0,0,1372,341,8647,786,9433,0.0512143,-0.214936,-0.975284,2
6647,0,0,0,0,1416,355,8418,914,9332,0.0558632,-0.206715,-0.976805,2
6603,0,0,0,0,1466,356,8425,844,9269,0.0462861,-0.22604,-0.973018,2
6730,0,0,0,0,1486,366,8582,894,9476,0.0338278,-0.262366,-0.964375,2
6554,0,0,0,0,1563,377,8494,665,9159,0.0259689,-0.254945,-0.966607,2
5706,0,0,0,0,1277,318,7301,444,7745,0.0212131,-0.285605,-0.958113,2
6464,0,0,0,0,1525,340,8329,561,8890,0.021841,-0.263267,-0.964476,2
6718,0,0,0,0,1384,353,8455,730,9185,0.0175221,-0.265202,-0.964034,2
7242,0,0,0,0,1454,374,9070,1258,10328,0.0129258,-0.256321,-0.966505,2
6769,0,0,0,0,939,238,7946,943,8889,0.0350164,-0.372017,-0.927565,2
3974,0,0,0,0,626,157,4757,354,5111,0.022868,-0.204428,-0.978615,2
7898,0,0,0,0,1177,309,9384,1961,11345,0.0231286,-0.239479,-0.970626,2
4542,0,0,0,0,742,176,5460,760,6220,0.0259069,-0.209018,-0.977569,2
6636,0,0,0,0,1185,372,8193,667,8860,0.0188483,-0.218621,-0.975628,2
7243,0,0,0,0,1311,299,8853,639,9492,0.0174793,-0.223406,-0.974569,2
6556,0,0,0,0,1339,314,8209,648,8857,0.0175258,-0.206065,-0.978381,2
7408,0,0,0,0,1329,326,9063,621,9684,0.0183366,-0.168795,-0.985481,2
6330,0,0,0,0,1270,305,7905,839,8744,0.0447432,-0.206837,-0.977352,2
6646,0,0,0,0,1228,300,8174,722,8896,0.0502232,-0.199573,-0.978595,2
6387,0,0,0,0,1185,284,7856,759,8615,0.0458783,-0.163337,-0.985503,2
6401,0,0,0,0,1105,260,7766,949,8715,0.0319886,-0.148162,-0.988446,2
6612,0,0,0,0,1296,257,8165,810,8975,0.0396371,-0.174336,-0.983888,2
6551,0,0,0,0,1013,271,7835,803,8638,0.0220194,-0.131653,-0.991051,2
6664,0,0,0,0,968,239,7871,822,8693,0.0330207,-0.13447,-0.990367,2
6378,0,0,0,0,941,234,7553,770,8323,0.0336023,-0.123016,-0.991836,2
6503,0,0,0,0,923,229,7655,715,8370,0.0454971,-0.122362,-0.991442,2
7420,0,0,0,0,957,225,8602,600,9202,0.0571202,-0.133152,-0.989448,2
6690,0,0,0,0,951,226,7867,638,8505,0.0489145,-0.112467,-0.992451,2
7678,0,0,0,0,963,245,8886,626,9512,0.0469337,-0.114546,-0.992309,2
6743,0,0,0,0,1069,262,8074,420,8494,0.0325788,-0.110102,-0.993386,2
6929,0,0,0,0,1369,378,8676,626,9302,0.0258931,-0.111937,-0.993378,2
6668,0,0,0,0,1288,285,8241,698,8939,0.011887,-0.105241,-0.994376,2
6843,0,0,0,0,1150,286,8279,645,8924,0.0154668,-0.103863,-0.994471,2
6964,0,0,0,0,1248,284,8496,791,9287,0.0153723,-0.104924,-0.994361,2
6852,0,0,0,0,1323,293,8468,801,9269,0.0282073,-0.120837,-0.992272,2
7134,0,0,0,0,1221,297,8652,873,9525,0.0166161,-0.125107,-0.992004,2
7005,0,0,0,0,1268,305,8578,803,9381,0.0161758,-0.145497,-0.989226,2
6051,0,0,0,0,1100,272,7423,952,8375,0.0108591,-0.0912944,-0.995765,2
6884,0,0,0,0,1297,342,8523,925,9448,0.0362118,-0.111578,-0.993096,2
7054,0,0,0,0,1287,318,8659,971,9630,0.0979606,-0.224602,-0.969514,2
7482,0,0,0,0,1394,367,9243,695,9938,0.0412521,-0.119346,-0.991995,2
3666,0,0,0,0,671,162,4499,676,5175,0.0492933,-0.131717,-0.990061,2
4027,0,0,0,0,786,191,5004,366,5370,0.0203634,-0.067499,-0.997512,2
7412,0,0,0,0,1376,332,9120,724,9844,0.0302186,-0.0770541,-0.996569,2
7117,0,0,0,0,1532,382,9031,940,9971,0.0283758,-0.104352,-0.994136,2
8192,0,0,0,0,1336,372,9900,1168,11068,0.013731,-0.100851,-0.994807,2
7016,0,0,0,0,1328,305,8649,1329,9978,0.00158815,-0.0948977,-0.995486,2
6915,0,0,0,0,1169,301,8385,1449,9834,0.0205033,-0.216183,-0.976138,2
6862,0,0,0,0,1139,273,8274,1470,9744,0.0195613,-0.204285,-0.978716,2
3349,0,0,0,0,524,124,3997,628,4625,0.014428,-0.114564,-0.993311,2
2820,0,0,0,0,454,109,3383,653,4036,0.0116396,-0.0838869,-0.996407,2
6559,0,0,0,0,1023,257,7839,1309,9148,0.00103689,-0.130739,-0.991416,2
6892,0,0,0,0,1065,292,8249,1238,9487,0.00591782,-0.135136,-0.990809,2
6755,0,0,0,0,943,236,7934,1130,9064,0.00770676,-0.133116,-0.99107,2
6580,0,0,0,0,918,222,7720,1023,8743,0.000928599,-0.130836,-0.991404,2
6910,0,0,0,0,813,225,7948,958,8906,0.00808837,-0.129949,-0.991488,2
6682,0,0,0,0,836,232,7750,1018,8768,0.0340212,-0.131998,-0.990666,2
6561,0,0,0,0,780,209,7550,836,8386,0.0400154,-0.116992,-0.992326,2
6773,0,0,0,0,795,189,7757,803,8560,0.0478567,-0.108319,-0.992964,2
6612,0,0,0,0,811,199,7622,760,8382,0.0656914,-0.131995,-0.989071,2
6625,0,0,0,0,928,234,7787,669,8456,0.0704477,-0.129332,-0.989096,2
6581,0,0,0,0,938,229,7748,542,8290,0.0641477,-0.154343,-0.985933,2
6761,0,0,0,0,1023,283,8067,472,8539,0.0718943,-0.195555,-0.978054,2
6762,0,0,0,0,1189,290,8241,508,8749,0.0670818,-0.202987,-0.976881,2
6729,0,0,0,0,1333,353,8415,514,8929,0.0591,-0.203763,-0.977235,2
6751,0,0,0,0,1450,366,8567,488,9055,0.0723992,-0.18942,-0.979223,2
6489,0,0,0,0,1456,362,8307,462,8769,0.0671813,-0.180869,-0.98121,2
6611,0,0,0,0,1479,378,8468,465,8933,0.0600106,-0.175479,-0.982653,2
6505,0,0,0,0,1448,381,8334,446,8780,0.0389901,-0.162487,-0.98594,2
6825,0,0,0,0,1459,371,8655,473,9128,0.0359868,-0.186522,-0.981792,2
6821,0,0,0,0,1634,362,8817,433,9250,0.0329624,-0.224724,-0.973865,2
6633,0,0,0,0,1606,400,8639,489,9128,0.0337337,-0.224457,-0.9739,2
6816,0,0,0,0,1599,413,8828,474,9302,0.0134382,-0.231085,-0.972841,2
7403,0,0,0,0,1727,388,9518,780,10298,0.024988,-0.286943,-0.957622,2
6109,0,0,0,0,1059,261,7429,616,8045,0.0163972,-0.218159,-0.975775,2
4045,0,0,0,0,776,188,5009,449,5458,0.0274086,-0.182307,-0.98286,2
7208,0,0,0,0,1589,377,9174,935,10109,0.0254743,-0.175503,-0.984149,2
6968,0,0,0,0,1485,356,8809,818,9627,0.00920181,-0.163125,-0.986562,2
7077,0,0,0,0,1439,415,8931,1123,10054,0.0111065,-0.137669,-0.990416,2
7043,0,0,0,0,1401,371,8815,901,9716,0.00868575,-0.119097,-0.992845,2
6795,0,0,0,0,1406,351,8552,953,9505,-0.00355627,-0.108854,-0.994051,2
6734,0,0,0,0,1339,308,8381,1033,9414,-0.00651654,-0.0914388,-0.995789,2
6453,0,0,0,0,1143,279,7875,851,8726,-0.00747663,-0.0725146,-0.997339,2
6520,0,0,0,0,1161,299,7980,739,8719,-0.0103458,-0.0650037,-0.997831,2
6477,0,0,0,0,1148,273,7898,862,8760,-0.00984339,-0.0608198,-0.9981,2
6719,0,0,0,0,1256,287,8262,901,9163,-0.0113306,-0.0556567,-0.998386,2
6957,0,0,0,0,1177,286,8420,982,9402,-0.0298679,-0.0565835,-0.997951,2
6841,0,0,0,0,778,207,7826,724,8550,-0.0253389,-0.0425692,-0.998772,2
3703,0,0,0,0,558,147,4408,496,4904,-0.0121581,-0.0356926,-0.999289,2
3689,0,0,0,0,683,157,4529,526,5055,-0.0170551,-0.0292932,-0.999425,2
6606,0,0,0,0,1180,279,8065,996,9061,-0.00635066,-0.0214379,-0.99975,2
6407,0,0,0,0,1173,184,7764,740,8504,-0.0043708,-0.0151209,-0.999876,2
6551,0,0,0,0,1210,309,8070,1049,9119,-0.00219428,-0.0105239,-0.999942,2
7043,0,0,0,0,1144,288,8475,1045,9520,0.00124447,-0.0122361,-0.999924,2
6584,0,0,0,0,1182,292,8058,985,9043,-0.00193787,-0.0183159,-0.99983,2
5553,0,0,0,0,813,198,6564,679,7243,-0.00230992,-0.023864,-0.999713,2
3275,0,0,0,0,597,147,4019,500,4519,-0.0042818,-0.0273974,-0.999615,2
7037,0,0,0,0,1229,334,8600,1011,9611,-0.00497511,-0.0355744,-0.999355,2
6837,0,0,0,0,1188,297,8322,915,9237,-0.00610281,-0.0389793,-0.999221,2
6610,0,0,0,0,1228,304,8142,920,9062,-0.0146547,-0.0429705,-0.998969,2
6457,0,0,0,0,1270,290,8017,950,8967,-0.0141077,-0.0511669,-0.99859,2
7114,0,0,0,0,1196,313,8623,907,9530,-0.020608,-0.0413795,-0.998931,2
6535,0,0,0,0,1273,318,8126,945,9071,-0.0157115,-0.0247854,-0.999569,2
6726,0,0,0,0,1595,322,8643,962,9605,-0.0232239,-0.0142329,-0.999629,2
6827,0,0,0,0,1196,295,8318,1002,9320,-0.0189725,-0.000499303,-0.99982,2
6524,0,0,0,0,1357,196,8077,706,8783,-0.0143937,-0.012269,-0.999821,2
3260,0,0,0,0,598,144,4002,554,4556,-0.015513,-0.0121122,-0.999806,2
6671,0,0,0,0,1212,293,8176,1111,9287,-0.0155341,-0.0117977,-0.99981,2
6658,0,0,0,0,1208,342,8208,1121,9329,-0.0171992,-0.0101037,-0.999801,2
6586,0,0,0,0,1495,383,8464,1492,9956,-0.0153061,-0.0123006,-0.999807,2
6699,0,0,0,0,1326,302,8327,1179,9506,-0.0210292,-0.0232299,-0.999509,2
8114,0,0,0,0,800,198,9112,711,9823,-0.0171706,-0.0255562,-0.999526,2
6774,0,0,0,0,1232,298,8304,1033,9337,-0.020663,-0.0260883,-0.999446,2
9643,0,0,0,0,1241,266,11150,904,12054,-0.0138325,-0.029773,-0.999461,2
3308,0,0,0,0,600,143,4051,556,4607,-0.0134328,-0.0269125,-0.999548,2
6761,0,0,0,0,1181,288,8230,1117,9347,-0.0103418,-0.0287294,-0.999534,2
7977,0,0,0,0,1186,292,9455,1164,10619,-0.00953605,-0.0244479,-0.999656,2
6742,0,0,0,0,1186,286,8214,1154,9368,-0.00844841,-0.0240767,-0.999674,2
6732,0,0,0,0,1181,285,8198,1098,9296,-0.00932686,-0.0263673,-0.999609,2
6680,0,0,0,0,1184,287,8151,1124,9275,-0.0211737,-0.0283876,-0.999373,2
6727,0,0,0,0,1198,290,8215,1035,9250,-0.0197281,-0.0261884,-0.999462,2
6670,0,0,0,0,1164,285,8119,1153,9272,-0.0148793,-0.0260982,-0.999549,2
6607,0,0,0,0,1192,285,8084,1070,9154,-0.00948036,-0.0278089,-0.999568,2
6753,0,0,0,0,1156,285,8194,1254,9448,-0.00474119,-0.0251203,-0.999673,2
6750,0,0,0,0,1152,278,8180,1044,9224,-0.00254343,-0.0221248,-0.999752,2
6694,0,0,0,0,1145,302,8141,995,9136,0.0012953,-0.0236325,-0.99972,2
7181,0,0,0,0,1363,289,8833,972,9805,-0.000389756,-0.0278839,-0.999611,2
6561,0,0,0,0,1172,279,8012,971,8983,-0.000667175,-0.0280583,-0.999606,2
5007,0,0,0,0,1154,245,6406,843,7249,-0.00138972,-0.0277588,-0.999614,2
6761,0,0,0,0,1141,278,8180,985,9165,-0.00201902,-0.0268627,-0.999637,2
6631,0,0,0,0,1185,280,8096,1016,9112,-0.00302286,-0.0270746,-0.999629,2
7025,0,0,0,0,1158,279,8462,1066,9528,-0.00398598,-0.0264951,-0.999641,2
6676,0,0,0,0,1150,279,8105,984,9089,-0.00245632,-0.0266715,-0.999641,2
