Downsample[ns],BuildFilTree[ns],SearchFil[ns],DeleteFil[ns],BuildTreeSub[ns],SearchSub[ns],DeleteSub[ns],PreProcTotal[ns],Plane[ns],Total[ns],nx,ny,nz,planeCount
2825,0,0,0,0,436,103,3364,980,4344,-0.00463549,0.0218669,-0.99975,0
2648,0,0,0,0,414,102,3164,898,4062,-0.00429762,0.0228305,-0.99973,0
2900,0,0,0,0,524,123,3547,922,4469,-0.00832561,0.0203308,-0.999759,0
2633,0,0,0,0,413,106,3152,953,4105,-0.00855662,0.0210403,-0.999742,0
2601,0,0,0,0,440,103,3144,929,4073,-0.00482775,0.0225989,-0.999733,0
2563,0,0,0,0,455,105,3123,894,4017,-0.00513754,0.0232211,-0.999717,0
2581,0,0,0,0,428,103,3112,867,3979,-0.00177302,0.0246894,-0.999694,0
2558,0,0,0,0,436,105,3099,860,3959,-0.00373167,0.0231208,-0.999726,0
2607,0,0,0,0,424,111,3142,893,4035,-0.00410115,0.0228903,-0.99973,0
2636,0,0,0,0,413,106,3155,922,4077,-0.00629071,0.0213623,-0.999752,0
2875,0,0,0,0,417,108,3400,920,4320,-0.00952316,0.0191609,-0.999771,0
2662,0,0,0,0,492,104,3258,943,4201,-0.00440818,0.0231598,-0.999722,0
2583,0,0,0,0,412,101,3096,903,3999,-0.00420457,0.0209689,-0.999771,0
2628,0,0,0,0,478,105,3211,900,4111,-0.0100447,0.0216295,-0.999716,0
2714,0,0,0,0,443,126,3283,908,4191,-0.00812608,0.0220048,-0.999725,0
2612,0,0,0,0,475,104,3191,844,4035,-0.00718888,0.0195419,-0.999783,0
2659,0,0,0,0,537,113,3309,873,4182,-0.00822664,0.0232555,-0.999696,0
2489,0,0,0,0,433,103,3025,878,3903,-0.00824489,0.0217262,-0.99973,0
2847,0,0,0,0,479,104,3430,1115,4545,-0.00603986,0.0220206,-0.999739,0
2691,0,0,0,0,483,112,3286,870,4156,-0.00320714,0.0245884,-0.999693,0
2595,0,0,0,0,418,102,3115,956,4071,-0.00390191,0.0235034,-0.999716,0
2495,0,0,0,0,507,108,3110,864,3974,-0.0102846,0.0198427,-0.99975,0
2630,0,0,0,0,414,102,3146,964,4110,-0.00528748,0.0227113,-0.999728,0
2639,0,0,0,0,448,107,3194,860,4054,-0.00821325,0.0186096,-0.999793,0
2489,0,0,0,0,436,124,3049,924,3973,-0.00761581,0.0192655,-0.999786,0
2688,0,0,0,0,465,116,3269,907,4176,-0.00795853,0.0195048,-0.999778,0
2662,0,0,0,0,420,105,3187,852,4039,-0.00537396,0.0218989,-0.999746,0
2634,0,0,0,0,413,101,3148,939,4087,-0.00434214,0.0219912,-0.999749,0
2671,0,0,0,0,428,128,3227,912,4139,-0.00496933,0.023299,-0.999716,0
2572,0,0,0,0,422,103,3097,882,3979,-0.00378243,0.0227584,-0.999734,0
2685,0,0,0,0,458,108,3251,1008,4259,-0.00636225,0.0213203,-0.999753,0
2710,0,0,0,0,466,110,3286,875,4161,-0.0042071,0.0225118,-0.999738,0
2599,0,0,0,0,626,111,3336,926,4262,-0.00631848,0.0217774,-0.999743,0
2599,0,0,0,0,463,116,3178,899,4077,-0.00623912,0.022639,-0.999724,0
2578,0,0,0,0,601,125,3304,910,4214,-0.00787848,0.0215386,-0.999737,0
2660,0,0,0,0,461,128,3249,865,4114,-0.00639223,0.0243801,-0.999682,0
2636,0,0,0,0,474,107,3217,960,4177,-0.00508611,0.0232502,-0.999717,0
3379,0,0,0,0,684,149,4212,1168,5380,-0.00589815,0.0222213,-0.999736,0
2789,0,0,0,0,472,100,3361,925,4286,-0.00401396,0.0234157,-0.999718,0
2664,0,0,0,0,484,102,3250,820,4070,-0.00518448,0.0221459,-0.999741,0
2740,0,0,0,0,420,105,3265,995,4260,-0.00886829,0.0218914,-0.999721,0
2576,0,0,0,0,420,112,3108,928,4036,-0.0084535,0.0206902,-0.99975,0
2644,0,0,0,0,429,111,3184,923,4107,-0.00818493,0.0206682,-0.999753,0
2641,0,0,0,0,428,113,3182,965,4147,-0.00718694,0.0226277,-0.999718,0
2631,0,0,0,0,423,128,3182,1014,4196,-0.00631056,0.0214681,-0.99975,0
2630,0,0,0,0,490,107,3227,829,4056,-0.00903097,0.0204994,-0.999749,0
2733,0,0,0,0,527,109,3369,917,4286,-0.00764736,0.0204816,-0.999761,0
2737,0,0,0,0,478,110,3325,920,4245,-0.00598144,0.0228661,-0.999721,0
2694,0,0,0,0,455,106,3255,883,4138,-0.00549922,0.021554,-0.999753,0
2591,0,0,0,0,537,108,3236,977,4213,-0.00685764,0.0214726,-0.999746,0
2590,0,0,0,0,581,113,3284,907,4191,-0.00597672,0.0225338,-0.999728,0
2651,0,0,0,0,578,107,3336,862,4198,-0.00549747,0.0223289,-0.999736,0
2650,0,0,0,0,442,115,3207,965,4172,-0.00432428,0.0221773,-0.999745,0
2565,0,0,0,0,464,106,3135,861,3996,-0.00794726,0.0212293,-0.999743,0
2530,0,0,0,0,428,111,3069,913,3982,-0.00317373,0.0232454,-0.999725,0
2513,0,0,0,0,455,134,3102,893,3995,-0.00707566,0.0201813,-0.999771,0
2676,0,0,0,0,477,106,3259,877,4136,-0.00317101,0.0230898,-0.999728,0
2774,0,0,0,0,447,103,3324,926,4250,-0.00629675,0.0220018,-0.999738,0
2819,0,0,0,0,488,102,3409,879,4288,-0.00936078,0.0201032,-0.999754,0
2840,0,0,0,0,425,108,3373,902,4275,-0.00353577,0.0224997,-0.999741,0
2553,0,0,0,0,427,108,3088,959,4047,-0.00830465,0.0195816,-0.999774,0
2599,0,0,0,0,454,112,3165,868,4033,-0.00295304,0.0231711,-0.999727,0
2566,0,0,0,0,423,118,3107,901,4008,-0.00396396,0.0227904,-0.999732,0
2575,0,0,0,0,483,107,3165,884,4049,-0.00348795,0.0236519,-0.999714,0
2674,0,0,0,0,414,105,3193,936,4129,-0.008648,0.0196362,-0.99977,0
2489,0,0,0,0,438,107,3034,957,3991,-0.00490899,0.0225655,-0.999733,0
2529,0,0,0,0,409,102,3040,827,3867,-0.0076786,0.0217959,-0.999733,0
2799,0,0,0,0,412,102,3313,925,4238,-0.00553124,0.022003,-0.999743,0
2693,0,0,0,0,453,118,3264,1002,4266,-0.00798917,0.0220313,-0.999725,0
2598,0,0,0,0,480,106,3184,887,4071,-0.00639336,0.024535,-0.999679,0
2568,0,0,0,0,473,115,3156,1050,4206,-0.00825197,0.0214597,-0.999736,0
2552,0,0,0,0,490,193,3235,842,4077,-0.00646433,0.0206249,-0.999766,0
2573,0,0,0,0,487,130,3190,844,4034,-0.00694742,0.0185829,-0.999803,0
2613,0,0,0,0,418,106,3137,959,4096,-0.00642887,0.0208494,-0.999762,0
2507,0,0,0,0,419,104,3030,1013,4043,-0.0048143,0.022096,-0.999744,0
2574,0,0,0,0,475,125,3174,849,4023,-0.00417795,0.0226266,-0.999735,0
2986,0,0,0,0,472,127,3585,1077,4662,-0.00862566,0.020688,-0.999749,0
2685,0,0,0,0,421,108,3214,892,4106,-0.00407598,0.0231158,-0.999725,0
2527,0,0,0,0,543,141,3211,934,4145,-0.00486527,0.0225782,-0.999733,0
2764,0,0,0,0,432,108,3304,942,4246,-0.0067181,0.0216573,-0.999743,0
2799,0,0,0,0,434,102,3335,1000,4335,-0.00646597,0.0211503,-0.999755,0
2664,0,0,0,0,420,105,3189,941,4130,-0.00670188,0.0213456,-0.99975,0
2918,0,0,0,0,455,107,3480,1043,4523,-0.00663932,0.0218723,-0.999739,0
2581,0,0,0,0,423,118,3122,940,4062,-0.00367476,0.021761,-0.999756,0
2540,0,0,0,0,428,107,3075,1021,4096,-0.00805548,0.0208644,-0.99975,0
3325,0,0,0,0,427,101,3853,949,4802,-0.0029771,0.0229998,-0.999731,0
2521,0,0,0,0,440,111,3072,903,3975,-0.00555531,0.022425,-0.999733,0
2615,0,0,0,0,425,106,3146,886,4032,-0.00596813,0.0209896,-0.999762,0
2614,0,0,0,0,420,104,3138,1046,4184,-0.0076383,0.0218054,-0.999733,0
2621,0,0,0,0,429,103,3153,835,3988,-0.00659555,0.022891,-0.999716,0
2582,0,0,0,0,575,129,3286,999,4285,-0.00806116,0.0212531,-0.999742,0
2660,0,0,0,0,428,102,3190,908,4098,-0.00766351,0.0205982,-0.999759,0
2752,0,0,0,0,449,126,3327,905,4232,-0.00401909,0.0229024,-0.99973,0
2602,0,0,0,0,427,103,3132,843,3975,-0.00704111,0.0210981,-0.999753,0
3523,0,0,0,0,644,135,4302,1218,5520,-0.00730762,0.0209794,-0.999753,0
2613,0,0,0,0,496,121,3230,895,4125,-0.00883634,0.0207322,-0.999746,0
2991,0,0,0,0,459,126,3576,887,4463,-0.00667307,0.0208398,-0.999761,0
2680,0,0,0,0,454,102,3236,970,4206,-0.00820787,0.0191962,-0.999782,0
2727,0,0,0,0,476,110,3313,909,4222,-0.00617325,0.0192218,-0.999796,0
2500,0,0,0,0,484,107,3091,843,3934,-0.00421667,0.020785,-0.999775,0
2758,0,0,0,0,419,101,3278,999,4277,-0.00517469,0.0227043,-0.999729,0
2574,0,0,0,0,427,106,3107,831,3938,-0.0090258,0.0235678,-0.999682,0
2616,0,0,0,0,412,107,3135,825,3960,-0.00281411,0.0232243,-0.999726,0
2740,0,0,0,0,420,102,3262,998,4260,-0.00828621,0.0206585,-0.999752,0
2712,0,0,0,0,421,108,3241,1056,4297,-0.0062476,0.0212683,-0.999754,0
2772,0,0,0,0,421,116,3309,875,4184,-0.00764457,0.0186027,-0.999798,0
2561,0,0,0,0,525,109,3195,874,4069,-0.00324147,0.0224276,-0.999743,0
2696,0,0,0,0,435,110,3241,915,4156,-0.00831543,0.0205608,-0.999754,0
2578,0,0,0,0,531,112,3221,957,4178,-0.00601347,0.0213523,-0.999754,0
2586,0,0,0,0,448,116,3150,879,4029,-0.00653932,0.0199888,-0.999779,0
2656,0,0,0,0,541,107,3304,915,4219,-0.00502981,0.0225898,-0.999732,0
2617,0,0,0,0,524,109,3250,876,4126,-0.00577548,0.019112,-0.999801,0
2689,0,0,0,0,460,103,3252,958,4210,-0.00738388,0.0216813,-0.999738,0
2578,0,0,0,0,420,103,3101,849,3950,-0.00439047,0.0239925,-0.999702,0
2914,0,0,0,0,432,103,3449,1006,4455,-0.0059328,0.0211597,-0.999759,0
2562,0,0,0,0,420,107,3089,995,4084,-0.00811804,0.0201584,-0.999764,0
2843,0,0,0,0,467,107,3417,887,4304,-0.00688752,0.0210339,-0.999755,0
2561,0,0,0,0,485,113,3159,910,4069,-0.00903402,0.0181875,-0.999794,0
2488,0,0,0,0,463,124,3075,1020,4095,-0.00473189,0.0228863,-0.999727,0
2526,0,0,0,0,450,145,3121,918,4039,-0.00628273,0.0216743,-0.999745,0
2830,0,0,0,0,462,123,3415,876,4291,-0.00479948,0.0212082,-0.999764,0
2502,0,0,0,0,446,103,3051,866,3917,-0.00555569,0.0218185,-0.999747,0
2526,0,0,0,0,418,109,3053,958,4011,-0.00625785,0.023042,-0.999715,0
2541,0,0,0,0,419,106,3066,878,3944,-0.0046199,0.0239215,-0.999703,0
2563,0,0,0,0,427,108,3098,992,4090,-0.00859634,0.0215906,-0.99973,0
2530,0,0,0,0,433,107,3070,861,3931,-0.00673355,0.022197,-0.999731,0
2444,0,0,0,0,436,109,2989,935,3924,-0.00682739,0.0212976,-0.99975,0
2532,0,0,0,0,418,111,3061,881,3942,-0.00578442,0.020999,-0.999763,0
2548,0,0,0,0,428,137,3113,857,3970,-0.00887901,0.0183343,-0.999792,0
2551,0,0,0,0,424,102,3077,987,4064,-0.00629818,0.022229,-0.999733,0
2634,0,0,0,0,504,106,3244,912,4156,-0.00729316,0.0177752,-0.999815,0
2587,0,0,0,0,415,103,3105,852,3957,-0.00600282,0.0195848,-0.99979,0
2731,0,0,0,0,424,120,3275,937,4212,-0.00406846,0.022233,-0.999745,0
2585,0,0,0,0,416,102,3103,839,3942,-0.00711898,0.0207637,-0.999759,0
3410,0,0,0,0,434,113,3957,996,4953,-0.00616767,0.0198241,-0.999785,0
2540,0,0,0,0,413,102,3055,861,3916,-0.00511706,0.0220813,-0.999743,0
2574,0,0,0,0,416,104,3094,978,4072,-0.00476458,0.0229149,-0.999726,0
2660,0,0,0,0,496,107,3263,914,4177,-0.00499201,0.023658,-0.999708,0
2556,0,0,0,0,420,102,3078,1014,4092,-0.00738719,0.0197323,-0.999778,0
2486,0,0,0,0,456,104,3046,860,3906,-0.00597591,0.0214805,-0.999751,0
2686,0,0,0,0,455,108,3249,894,4143,-0.00238968,0.0238751,-0.999712,0
2620,0,0,0,0,420,101,3141,976,4117,-0.00686655,0.0211823,-0.999752,0
2754,0,0,0,0,457,107,3318,991,4309,-0.00432656,0.0227484,-0.999732,0
2695,0,0,0,0,474,111,3280,903,4183,-0.00382487,0.0223443,-0.999743,0
2634,0,0,0,0,433,127,3194,992,4186,-0.00332075,0.0225007,-0.999741,0
2628,0,0,0,0,464,103,3195,886,4081,-0.00670755,0.0205737,-0.999766,0
2572,0,0,0,0,415,105,3092,812,3904,-0.00634189,0.0178738,-0.99982,0
2720,0,0,0,0,416,102,3238,813,4051,-0.00640236,0.0189426,-0.9998,0
2667,0,0,0,0,595,116,3378,921,4299,-0.00755379,0.0208409,-0.999754,0
2576,0,0,0,0,425,117,3118,927,4045,-0.00642651,0.0210045,-0.999759,0
2575,0,0,0,0,427,118,3120,915,4035,-0.00824316,0.0215086,-0.999735,0
2654,0,0,0,0,426,101,3181,818,3999,-0.00928438,0.018294,-0.99979,0
2666,0,0,0,0,423,112,3201,926,4127,-0.00617633,0.0200232,-0.99978,0
2555,0,0,0,0,429,102,3086,872,3958,-0.0084049,0.0204703,-0.999755,0
2566,0,0,0,0,526,111,3203,906,4109,-0.00718747,0.0240127,-0.999686,0
2629,0,0,0,0,446,106,3181,830,4011,-0.0071609,0.0185488,-0.999802,0
2704,0,0,0,0,414,102,3220,966,4186,-0.00913133,0.0210737,-0.999736,0
2700,0,0,0,0,423,102,3225,864,4089,-0.00662585,0.0195474,-0.999787,0
2557,0,0,0,0,608,123,3288,956,4244,-0.00732615,0.0199763,-0.999774,0
2672,0,0,0,0,482,107,3261,883,4144,-0.00648057,0.02178,-0.999742,0
2590,0,0,0,0,438,106,3134,1044,4178,-0.00726936,0.0207848,-0.999758,0
2626,0,0,0,0,450,102,3178,878,4056,-0.00441821,0.0219604,-0.999749,0
2643,0,0,0,0,436,109,3188,979,4167,-0.00722477,0.0199087,-0.999776,0
2736,0,0,0,0,472,118,3326,829,4155,-0.00502882,0.0226089,-0.999732,0
2719,0,0,0,0,488,118,3325,1062,4387,-0.0060458,0.0210603,-0.99976,0
2761,0,0,0,0,418,104,3283,867,4150,-0.00376826,0.0217902,-0.999755,0
2504,0,0,0,0,422,105,3031,1025,4056,-0.005832,0.0213455,-0.999755,0
2553,0,0,0,0,510,122,3185,885,4070,-0.00514964,0.0211687,-0.999763,0
2633,0,0,0,0,441,107,3181,1032,4213,-0.00712715,0.0212772,-0.999748,0
2751,0,0,0,0,453,107,3311,876,4187,-0.0076528,0.0209377,-0.999751,0
2578,0,0,0,0,419,104,3101,972,4073,-0.00968664,0.0194305,-0.999764,0
2575,0,0,0,0,1270,113,3958,894,4852,-0.00486211,0.0213817,-0.99976,0
2785,0,0,0,0,469,104,3358,1003,4361,-0.00668141,0.0207389,-0.999763,0
2618,0,0,0,0,426,108,3152,901,4053,-0.00486363,0.0216745,-0.999753,0
2515,0,0,0,0,440,114,3069,909,3978,-0.0059026,0.0224114,-0.999732,0
3649,0,0,0,0,846,117,4612,916,5528,-0.0081594,0.0203778,-0.999759,0
2732,0,0,0,0,515,108,3355,926,4281,-0.00682481,0.0203859,-0.999769,0
2694,0,0,0,0,487,128,3309,896,4205,-0.00544576,0.0220884,-0.999741,0
2661,0,0,0,0,536,123,3320,1019,4339,-0.00535342,0.0211356,-0.999762,0
2565,0,0,0,0,434,129,3128,949,4077,-0.00668381,0.021124,-0.999755,0
2640,0,0,0,0,432,108,3180,922,4102,-0.00657015,0.0208488,-0.999761,0
2582,0,0,0,0,428,108,3118,886,4004,-0.00499842,0.0222661,-0.99974,0
2546,0,0,0,0,584,109,3239,1010,4249,-0.0051537,0.0220367,-0.999744,0
2588,0,0,0,0,420,105,3113,929,4042,-0.00612135,0.0205839,-0.99977,0
2605,0,0,0,0,415,104,3124,940,4064,-0.00887809,0.0202278,-0.999756,0
2539,0,0,0,0,434,106,3079,858,3937,-0.00808292,0.0182954,-0.9998,0
2570,0,0,0,0,419,102,3091,958,4049,-0.00444567,0.0225899,-0.999735,0
2671,0,0,0,0,461,116,3248,891,4139,-0.00548697,0.0210076,-0.999764,0
2760,0,0,0,0,492,107,3359,1009,4368,-0.00660091,0.0219702,-0.999737,0
2675,0,0,0,0,421,103,3199,868,4067,-0.00942872,0.0209372,-0.999736,0
2473,0,0,0,0,565,112,3150,885,4035,-0.00659598,0.0198072,-0.999782,0
2658,0,0,0,0,473,107,3238,830,4068,-0.00784816,0.0204552,-0.99976,0
2674,0,0,0,0,440,104,3218,844,4062,-0.00407876,0.02258,-0.999737,0
2771,0,0,0,0,458,108,3337,925,4262,-0.00531502,0.0212928,-0.999759,0
2614,0,0,0,0,416,103,3133,965,4098,-0.00712151,0.0204088,-0.999766,0
2690,0,0,0,0,488,125,3303,838,4141,-0.00373275,0.0221656,-0.999747,0
2697,0,0,0,0,419,106,3222,985,4207,-0.00819771,0.0200259,-0.999766,0
2587,0,0,0,0,425,104,3116,913,4029,-0.00670188,0.0218325,-0.999739,0
2589,0,0,0,0,472,102,3163,885,4048,-0.00273486,0.023359,-0.999723,0
2533,0,0,0,0,420,105,3058,892,3950,-0.00468777,0.0225553,-0.999735,0
2604,0,0,0,0,436,105,3145,938,4083,-0.00831745,0.020114,-0.999763,0
3885,0,0,0,0,709,148,4742,1138,5880,-0.0105853,0.0199513,-0.999745,0
2677,0,0,0,0,501,106,3284,949,4233,-0.00575518,0.0198479,-0.999787,0
2581,0,0,0,0,455,119,3155,839,3994,-0.00621057,0.0196518,-0.999788,0
2728,0,0,0,0,416,151,3295,945,4240,-0.00663315,0.0216204,-0.999744,0
2676,0,0,0,0,425,104,3205,894,4099,-0.00855384,0.0199691,-0.999764,0
2612,0,0,0,0,505,109,3226,973,4199,-0.00797842,0.0200446,-0.999767,0
2654,0,0,0,0,425,102,3181,862,4043,-0.0093496,0.0218796,-0.999717,0
2794,0,0,0,0,487,158,3439,951,4390,-0.00612467,0.0180896,-0.999818,0
2549,0,0,0,0,406,100,3055,836,3891,-0.00345293,0.0221579,-0.999749,0
2710,0,0,0,0,471,105,3286,919,4205,-0.0054282,0.0200063,-0.999785,0
2722,0,0,0,0,462,111,3295,850,4145,-0.00806578,0.0190592,-0.999786,0
2640,0,0,0,0,414,118,3172,879,4051,-0.00808771,0.0186644,-0.999793,0
2625,0,0,0,0,450,102,3177,846,4023,-0.00975733,0.0204563,-0.999743,0
2668,0,0,0,0,414,120,3202,804,4006,-0.00407131,0.0216291,-0.999758,0
2560,0,0,0,0,420,105,3085,787,3872,-0.00386088,0.021814,-0.999755,0
2631,0,0,0,0,454,110,3195,885,4080,-0.00565574,0.0180351,-0.999821,0
2551,0,0,0,0,391,101,3043,794,3837,-0.0091655,0.0193028,-0.999772,0
2785,0,0,0,0,484,100,3369,771,4140,-0.0057931,0.0227604,-0.999724,0
2505,0,0,0,0,424,97,3026,802,3828,-0.00532967,0.0222844,-0.999738,0
2653,0,0,0,0,944,104,3701,843,4544,-0.00433499,0.0211864,-0.999766,0
2650,0,0,0,0,381,93,3124,837,3961,-0.00769323,0.0178454,-0.999811,0
2522,0,0,0,0,425,108,3055,890,3945,-0.00778749,0.0196104,-0.999777,0
2596,0,0,0,0,399,99,3094,816,3910,-0.00833118,0.0180777,-0.999802,0
2802,0,0,0,0,547,105,3454,898,4352,-0.00798318,0.0202993,-0.999762,0
2601,0,0,0,0,458,97,3156,820,3976,-0.00764624,0.019716,-0.999776,0
2557,0,0,0,0,389,101,3047,835,3882,-0.0063843,0.0197085,-0.999786,0
2470,0,0,0,0,546,171,3187,714,3901,-0.00974408,0.0213076,-0.999725,0
2535,0,0,0,0,382,93,3010,818,3828,-0.00778086,0.0197011,-0.999776,0
2733,0,0,0,0,392,96,3221,732,3953,-0.00885184,0.020532,-0.99975,0
2460,0,0,0,0,472,92,3024,790,3814,-0.00700542,0.0203281,-0.999769,0
2485,0,0,0,0,365,92,2942,701,3643,-0.0081638,0.0197693,-0.999771,0
2553,0,0,0,0,366,96,3015,783,3798,-0.00663484,0.0185322,-0.999806,0
2619,0,0,0,0,391,92,3102,791,3893,-0.00571392,0.0207385,-0.999769,0
2676,0,0,0,0,502,135,3313,746,4059,-0.00669516,0.018313,-0.99981,0
2555,0,0,0,0,452,94,3101,708,3809,-0.00660299,0.0161449,-0.999848,0
2660,0,0,0,0,387,97,3144,757,3901,-0.00853282,0.0188449,-0.999786,0
2477,0,0,0,0,381,105,2963,706,3669,-0.00587171,0.0198212,-0.999786,0
3141,0,0,0,0,472,104,3717,664,4381,-0.00729814,0.0202575,-0.999768,0
2550,0,0,0,0,432,95,3077,718,3795,-0.00773794,0.0210014,-0.99975,0
2605,0,0,0,0,361,94,3060,773,3833,-0.00607469,0.0198692,-0.999784,0
2647,0,0,0,0,430,108,3185,727,3912,-0.00536932,0.0220324,-0.999743,0
2554,0,0,0,0,361,94,3009,782,3791,-0.00915837,0.0188523,-0.99978,0
2516,0,0,0,0,378,90,2984,749,3733,-0.0133408,0.0220103,-0.999669,0
2884,0,0,0,0,371,107,3362,948,4310,-0.0186851,0.0246658,-0.999521,0
2516,0,0,0,0,448,99,3063,1117,4180,-0.02061,0.0152513,-0.999671,0
2640,0,0,0,0,384,95,3119,1381,4500,-0.0283567,0.013369,-0.999509,0
2606,0,0,0,0,455,114,3175,1600,4775,-0.0391245,0.0150833,-0.99912,0
3894,0,0,0,0,672,144,4710,2332,7042,-0.00471586,0.0214954,-0.999758,0
2850,0,0,0,0,500,106,3456,1978,5434,-0.0130849,0.0194904,-0.999724,0
2881,0,0,0,0,497,110,3488,2302,5790,-0.0209671,0.0183351,-0.999612,0
2844,0,0,0,0,438,112,3394,2227,5621,-0.0337059,0.0138463,-0.999336,0
2792,0,0,0,0,448,112,3352,2502,5854,-0.0433745,0.016094,-0.998929,0
2732,0,0,0,0,505,118,3355,2451,5806,-0.0451892,0.0246086,-0.998675,0
2917,0,0,0,0,562,127,3606,2487,6093,-0.0486898,0.043835,-0.997852,0
2921,0,0,0,0,473,119,3513,2449,5962,-0.0517197,0.0654772,-0.996513,0
2738,0,0,0,0,465,112,3315,2177,5492,0.00759778,0.0143455,-0.999868,0
2602,0,0,0,0,466,123,3191,2218,5409,0.00753681,0.0321263,-0.999456,0
2791,0,0,0,0,665,165,3621,2306,5927,0.00687358,0.0447777,-0.998973,0
2596,0,0,0,0,474,116,3186,2227,5413,0.00354544,0.0533261,-0.998571,0
2682,0,0,0,0,526,116,3324,2261,5585,0.00399004,0.0667382,-0.997763,0
2573,0,0,0,0,513,137,3223,2055,5278,-0.00108793,0.0739913,-0.997258,0
2676,0,0,0,0,502,118,3296,2163,5459,0.00341952,0.0702862,-0.997521,0
2644,0,0,0,0,442,110,3196,1854,5050,0.00745641,0.0683959,-0.99763,0
2771,0,0,0,0,441,111,3323,1682,5005,0.0163707,0.0658331,-0.997696,0
2755,0,0,0,0,430,131,3316,1586,4902,-0.0127831,0.0316412,-0.999418,0
2682,0,0,0,0,441,111,3234,1724,4958,-0.00974955,0.027344,-0.999578,0
2706,0,0,0,0,468,105,3279,1455,4734,-0.0104848,0.0198869,-0.999747,0
2808,0,0,0,0,435,106,3349,1342,4691,-0.0097521,0.00730333,-0.999926,0
2543,0,0,0,0,402,103,3048,1013,4061,-0.00366807,-0.00682895,-0.99997,0
2885,0,0,0,0,392,101,3378,1141,4519,-0.00243288,0.0268037,-0.999638,0
2608,0,0,0,0,392,98,3098,1000,4098,-0.00582916,0.0246884,-0.999678,0
2569,0,0,0,0,388,93,3050,817,3867,-0.00832688,0.0220024,-0.999723,0
2468,0,0,0,0,369,99,2936,923,3859,-0.00565061,0.0177155,-0.999827,0
2518,0,0,0,0,645,99,3262,1158,4420,-0.00216368,0.0212878,-0.999771,0
2605,0,0,0,0,382,96,3083,887,3970,-0.0112953,0.030029,-0.999485,0
2580,0,0,0,0,364,92,3036,549,3585,-0.0142168,0.0266708,-0.999543,0
2556,0,0,0,0,442,90,3088,653,3741,-0.0189471,0.0206971,-0.999606,0
2572,0,0,0,0,385,119,3076,940,4016,-0.00071594,0.0145974,-0.999893,0
2460,0,0,0,0,409,96,2965,616,3581,-0.00133292,0.0101829,-0.999947,0
2582,0,0,0,0,400,107,3089,566,3655,0.0220411,-0.0248688,-0.999448,0
2478,0,0,0,0,382,88,2948,390,3338,0.00452802,-0.0814529,-0.996667,0
2553,0,0,0,0,362,88,3003,445,3448,0.00390685,-0.105326,-0.99443,0
2594,0,0,0,0,396,90,3080,422,3502,-0.00181616,-0.14968,-0.988733,0
2849,0,0,0,0,445,105,3399,586,3985,-0.0184462,-0.143676,-0.989453,0
2562,0,0,0,0,405,107,3074,709,3783,0.010408,0.0164399,-0.999811,0
2615,0,0,0,0,478,112,3205,745,3950,-0.000955879,0.0718961,-0.997412,0
2642,0,0,0,0,360,85,3087,771,3858,0.00993714,0.0201287,-0.999748,0
2736,0,0,0,0,354,97,3187,737,3924,0.0210521,-0.0277523,-0.999393,0
2544,0,0,0,0,370,85,2999,700,3699,0.0288137,-0.085247,-0.995943,0
2913,0,0,0,0,345,87,3345,729,4074,0.0328335,-0.133403,-0.990518,0
2567,0,0,0,0,344,89,3000,652,3652,0.0322353,-0.19498,-0.980277,0
2714,0,0,0,0,404,91,3209,645,3854,0.0247311,-0.266552,-0.963503,0
2496,0,0,0,0,329,76,2901,736,3637,0.0140815,-0.349757,-0.936734,0
2921,0,0,0,0,472,100,3493,862,4355,-0.00275322,-0.221487,-0.975159,0
2756,0,0,0,0,335,79,3170,810,3980,0.0205762,0.0575989,-0.998128,0
2614,0,0,0,0,391,89,3094,806,3900,0.01557,0.0344068,-0.999287,0
2736,0,0,0,0,428,122,3286,769,4055,0.0166116,0.0610446,-0.997997,0
2628,0,0,0,0,307,75,3010,798,3808,0.0172041,0.0551103,-0.998332,0
2374,0,0,0,0,204,50,2628,642,3270,0.0147433,-0.00722947,-0.999865,0
2424,0,0,0,0,218,75,2717,589,3306,0.0215276,0.0700577,-0.997311,0
2389,0,0,0,0,225,70,2684,549,3233,0.0202034,0.00252479,-0.999793,0
2512,0,0,0,0,222,57,2791,712,3503,0.0144157,-0.0624661,-0.997943,0
2330,0,0,0,0,210,56,2596,762,3358,0.0102729,-0.116069,-0.993188,0
2645,0,0,0,0,202,54,2901,829,3730,0.0193608,0.0469733,-0.998709,0
2519,0,0,0,0,264,50,2833,756,3589,0.0200895,0.0462635,-0.998727,0
2540,0,0,0,0,191,46,2777,791,3568,0.0299439,0.0594874,-0.99778,0
2517,0,0,0,0,179,46,2742,712,3454,0.0239836,-0.00707783,-0.999687,0
2446,0,0,0,0,181,48,2675,744,3419,0.019836,-0.0861775,-0.996082,0
2445,0,0,0,0,171,48,2664,627,3291,0.0116349,-0.161724,-0.986767,0
2508,0,0,0,0,313,72,2893,769,3662,0.00622434,-0.208642,-0.977972,0
2452,0,0,0,0,218,57,2727,674,3401,0.00241099,-0.275105,-0.961411,0
2632,0,0,0,0,300,70,3002,710,3712,0.00117573,-0.343606,-0.939113,0
2536,0,0,0,0,255,66,2857,820,3677,0.034566,0.0476563,-0.998265,0
2518,0,0,0,0,274,74,2866,695,3561,0.0398694,-0.0435336,-0.998256,0
2515,0,0,0,0,296,78,2889,757,3646,0.0441704,-0.116359,-0.992225,0
2516,0,0,0,0,333,93,2942,818,3760,-0.0374808,0.10954,-0.993275,0
2650,0,0,0,0,334,106,3090,696,3786,-0.0493596,0.0806451,-0.99552,0
2774,0,0,0,0,333,89,3196,658,3854,-0.0376876,0.13482,-0.990153,0
2585,0,0,0,0,373,106,3064,580,3644,-0.0341362,0.154809,-0.987355,0
2640,0,0,0,0,401,99,3140,777,3917,-0.0221845,0.136719,-0.990362,0
2430,0,0,0,0,382,102,2914,512,3426,0.0310198,0.0471584,-0.998406,0
2553,0,0,0,0,369,109,3031,372,3403,0.0273027,0.303182,-0.952541,0
2503,0,0,0,0,365,102,2970,190,3160,-0.024124,0.526167,-0.850039,0
2726,0,0,0,0,486,100,3312,177,3489,0.411406,-0.285927,-0.865443,0
2528,0,0,0,0,390,104,3022,539,3561,0.0399063,-0.255492,-0.965987,0
2996,0,0,0,0,468,96,3560,1308,4868,0.0369619,-0.244315,-0.968991,0
2551,0,0,0,0,364,91,3006,1883,4889,-0.0079256,-0.00301229,-0.999964,0
2640,0,0,0,0,349,87,3076,2111,5187,-0.00578114,-0.0923984,-0.995705,0
2571,0,0,0,0,323,89,2983,2102,5085,0.00951499,-0.00725239,-0.999928,0
2532,0,0,0,0,316,76,2924,2352,5276,0.0142618,-0.0983979,-0.995045,0
2666,0,0,0,0,289,69,3024,2133,5157,-0.0103311,0.0748447,-0.997142,0
2644,0,0,0,0,287,65,2996,1908,4904,-0.00739142,-0.0174164,-0.999821,0
2563,0,0,0,0,285,60,2908,1625,4533,-0.00225375,-0.107145,-0.994241,0
2518,0,0,0,0,286,58,2862,1445,4307,-0.000236037,-0.196156,-0.980573,0
2662,0,0,0,0,245,65,2972,1354,4326,-0.00244074,-0.290394,-0.956904,0
2666,0,0,0,0,221,79,2966,1302,4268,-0.00878804,-0.380696,-0.924659,0
2589,0,0,0,0,242,61,2892,1147,4039,-0.0177163,-0.472269,-0.881276,0
2925,0,0,0,0,278,71,3274,1021,4295,-0.0209874,0.0106527,-0.999723,0
2550,0,0,0,0,303,83,2936,1008,3944,-0.0338151,-0.0640895,-0.997371,0
2788,0,0,0,0,339,85,3212,1000,4212,-0.0513069,-0.173209,-0.983548,0
2917,0,0,0,0,465,92,3474,893,4367,0.0128376,0.14748,-0.988982,0
3023,0,0,0,0,460,102,3585,861,4446,0.00767764,0.138845,-0.990285,0
2695,0,0,0,0,426,106,3227,759,3986,-0.00626262,0.0219808,-0.999739,0
2833,0,0,0,0,431,108,3372,863,4235,-0.0288708,-0.0943898,-0.995117,0
2684,0,0,0,0,450,129,3263,803,4066,0.0135397,0.091592,-0.995705,0
2831,0,0,0,0,466,119,3416,898,4314,4.88706e-05,-0.0185166,-0.999829,0
2801,0,0,0,0,483,119,3403,868,4271,-0.011218,-0.135085,-0.990771,0
2774,0,0,0,0,543,131,3448,900,4348,-0.0211635,-0.245388,-0.969194,0
2813,0,0,0,0,471,120,3404,935,4339,-0.0271308,-0.36101,-0.932167,0
2785,0,0,0,0,496,119,3400,1038,4438,-0.0387957,-0.456254,-0.889004,0
2740,0,0,0,0,532,119,3391,13178,16569,-0.000512013,0.149473,-0.988766,0
2701,0,0,0,0,461,125,3287,1129,4416,-0.00375109,0.081931,-0.996631,0
2774,0,0,0,0,494,116,3384,1432,4816,-0.011145,-0.0212204,-0.999713,0
2661,0,0,0,0,455,125,3241,1402,4643,-0.0202207,-0.123004,-0.9922,0
2802,0,0,0,0,433,109,3344,1220,4564,-0.0276121,-0.218406,-0.975467,0
2710,0,0,0,0,525,103,3338,815,4153,-0.0270349,-0.319227,-0.947293,0
2513,0,0,0,0,359,84,2956,566,3522,-0.0350427,-0.419169,-0.907232,0
2617,0,0,0,0,372,106,3095,669,3764,-0.040813,-0.509852,-0.859293,0
2522,0,0,0,0,363,84,2969,880,3849,-0.0470097,-0.597864,-0.800217,0
2836,0,0,0,0,367,82,3285,1028,4313,0.013014,-0.00470345,-0.999904,0
3175,0,0,0,0,525,113,3813,1107,4920,-0.0016615,0.0692407,-0.997599,0
2513,0,0,0,0,341,79,2933,737,3670,0.00947168,0.056789,-0.998341,0
2572,0,0,0,0,315,85,2972,769,3741,0.0194219,-0.0275039,-0.999433,0
2651,0,0,0,0,317,92,3060,772,3832,0.00597761,0.0472141,-0.998867,0
2562,0,0,0,0,364,80,3006,850,3856,0.0123078,-0.0238058,-0.999641,0
2588,0,0,0,0,288,89,2965,857,3822,0.0140237,0.0327512,-0.999365,0
2605,0,0,0,0,290,74,2969,781,3750,0.0205894,-0.0429676,-0.998864,0
2766,0,0,0,0,268,70,3104,912,4016,0.0236502,-0.126556,-0.991677,0
2591,0,0,0,0,246,65,2902,889,3791,0.026898,-0.204059,-0.978589,0
2973,0,0,0,0,241,101,3315,979,4294,0.0136646,0.0700076,-0.997453,0
2681,0,0,0,0,208,55,2944,869,3813,0.012183,-0.00556299,-0.99991,0
2469,0,0,0,0,207,67,2743,825,3568,0.00663555,-0.082402,-0.996577,0
2565,0,0,0,0,212,55,2832,811,3643,0.00515497,-0.108439,-0.99409,0
2828,0,0,0,0,178,46,3052,791,3843,0.0218405,0.0449818,-0.998749,0
2513,0,0,0,0,149,41,2703,714,3417,0.0142621,-0.0246337,-0.999595,0
2420,0,0,0,0,149,51,2620,598,3218,0.00411156,-0.0930064,-0.995657,0
2342,0,0,0,0,172,43,2557,552,3109,0.0145494,-0.144528,-0.989394,0
2308,0,0,0,0,186,51,2545,534,3079,-0.0215258,-0.145748,-0.989087,0
2484,0,0,0,0,192,53,2729,482,3211,-0.0325055,-0.23021,-0.972598,0
2535,0,0,0,0,254,56,2845,486,3331,0.035024,0.0559277,-0.99782,0
2835,0,0,0,0,210,64,3109,613,3722,0.0290568,-0.00521927,-0.999564,0
2786,0,0,0,0,240,63,3089,562,3651,0.0312756,0.0246971,-0.999206,0
2402,0,0,0,0,237,66,2705,592,3297,0.0245192,-0.0360367,-0.99905,0
2759,0,0,0,0,270,75,3104,617,3721,0.016478,-0.0847861,-0.996263,0
2625,0,0,0,0,263,73,2961,563,3524,0.00671299,-0.148243,-0.988928,0
2486,0,0,0,0,284,76,2846,572,3418,0.0301105,0.045632,-0.998504,0
2552,0,0,0,0,298,78,2928,643,3571,0.0267655,-0.0190068,-0.999461,0
2598,0,0,0,0,334,109,3041,628,3669,0.00272844,-0.0588639,-0.998262,0
2664,0,0,0,0,321,92,3077,498,3575,-0.0185676,-0.120797,-0.992504,0
2805,0,0,0,0,469,94,3368,536,3904,-0.0202514,0.075194,-0.996963,0
2591,0,0,0,0,343,86,3020,485,3505,-0.0188393,0.011887,-0.999752,0
2672,0,0,0,0,362,87,3121,532,3653,-0.0315328,-0.0598695,-0.997708,0
2706,0,0,0,0,352,90,3148,392,3540,-0.0337489,-0.0821993,-0.996044,0
2557,0,0,0,0,371,92,3020,290,3310,0.0135679,-0.244675,-0.96951,0
2602,0,0,0,0,364,90,3056,470,3526,0.0190845,0.0385467,-0.999075,0
2751,0,0,0,0,375,159,3285,579,3864,0.0235199,-0.0531252,-0.998311,0
2739,0,0,0,0,379,97,3215,691,3906,0.0192921,-0.124115,-0.99208,0
2731,0,0,0,0,438,92,3261,956,4217,0.0147211,-0.0200862,-0.99969,0
2699,0,0,0,0,358,93,3150,1410,4560,0.0142765,-0.0935414,-0.995513,0
2686,0,0,0,0,358,87,3131,1749,4880,0.00972534,-0.172766,-0.984915,0
2582,0,0,0,0,338,84,3004,2014,5018,0.00189437,0.0639259,-0.997953,0
2737,0,0,0,0,347,89,3173,2235,5408,0.00232639,0.0285543,-0.99959,0
2834,0,0,0,0,308,78,3220,2244,5464,-0.00260463,0.00318469,-0.999992,0
2826,0,0,0,0,280,70,3176,2238,5414,-0.0145358,0.0286472,-0.999484,0
2551,0,0,0,0,251,64,2866,1956,4822,-0.0143804,-0.0564159,-0.998304,0
2741,0,0,0,0,243,64,3048,1612,4660,-0.00909029,0.0266722,-0.999603,0
2524,0,0,0,0,254,64,2842,1422,4264,-0.0130043,-0.0587826,-0.998186,0
2613,0,0,0,0,318,65,2996,1383,4379,-0.0210178,-0.136371,-0.990435,0
2653,0,0,0,0,275,95,3023,1232,4255,-0.0222963,-0.235076,-0.971721,0
2655,0,0,0,0,260,68,2983,1242,4225,-0.0103697,0.0572721,-0.998305,0
2484,0,0,0,0,282,68,2834,1206,4040,-0.00898569,0.0887124,-0.996017,0
2714,0,0,0,0,323,93,3130,2054,5184,-0.0111712,-0.00417956,-0.999929,0
2720,0,0,0,0,342,95,3157,1139,4296,-0.024451,-0.100054,-0.994682,0
2800,0,0,0,0,383,94,3277,1189,4466,-0.0359111,-0.192719,-0.980597,0
2876,0,0,0,0,507,139,3522,1180,4702,-0.0442434,-0.279674,-0.959075,0
2801,0,0,0,0,424,103,3328,1016,4344,-0.00442426,0.041879,-0.999113,0
2888,0,0,0,0,433,118,3439,890,4329,-0.011807,-0.0522556,-0.998564,0
3626,0,0,0,0,634,178,4438,872,5310,0.0106471,0.0921219,-0.995691,0
2924,0,0,0,0,439,109,3472,890,4362,-0.00291999,0.115597,-0.993292,0
3136,0,0,0,0,448,114,3698,854,4552,-0.000276469,0.0211987,-0.999775,0
2802,0,0,0,0,483,123,3408,851,4259,-0.00100881,-0.083347,-0.99652,0
2857,0,0,0,0,549,134,3540,910,4450,0.00120094,-0.186443,-0.982465,0
2801,0,0,0,0,463,126,3390,937,4327,-0.0261926,0.0858844,-0.995961,0
2869,0,0,0,0,488,154,3511,1046,4557,-0.0281114,-0.0215397,-0.999373,0
2649,0,0,0,0,457,136,3242,977,4219,-0.0318764,-0.134544,-0.990395,0
2884,0,0,0,0,502,122,3508,1115,4623,-0.0375245,-0.246137,-0.968508,0
2608,0,0,0,0,539,118,3265,1098,4363,-0.0471755,-0.35939,-0.931994,0
2722,0,0,0,0,745,170,3637,1579,5216,-0.0554934,-0.44903,-0.891792,0
2736,0,0,0,0,475,128,3339,1372,4711,0.0127328,0.192496,-0.981215,0
2990,0,0,0,0,486,110,3586,1194,4780,0.00612138,0.0753076,-0.997142,0
2701,0,0,0,0,414,107,3222,891,4113,-0.00169142,-0.0473222,-0.998878,0
2680,0,0,0,0,544,120,3344,649,3993,0.0187901,0.120096,-0.992585,0
2768,0,0,0,0,406,98,3272,833,4105,0.0144811,0.00439918,-0.999885,0
2571,0,0,0,0,397,99,3067,964,4031,0.0106432,-0.107173,-0.994183,0
2465,0,0,0,0,365,88,2918,730,3648,0.0117665,-0.221116,-0.975176,0
2628,0,0,0,0,375,91,3094,645,3739,0.0122063,-0.321761,-0.946742,0
2602,0,0,0,0,459,90,3151,606,3757,0.000757296,-0.433616,-0.901097,0
2506,0,0,0,0,346,88,2940,646,3586,0.0102224,0.0795939,-0.996775,0
2699,0,0,0,0,323,79,3101,755,3856,0.0159892,0.0704764,-0.997385,0
2536,0,0,0,0,334,86,2956,765,3721,0.0120651,-0.0432415,-0.998992,0
2573,0,0,0,0,312,90,2975,814,3789,0.0304739,0.0504999,-0.998259,0
2782,0,0,0,0,283,70,3135,765,3900,0.0297114,0.0954396,-0.994992,0
2579,0,0,0,0,241,63,2883,826,3709,0.0362815,0.000773996,-0.999342,0
2698,0,0,0,0,218,68,2984,728,3712,0.037038,-0.0960919,-0.994683,0
2492,0,0,0,0,251,77,2820,596,3416,0.0272396,0.0616817,-0.997724,0
2595,0,0,0,0,207,56,2858,497,3355,0.0123892,0.0467985,-0.998827,0
2647,0,0,0,0,227,68,2942,441,3383,0.00595026,0.0238586,-0.999697,0
2488,0,0,0,0,235,77,2800,448,3248,0.0120855,0.0909554,-0.995782,0
2512,0,0,0,0,225,61,2798,368,3166,-0.00152878,0.13821,-0.990402,0
2437,0,0,0,0,245,77,2759,405,3164,0.0185119,0.0755048,-0.996974,0
3398,0,0,0,0,291,72,3761,367,4128,-0.0281989,0.0569979,-0.997976,0
2518,0,0,0,0,272,86,2876,343,3219,-0.00418728,0.0192965,-0.999805,0
2501,0,0,0,0,317,76,2894,360,3254,-0.00160522,-0.0616269,-0.998098,0
2547,0,0,0,0,300,79,2926,386,3312,-0.0300395,-0.134127,-0.990509,0
2510,0,0,0,0,369,83,2962,385,3347,0.00614925,-0.220936,-0.975269,0
2635,0,0,0,0,345,87,3067,452,3519,0.0297828,-0.307008,-0.951241,0
2649,0,0,0,0,326,118,3093,480,3573,0.0356277,-0.361348,-0.93175,0
3689,0,0,0,0,549,116,4354,630,4984,0.0070737,-0.248485,-0.96861,0
2475,0,0,0,0,335,94,2904,316,3220,-0.027774,0.043973,-0.998647,0
2742,0,0,0,0,404,87,3233,332,3565,0.0053808,-0.0988556,-0.995087,0
2750,0,0,0,0,397,89,3236,452,3688,-0.00170188,-0.183211,-0.983072,0
2830,0,0,0,0,367,89,3286,635,3921,0.0155874,0.00170109,-0.999877,0
2912,0,0,0,0,377,90,3379,875,4254,0.00268469,0.05717,-0.998361,0
2857,0,0,0,0,400,103,3360,1288,4648,-0.00251077,0.0422338,-0.999105,0
2647,0,0,0,0,359,110,3116,1778,4894,-0.0119685,-0.0525954,-0.998544,0
2741,0,0,0,0,330,86,3157,2129,5286,-0.00741675,0.0715526,-0.997409,0
2586,0,0,0,0,336,83,3005,2217,5222,-0.0204197,-0.0260217,-0.999453,0
2812,0,0,0,0,338,70,3220,2444,5664,-0.0350007,-0.124545,-0.991596,0
2473,0,0,0,0,233,59,2765,1990,4755,-0.0488722,-0.2191,-0.974478,0
2685,0,0,0,0,224,59,2968,1697,4665,-0.060834,-0.3211,-0.945089,0
2534,0,0,0,0,266,59,2859,1424,4283,-0.0723196,-0.406918,-0.910598,0
2506,0,0,0,0,316,73,2895,1332,4227,-0.0343246,0.00091499,-0.99941,0
2541,0,0,0,0,241,80,2862,1323,4185,-0.032921,0.0869825,-0.995666,0
2698,0,0,0,0,251,82,3031,1323,4354,-0.0646431,-0.00849047,-0.997873,0
3672,0,0,0,0,461,96,4229,1618,5847,-0.0288101,0.079952,-0.996382,0
2660,0,0,0,0,313,74,3047,1430,4477,-0.0591049,0.0079043,-0.998221,0
2776,0,0,0,0,360,84,3220,1276,4496,-0.0216914,0.0693723,-0.997355,0
2786,0,0,0,0,349,90,3225,1396,4621,0.0228504,0.124998,-0.991894,0
2573,0,0,0,0,383,95,3051,1103,4154,-0.0312454,0.0363119,-0.998852,0
2725,0,0,0,0,426,104,3255,1172,4427,-0.0873938,-0.0556125,-0.99462,0
2873,0,0,0,0,468,187,3528,1159,4687,0.0167402,0.0991819,-0.994929,0
2791,0,0,0,0,481,126,3398,1267,4665,-0.0419735,0.0175962,-0.998964,0
2721,0,0,0,0,492,126,3339,1157,4496,0.0302599,0.0978304,-0.994743,0
2933,0,0,0,0,567,150,3650,1423,5073,0.0801762,0.168504,-0.982435,0
2848,0,0,0,0,505,134,3487,1074,4561,0.034224,0.116105,-0.992647,0
2943,0,0,0,0,526,139,3608,1329,4937,-0.0363467,0.035423,-0.998711,0
2977,0,0,0,0,535,142,3654,1178,4832,-0.105844,-0.0421697,-0.993488,0
3139,0,0,0,0,576,141,3856,1345,5201,0.0644953,0.126512,-0.989866,0
2797,0,0,0,0,668,139,3604,1297,4901,-0.0149056,0.0602775,-0.99807,0
2807,0,0,0,0,548,143,3498,1252,4750,-0.0944824,-0.00839543,-0.995491,0
2798,0,0,0,0,631,143,3572,1170,4742,-0.174093,-0.0772835,-0.981692,0
3023,0,0,0,0,653,146,3822,1155,4977,0.138933,0.0962251,-0.985616,0
3104,0,0,0,0,575,153,3832,1116,4948,0.0794231,0.0613307,-0.994953,0
2761,0,0,0,0,482,117,3360,754,4114,0.160018,0.116511,-0.980214,0
2661,0,0,0,0,428,101,3190,558,3748,0.0578741,0.058415,-0.996614,0
2703,0,0,0,0,535,103,3341,549,3890,-0.0413907,0.00674601,-0.99912,0
2658,0,0,0,0,456,101,3215,885,4100,0.121701,0.0633835,-0.990541,0
2722,0,0,0,0,457,156,3335,866,4201,0.0403706,0.0312904,-0.998695,0
2722,0,0,0,0,380,90,3192,813,4005,-0.0660738,-0.00724182,-0.997789,0
2602,0,0,0,0,422,106,3130,690,3820,-0.169676,-0.043379,-0.984545,0
2768,0,0,0,0,324,85,3177,810,3987,0.098839,0.0379731,-0.994379,0
2576,0,0,0,0,429,87,3092,892,3984,0.0147618,0.0168133,-0.99975,0
2619,0,0,0,0,317,79,3015,949,3964,0.0834174,0.019009,-0.996334,0
2850,0,0,0,0,319,84,3253,1027,4280,-0.0186143,0.0171175,-0.99968,0
2664,0,0,0,0,348,89,3101,1130,4231,0.0589916,-0.00892838,-0.998219,0
2635,0,0,0,0,317,82,3034,1211,4245,0.0832373,-0.0328668,-0.995988,0
2592,0,0,0,0,291,77,2960,1041,4001,-0.00963971,-0.0253397,-0.999632,0
2894,0,0,0,0,291,88,3273,1077,4350,-0.100478,-0.0236322,-0.994659,0
2510,0,0,0,0,286,72,2868,862,3730,-0.189776,-0.0244948,-0.981522,0
2461,0,0,0,0,284,78,2823,869,3692,-0.274555,-0.0266065,-0.961203,0
2350,0,0,0,0,248,67,2665,717,3382,-0.359253,-0.027705,-0.932829,0
2408,0,0,0,0,254,67,2729,660,3389,0.0814647,-0.0031499,-0.996671,0
2510,0,0,0,0,313,74,2897,693,3590,0.109372,-0.0247023,-0.993694,0
2710,0,0,0,0,320,94,3124,724,3848,0.0373203,-0.00365189,-0.999297,0
2692,0,0,0,0,396,123,3211,717,3928,-0.00936865,0.0124226,-0.999879,0
2828,0,0,0,0,339,91,3258,909,4167,0.053571,-0.0139073,-0.998467,0
2610,0,0,0,0,353,91,3054,785,3839,0.0056554,0.0147277,-0.999876,0
2817,0,0,0,0,443,98,3358,859,4217,-0.0391442,0.0409856,-0.998393,0
2677,0,0,0,0,377,113,3167,782,3949,0.0517918,-0.0293327,-0.998227,0
2594,0,0,0,0,402,111,3107,795,3902,0.0468471,-0.0299808,-0.998452,0
2702,0,0,0,0,443,110,3255,711,3966,0.00902675,-0.00492044,-0.999947,0
2997,0,0,0,0,428,118,3543,953,4496,0.0254066,-0.013924,-0.99958,0
2804,0,0,0,0,444,115,3363,830,4193,0.0387522,-0.0250859,-0.998934,0
3088,0,0,0,0,453,118,3659,925,4584,-0.000188299,-0.000517327,-1,0
2810,0,0,0,0,466,125,3401,943,4344,-0.0451675,0.0193923,-0.998791,0
2653,0,0,0,0,531,136,3320,770,4090,-0.0838052,0.0437783,-0.99552,0
2764,0,0,0,0,549,126,3439,592,4031,-0.0990817,0.0643346,-0.992998,0
2752,0,0,0,0,508,129,3389,510,3899,-0.116717,0.0864031,-0.9894,0
2683,0,0,0,0,579,140,3402,542,3944,0.0477642,-0.0371684,-0.998167,0
2759,0,0,0,0,600,139,3498,552,4050,0.0283859,-0.0134625,-0.999506,0
2738,0,0,0,0,538,138,3414,518,3932,0.0129243,0.0136423,-0.999823,0
2633,0,0,0,0,606,140,3379,533,3912,-0.0523405,0.0669455,-0.996383,0
2796,0,0,0,0,596,150,3542,689,4231,0.0188022,-0.013581,-0.999731,0
2743,0,0,0,0,704,174,3621,765,4386,0.00970552,0.0125999,-0.999873,0
2872,0,0,0,0,571,158,3601,847,4448,0.0275489,-0.0324015,-0.999095,0
2749,0,0,0,0,579,139,3467,880,4347,0.013697,0.0059569,-0.999888,0
2952,0,0,0,0,544,160,3656,922,4578,-0.00117371,0.0579464,-0.998319,0
2667,0,0,0,0,538,141,3346,1103,4449,-0.0194414,0.100149,-0.994782,0
2825,0,0,0,0,570,157,3552,1380,4932,-0.0346311,0.143099,-0.989103,0
2774,0,0,0,0,626,138,3538,1664,5202,0.0160736,0.0108549,-0.999812,0
2859,0,0,0,0,543,127,3529,1657,5186,0.00359635,0.0632995,-0.997988,0
2777,0,0,0,0,499,121,3397,1956,5353,-0.00791937,0.120506,-0.992681,0
2753,0,0,0,0,499,118,3370,2038,5408,-0.016186,0.182882,-0.983002,0
2938,0,0,0,0,496,119,3553,2142,5695,-0.0228835,0.248991,-0.968236,0
4018,0,0,0,0,759,162,4939,2833,7772,0.0198552,0.121805,-0.992355,0
2685,0,0,0,0,443,130,3258,2100,5358,0.00851228,-0.00924722,-0.999921,0
2563,0,0,0,0,424,104,3091,1692,4783,-0.000546636,0.0664957,-0.997787,0
2955,0,0,0,0,382,105,3442,1608,5050,0.0420118,-0.0302151,-0.99866,0
2634,0,0,0,0,372,90,3096,1234,4330,0.0273999,0.0543646,-0.998145,0
2766,0,0,0,0,468,92,3326,1341,4667,0.0389819,-0.0487266,-0.998051,0
2518,0,0,0,0,338,85,2941,1174,4115,0.0476992,0.0372499,-0.998167,0
2728,0,0,0,0,367,95,3190,1229,4419,0.0374031,0.128539,-0.990999,0
2549,0,0,0,0,352,87,2988,1189,4177,0.038725,0.216884,-0.975429,0
3070,0,0,0,0,403,88,3561,1150,4711,0.0426053,0.302593,-0.952167,0
2674,0,0,0,0,350,88,3112,1030,4142,0.0218476,-0.021199,-0.999537,0
2751,0,0,0,0,359,108,3218,1074,4292,0.03174,0.0743638,-0.996726,0
2572,0,0,0,0,385,94,3051,931,3982,0.0112882,-0.0730536,-0.997264,0
2902,0,0,0,0,514,124,3540,965,4505,0.0248335,0.026405,-0.999343,0
2758,0,0,0,0,644,149,3551,984,4535,0.0377757,0.119135,-0.992159,0
2912,0,0,0,0,426,110,3448,905,4353,0.0171675,0.0048293,-0.999841,0
2766,0,0,0,0,441,112,3319,898,4217,0.0290427,0.11623,-0.992798,0
2766,0,0,0,0,558,127,3451,797,4248,0.0440097,0.225384,-0.973276,0
2848,0,0,0,0,485,125,3458,739,4197,0.049306,0.354278,-0.93384,0
4101,0,0,0,0,480,128,4709,938,5647,-0.0202755,-0.236038,-0.971532,0
3018,0,0,0,0,489,123,3630,871,4501,-0.0127511,-0.120917,-0.992581,0
4084,0,0,0,0,521,138,4743,835,5578,-0.016205,-0.164369,-0.986266,0
2785,0,0,0,0,528,122,3435,855,4290,-0.00927868,-0.050644,-0.998674,0
2761,0,0,0,0,486,140,3387,910,4297,-0.0010839,0.0673439,-0.997729,0
2811,0,0,0,0,497,122,3430,1254,4684,0.00908797,0.185811,-0.982544,0
2803,0,0,0,0,482,120,3405,1313,4718,0.0219574,0.300702,-0.953465,0
2656,0,0,0,0,419,111,3186,921,4107,0.0357664,0.408281,-0.912155,0
2752,0,0,0,0,475,106,3333,785,4118,0.0527425,0.510768,-0.8581,0
2938,0,0,0,0,373,102,3413,1162,4575,0.065011,0.576173,-0.814738,0
2776,0,0,0,0,378,93,3247,1076,4323,-0.0112019,-0.121031,-0.992586,0
2704,0,0,0,0,421,111,3236,939,4175,-0.0257967,-0.167079,-0.985606,0
2740,0,0,0,0,620,104,3464,876,4340,-0.0201812,-0.065369,-0.997657,0
2556,0,0,0,0,410,100,3066,815,3881,-0.0208222,0.0324078,-0.999258,0
2606,0,0,0,0,412,101,3119,797,3916,-0.0325099,-0.0515347,-0.998142,0
2721,0,0,0,0,377,96,3194,846,4040,-0.0385288,0.0425963,-0.998349,0
2698,0,0,0,0,512,138,3348,919,4267,-0.0391147,0.12598,-0.991261,0
2511,0,0,0,0,488,104,3103,1034,4137,-0.0321526,0.199447,-0.979381,0
3179,0,0,0,0,420,96,3695,1066,4761,-0.0259367,-0.0769872,-0.996695,0
2596,0,0,0,0,449,116,3161,950,4111,-0.0183738,-0.0115042,-0.999765,0
2868,0,0,0,0,511,99,3478,963,4441,-0.00891369,0.0721745,-0.997352,0
2721,0,0,0,0,449,113,3283,954,4237,-0.000242831,0.115941,-0.993256,0
2466,0,0,0,0,306,79,2851,948,3799,-0.0251593,-0.0174383,-0.999532,0
2727,0,0,0,0,373,79,3179,949,4128,-0.0173017,0.0278711,-0.999462,0
2736,0,0,0,0,288,66,3090,717,3807,-0.0400886,-0.051176,-0.997885,0
2470,0,0,0,0,216,59,2745,685,3430,-0.0501148,-0.0960032,-0.994119,0
2498,0,0,0,0,208,58,2764,823,3587,-0.0235458,-0.0219382,-0.999482,0
2559,0,0,0,0,218,60,2837,691,3528,-0.0447792,-0.0622072,-0.997058,0
2803,0,0,0,0,228,61,3092,705,3797,-0.0460565,-0.0629084,-0.996956,0
2633,0,0,0,0,246,65,2944,741,3685,-0.0203765,0.00445331,-0.999782,0
2599,0,0,0,0,249,75,2923,859,3782,-0.0458402,-0.0660845,-0.996761,0
2631,0,0,0,0,313,73,3017,811,3828,-0.0309272,0.00138536,-0.999521,0
2740,0,0,0,0,351,83,3174,864,4038,-0.0201559,0.0756527,-0.996931,0
2700,0,0,0,0,280,78,3058,877,3935,-0.0477255,-0.0644899,-0.996777,0
2956,0,0,0,0,287,77,3320,772,4092,-0.0353654,-0.0520338,-0.998019,0
2479,0,0,0,0,346,81,2906,785,3691,-0.0180694,-0.0318209,-0.99933,0
2672,0,0,0,0,333,86,3091,673,3764,-0.0212203,-0.067827,-0.997471,0
2598,0,0,0,0,361,92,3051,581,3632,-0.00897461,-0.0296957,-0.999519,0
2619,0,0,0,0,392,118,3129,403,3532,-0.011816,-0.128134,-0.991686,0
2695,0,0,0,0,491,107,3293,233,3526,-0.0363213,-0.237691,-0.970662,0
2898,0,0,0,0,441,98,3437,207,3644,-0.00376959,-0.196804,-0.980436,0
2663,0,0,0,0,404,99,3166,221,3387,0.055375,-0.101959,-0.993246,0
3136,0,0,0,0,385,105,3626,236,3862,-0.0863491,-0.000440127,-0.996265,0
2689,0,0,0,0,441,106,3236,674,3910,-0.00919484,0.0427278,-0.999044,0
2810,0,0,0,0,496,165,3471,687,4158,0.0129632,0.126603,-0.991869,0
2758,0,0,0,0,437,108,3303,1035,4338,-0.0388088,-0.00904809,-0.999206,0
2686,0,0,0,0,539,122,3347,1769,5116,-0.0138332,0.0776728,-0.996883,0
2808,0,0,0,0,426,106,3340,1917,5257,0.00250517,0.163673,-0.986512,0
2728,0,0,0,0,429,124,3281,2167,5448,0.0181745,0.253321,-0.967212,0
2610,0,0,0,0,395,115,3120,2067,5187,0.0314838,0.338838,-0.940318,0
2664,0,0,0,0,340,85,3089,2318,5407,0.0505111,0.425414,-0.903588,0
2620,0,0,0,0,372,91,3083,2203,5286,0.0715501,0.502178,-0.861799,0
3070,0,0,0,0,322,77,3469,1823,5292,0.0238894,0.0256786,-0.999385,0
2560,0,0,0,0,282,84,2926,1472,4398,0.00326362,-0.0614189,-0.998107,0
2444,0,0,0,0,317,88,2849,1510,4359,0.00216777,-0.0494291,-0.998775,0
2423,0,0,0,0,283,81,2787,1371,4158,-0.000233368,-0.0274463,-0.999623,0
2749,0,0,0,0,294,75,3118,1425,4543,0.0378976,0.0652288,-0.99715,0
2557,0,0,0,0,310,82,2949,1171,4120,-0.019916,-0.0336849,-0.999234,0
2805,0,0,0,0,400,87,3292,1103,4395,-0.0158334,-0.0600623,-0.998069,0
2692,0,0,0,0,381,101,3174,995,4169,0.020775,0.0442148,-0.998806,0
2912,0,0,0,0,395,104,3411,1031,4442,-0.00691609,-0.0249997,-0.999663,0
2808,0,0,0,0,398,125,3331,1113,4444,0.0250461,0.072095,-0.997083,0
2730,0,0,0,0,688,143,3561,974,4535,0.00632249,-0.0187264,-0.999805,0
2886,0,0,0,0,506,122,3514,918,4432,-0.00549315,-0.0820763,-0.996611,0
2946,0,0,0,0,466,126,3538,1101,4639,-0.0312778,-0.142641,-0.98928,0
3028,0,0,0,0,474,149,3651,896,4547,-0.0545261,-0.192582,-0.979765,0
3057,0,0,0,0,467,122,3646,951,4597,-0.019023,-0.0872797,-0.996002,0
2790,0,0,0,0,535,123,3448,852,4300,0.0161233,0.0174173,-0.999718,0
2944,0,0,0,0,458,114,3516,1055,4571,0.0529191,0.132736,-0.989738,0
2762,0,0,0,0,537,112,3411,910,4321,0.0895833,0.243766,-0.965688,0
2751,0,0,0,0,482,113,3346,1052,4398,0.124515,0.355396,-0.926385,0
2790,0,0,0,0,443,111,3344,874,4218,-0.0606902,-0.128067,-0.989907,0
2698,0,0,0,0,425,106,3229,1110,4339,-0.0300918,-0.00955343,-0.999502,0
2821,0,0,0,0,409,102,3332,1296,4628,0.000706211,0.110596,-0.993865,0
2680,0,0,0,0,391,103,3174,887,4061,-0.0167265,-0.08193,-0.996498,0
2622,0,0,0,0,422,97,3141,596,3737,0.00710484,0.041295,-0.999122,0
2605,0,0,0,0,337,87,3029,590,3619,0.0374976,0.169353,-0.984842,0
2859,0,0,0,0,350,86,3295,676,3971,0.0637804,0.29385,-0.953721,0
2553,0,0,0,0,352,91,2996,739,3735,0.0925715,0.404488,-0.909846,0
2695,0,0,0,0,378,106,3179,747,3926,0.120287,0.507934,-0.852956,0
2656,0,0,0,0,362,98,3116,1520,4636,0.0565531,0.283333,-0.957353,0
2731,0,0,0,0,366,92,3189,911,4100,-0.0262486,-0.0989887,-0.994742,0
3020,0,0,0,0,356,93,3469,913,4382,-0.0237546,-0.0420779,-0.998832,0
2555,0,0,0,0,507,94,3156,1020,4176,-0.0114246,0.0228062,-0.999674,0
2563,0,0,0,0,346,92,3001,1041,4042,-0.0339212,-0.0373731,-0.998725,0
2765,0,0,0,0,347,92,3204,1002,4206,-0.00968949,0.0450419,-0.998938,0
2653,0,0,0,0,429,93,3175,1025,4200,0.0122257,0.124089,-0.992196,0
2701,0,0,0,0,343,85,3129,1004,4133,0.0350589,0.19746,-0.979684,0
2664,0,0,0,0,323,87,3074,921,3995,-0.0215028,-0.00886234,-0.999729,0
2473,0,0,0,0,305,78,2856,902,3758,0.00467015,0.0588915,-0.998254,0
2569,0,0,0,0,339,71,2979,1116,4095,-0.0131782,-0.0107451,-0.999855,0
2650,0,0,0,0,337,85,3072,789,3861,-0.0512759,-0.0631241,-0.996688,0
2488,0,0,0,0,246,76,2810,827,3637,-0.0487375,-0.0518931,-0.997463,0
2348,0,0,0,0,251,64,2663,767,3430,-0.0164324,0.0100192,-0.999815,0
2817,0,0,0,0,304,65,3186,885,4071,-0.0517165,-0.0403239,-0.997847,0
2717,0,0,0,0,251,67,3035,760,3795,-0.0322094,0.000781822,-0.999481,0
2730,0,0,0,0,258,68,3056,811,3867,-0.0299186,0.005302,-0.999538,0
2544,0,0,0,0,266,68,2878,800,3678,-0.000608339,0.0629329,-0.998018,0
2535,0,0,0,0,288,93,2916,838,3754,0.0184928,0.12888,-0.991488,0
2655,0,0,0,0,320,74,3049,778,3827,0.0400968,0.194311,-0.98012,0
2701,0,0,0,0,351,78,3130,862,3992,-0.0295445,-0.047475,-0.998436,0
2610,0,0,0,0,318,86,3014,817,3831,-0.00934164,0.0217295,-0.99972,0
2769,0,0,0,0,326,87,3182,854,4036,-0.00869856,-0.0596928,-0.998179,0
2629,0,0,0,0,330,88,3047,750,3797,-0.00352157,-0.0460703,-0.998932,0
2618,0,0,0,0,342,87,3047,700,3747,0.0149889,0.0146631,-0.99978,0
2661,0,0,0,0,363,92,3116,505,3621,0.0369719,0.100983,-0.994201,0
2751,0,0,0,0,377,102,3230,468,3698,0.0572975,0.140606,-0.988406,0
2790,0,0,0,0,376,102,3268,327,3595,0.060396,0.143728,-0.987773,0
2730,0,0,0,0,553,104,3387,271,3658,0.14118,0.134079,-0.980862,0
2611,0,0,0,0,385,109,3105,392,3497,0.114082,0.372435,-0.92102,0
3680,0,0,0,0,628,133,4441,519,4960,-0.0627411,0.0351297,-0.997412,0
2648,0,0,0,0,394,101,3143,505,3648,-0.0528221,-0.0582565,-0.996903,0
2616,0,0,0,0,444,129,3189,656,3845,-0.0456293,0.0236768,-0.998678,0
2700,0,0,0,0,428,108,3236,906,4142,0.00889492,0.0878513,-0.996094,0
2784,0,0,0,0,489,114,3387,1442,4829,0.0254026,0.158991,-0.986953,0
2630,0,0,0,0,465,106,3201,1720,4921,0.0456829,0.229498,-0.972237,0
2722,0,0,0,0,502,113,3337,1949,5286,0.0678758,0.298777,-0.951906,0
2630,0,0,0,0,381,95,3106,2057,5163,0.0866322,0.366911,-0.926214,0
2650,0,0,0,0,585,100,3335,2259,5594,0.106314,0.438052,-0.892641,0
2557,0,0,0,0,332,81,2970,2606,5576,0.129098,0.506007,-0.852813,0
2496,0,0,0,0,328,83,2907,2213,5120,0.14528,0.574754,-0.805327,0
2609,0,0,0,0,342,83,3034,1629,4663,0.168573,0.593875,-0.786699,0
2613,0,0,0,0,415,108,3136,1390,4526,0.0318517,0.0121012,-0.999419,0
2463,0,0,0,0,277,68,2808,1364,4172,0.0387661,-0.0157323,-0.999124,0
2598,0,0,0,0,277,85,2960,1427,4387,0.0298654,-0.0511777,-0.998243,0
2463,0,0,0,0,270,113,2846,1177,4023,0.0704753,0.0487534,-0.996321,0
2743,0,0,0,0,385,75,3203,1184,4387,0.0262443,0.00521453,-0.999642,0
2626,0,0,0,0,367,82,3075,1082,4157,0.0624126,0.0816342,-0.994706,0
2822,0,0,0,0,349,90,3261,1020,4281,-0.00347997,-0.0494712,-0.998769,0
2771,0,0,0,0,402,94,3267,1037,4304,0.0504363,0.0554944,-0.997184,0
3101,0,0,0,0,404,100,3605,955,4560,0.000968011,-0.026977,-0.999636,0
2808,0,0,0,0,429,107,3344,951,4295,0.051165,0.0773864,-0.995687,0
2896,0,0,0,0,453,108,3457,837,4294,-0.0306442,-0.0634003,-0.997518,0
2750,0,0,0,0,418,102,3270,914,4184,0.0240448,0.0496978,-0.998475,0
2938,0,0,0,0,400,101,3439,956,4395,0.070829,0.148569,-0.986362,0
2699,0,0,0,0,451,113,3263,915,4178,0.119497,0.247671,-0.961447,0
2829,0,0,0,0,488,109,3426,888,4314,0.167629,0.344865,-0.923563,0
2615,0,0,0,0,421,109,3145,882,4027,0.212714,0.442403,-0.871225,0
2711,0,0,0,0,430,164,3305,931,4236,-0.0726023,-0.148432,-0.986254,0
2597,0,0,0,0,392,109,3098,1089,4187,-0.0378494,-0.047506,-0.998154,0
2525,0,0,0,0,411,114,3050,1100,4150,-0.000568105,0.0520865,-0.998642,0
2586,0,0,0,0,396,118,3100,1276,4376,0.0378256,0.14755,-0.988331,0
2919,0,0,0,0,535,115,3569,1421,4990,0.0780709,0.241487,-0.967259,0
2636,0,0,0,0,475,106,3217,1253,4470,0.11538,0.329762,-0.936987,0
2726,0,0,0,0,416,95,3237,945,4182,0.152779,0.413883,-0.897418,0
2717,0,0,0,0,393,86,3196,515,3711,0.188981,0.490525,-0.850689,0
2653,0,0,0,0,335,98,3086,562,3648,0.0684194,0.194764,-0.978461,0
2470,0,0,0,0,350,85,2905,661,3566,-0.00183397,-0.0208548,-0.999781,0
2585,0,0,0,0,432,99,3116,747,3863,-0.023986,-0.0526223,-0.998326,0
2709,0,0,0,0,371,111,3191,741,3932,0.00204892,0.0460957,-0.998935,0
2670,0,0,0,0,400,106,3176,795,3971,0.0283402,0.141487,-0.989535,0
2611,0,0,0,0,368,109,3088,682,3770,0.0580367,0.231223,-0.971168,0
2597,0,0,0,0,363,103,3063,790,3853,0.0803135,0.322476,-0.943164,0
2558,0,0,0,0,346,90,2994,810,3804,0.104916,0.402783,-0.909263,0
3102,0,0,0,0,380,89,3571,888,4459,0.127931,0.484272,-0.865514,0
2749,0,0,0,0,343,87,3179,1197,4376,0.134053,0.515319,-0.846449,0
2713,0,0,0,0,325,82,3120,858,3978,-0.0231665,0.00442516,-0.999722,0
2694,0,0,0,0,311,96,3101,925,4026,-0.00994799,0.0880067,-0.99607,0
2542,0,0,0,0,321,76,2939,852,3791,0.00529616,0.181237,-0.983425,0
2616,0,0,0,0,290,75,2981,885,3866,-0.0211431,-0.0491759,-0.998566,0
2982,0,0,0,0,276,83,3341,945,4286,-0.000211764,0.0322081,-0.999481,0
2551,0,0,0,0,265,68,2884,738,3622,0.0234394,0.109878,-0.993669,0
2686,0,0,0,0,319,94,3099,699,3798,0.0454238,0.187607,-0.981193,0
2473,0,0,0,0,271,64,2808,751,3559,0.0710768,0.257913,-0.96355,0
2797,0,0,0,0,244,62,3103,854,3957,-0.0302542,-0.0197813,-0.999347,0
2549,0,0,0,0,250,64,2863,823,3686,-0.0495095,-0.0814004,-0.995451,0
2870,0,0,0,0,265,66,3201,999,4200,-0.0277681,-0.00846032,-0.999579,0
2426,0,0,0,0,269,77,2772,897,3669,-0.040769,-0.040888,-0.998332,0
2675,0,0,0,0,271,70,3016,1014,4030,-0.0224035,0.0286487,-0.999339,0
2485,0,0,0,0,380,77,2942,856,3798,-0.0425105,-0.0446937,-0.998096,0
2519,0,0,0,0,454,103,3076,905,3981,-0.0314045,0.0232454,-0.999237,0
2417,0,0,0,0,302,79,2798,839,3637,-0.0166551,0.0881551,-0.995968,0
2605,0,0,0,0,362,83,3050,845,3895,-0.0007518,0.146808,-0.989165,0
2468,0,0,0,0,319,80,2867,925,3792,0.00754299,0.209488,-0.977782,0
2500,0,0,0,0,330,97,2927,976,3903,0.0126469,0.261594,-0.965095,0
2673,0,0,0,0,344,88,3105,779,3884,-0.0300796,-0.0299153,-0.9991,0
2493,0,0,0,0,382,82,2957,730,3687,-0.0229672,0.0256992,-0.999406,0
2389,0,0,0,0,332,80,2801,719,3520,-0.0214237,0.0575974,-0.99811,0
2447,0,0,0,0,343,109,2899,492,3391,-0.0300449,-0.0875122,-0.99571,0
2570,0,0,0,0,343,86,2999,369,3368,-0.0244733,-0.0756711,-0.996832,0
2580,0,0,0,0,377,97,3054,325,3379,-0.0142849,0.0174861,-0.999745,0
2562,0,0,0,0,495,94,3151,401,3552,-0.00847422,0.0517482,-0.998624,0
2476,0,0,0,0,380,108,2964,451,3415,0.0241558,0.162314,-0.986443,0
2608,0,0,0,0,423,112,3143,985,4128,0.0285256,0.153738,-0.9877,0
3422,0,0,0,0,421,110,3953,1033,4986,0.00382698,-0.00909864,-0.999951,0
2484,0,0,0,0,366,97,2947,923,3870,-0.0102276,-0.0150001,-0.999835,0
2662,0,0,0,0,401,99,3162,936,4098,-0.0140734,-0.0259675,-0.999564,0
2569,0,0,0,0,352,92,3013,828,3841,-0.0227689,-0.0483799,-0.998569,0
2639,0,0,0,0,413,96,3148,816,3964,-0.0299273,-0.0646138,-0.997462,0
2579,0,0,0,0,331,85,2995,757,3752,-0.0422223,-0.0704207,-0.996623,0
2548,0,0,0,0,319,79,2946,752,3698,-0.0892838,-0.116359,-0.989186,0
2429,0,0,0,0,298,73,2800,622,3422,-0.105017,-0.143291,-0.984093,0
2461,0,0,0,0,360,73,2894,568,3462,-0.155588,-0.186118,-0.97013,0
2474,0,0,0,0,264,86,2824,629,3453,-0.166636,-0.22805,-0.959284,0
2481,0,0,0,0,395,91,2967,616,3583,-0.0357532,0.0166305,-0.999222,0
2484,0,0,0,0,277,73,2834,526,3360,-0.0712883,-0.0212269,-0.99723,0
2623,0,0,0,0,252,64,2939,595,3534,-0.0843755,-0.0384631,-0.995692,0
2528,0,0,0,0,225,61,2814,476,3290,-0.103352,-0.0798168,-0.991437,0
2436,0,0,0,0,233,68,2737,528,3265,-0.072142,-0.00728069,-0.997368,0
2308,0,0,0,0,274,67,2649,479,3128,-0.0844828,-0.0272384,-0.996053,0
2469,0,0,0,0,527,61,3057,439,3496,-0.0898992,-0.0296657,-0.995509,0
2269,0,0,0,0,290,90,2649,446,3095,-0.08517,-0.0294864,-0.99593,0
2562,0,0,0,0,205,56,2823,436,3259,-0.0873432,-0.0469975,-0.995069,0
2280,0,0,0,0,201,55,2536,384,2920,-0.0954337,-0.0599718,-0.993628,0
2328,0,0,0,0,191,54,2573,332,2905,-0.0405035,0.00937519,-0.999136,0
2427,0,0,0,0,180,50,2657,358,3015,-0.0640615,0.037532,-0.99724,0
2534,0,0,0,0,174,49,2757,327,3084,-0.0695876,-0.00677197,-0.997553,0
2358,0,0,0,0,155,43,2556,312,2868,-0.0494375,0.0497738,-0.997536,0
2400,0,0,0,0,152,41,2593,400,2993,-0.048764,0.0644105,-0.996731,0
2440,0,0,0,0,194,42,2676,332,3008,-0.0738511,-0.00972091,-0.997222,0
2529,0,0,0,0,232,52,2813,378,3191,-0.0306727,0.0868702,-0.995747,0
2450,0,0,0,0,133,39,2622,389,3011,0.00324643,0.095123,-0.99546,0
2489,0,0,0,0,145,58,2692,505,3197,-0.0241371,0.0144596,-0.999604,0
2467,0,0,0,0,161,42,2670,595,3265,-0.0441827,-0.0402283,-0.998213,0
2614,0,0,0,0,163,45,2822,557,3379,-0.00624453,0.0523864,-0.998607,0
2585,0,0,0,0,173,52,2810,612,3422,0.0127272,0.129105,-0.991549,0
2634,0,0,0,0,191,49,2874,762,3636,-0.0133951,0.0578771,-0.998234,0
2468,0,0,0,0,189,53,2710,640,3350,-0.0117516,0.0717366,-0.997354,0
3000,0,0,0,0,214,56,3270,629,3899,-0.0316552,0.0255792,-0.999172,0
2497,0,0,0,0,203,66,2766,728,3494,-0.0472593,-0.0190334,-0.998701,0
2689,0,0,0,0,252,92,3033,775,3808,-0.0696556,-0.0912652,-0.993388,0
2441,0,0,0,0,212,61,2714,836,3550,-0.0982036,-0.166118,-0.981204,0
2572,0,0,0,0,226,59,2857,1080,3937,-0.129831,-0.220711,-0.96666,0
2540,0,0,0,0,228,58,2826,1006,3832,-0.0105367,0.0777775,-0.996915,0
2650,0,0,0,0,305,62,3017,1219,4236,-0.0324546,0.018588,-0.9993,0
2583,0,0,0,0,281,94,2958,1251,4209,-0.0495893,-0.041562,-0.997905,0
2516,0,0,0,0,265,67,2848,1387,4235,-0.0690516,-0.0907556,-0.993476,0
2531,0,0,0,0,278,68,2877,1881,4758,-0.0848387,-0.156816,-0.983977,0
2382,0,0,0,0,307,80,2769,1525,4294,-0.105099,-0.218974,-0.970054,0
2567,0,0,0,0,325,79,2971,1681,4652,-0.122487,-0.282551,-0.9514,0
2758,0,0,0,0,374,110,3242,1944,5186,-0.0982102,-0.234366,-0.967175,0
2574,0,0,0,0,343,85,3002,2157,5159,0.00109412,0.033955,-0.999423,0
2888,0,0,0,0,389,118,3395,2584,5979,0.00652458,0.0863458,-0.996244,0
2992,0,0,0,0,492,112,3596,2811,6407,0.00986363,0.0908273,-0.995818,0
2699,0,0,0,0,396,153,3248,2858,6106,-0.00162241,0.0365561,-0.99933,0
2614,0,0,0,0,413,114,3141,2745,5886,-0.0229966,-0.00631753,-0.999716,0
2646,0,0,0,0,398,101,3145,2658,5803,-0.0504959,-0.0476092,-0.997589,0
2667,0,0,0,0,393,93,3153,2503,5656,-0.0651703,-0.0898831,-0.993818,0
2649,0,0,0,0,429,96,3174,2390,5564,-0.0654234,-0.128736,-0.989519,0
2868,0,0,0,0,422,99,3389,2435,5824,-0.0653248,-0.162507,-0.984543,0
2719,0,0,0,0,401,95,3215,2381,5596,-0.00967837,0.0012306,-0.999952,0
2908,0,0,0,0,394,96,3398,2458,5856,-0.0172008,0.00679383,-0.999829,0
2778,0,0,0,0,478,100,3356,2201,5557,-0.0099114,0.00341228,-0.999945,0
2708,0,0,0,0,385,117,3210,2216,5426,-0.00719179,-0.000551282,-0.999974,0
2675,0,0,0,0,434,94,3203,2230,5433,-0.0052511,-0.00339826,-0.99998,0
2590,0,0,0,0,381,132,3103,2086,5189,-0.00863207,-0.00342048,-0.999957,0
2849,0,0,0,0,398,104,3351,2061,5412,-0.00496717,-0.00306683,-0.999983,0
2700,0,0,0,0,384,94,3178,1952,5130,-0.0144959,0.00196213,-0.999893,0
2615,0,0,0,0,414,94,3123,1890,5013,-0.0174819,0.0112489,-0.999784,0
2817,0,0,0,0,387,91,3295,1903,5198,-0.0170447,0.0122754,-0.999779,0
2599,0,0,0,0,392,110,3101,1908,5009,-0.016506,0.00435045,-0.999854,0
3798,0,0,0,0,614,129,4541,2492,7033,-0.00496933,-0.00359601,-0.999981,0
2607,0,0,0,0,415,117,3139,1928,5067,-0.00727146,-0.00275316,-0.99997,0
2655,0,0,0,0,367,89,3111,1764,4875,-0.0106035,0.000763219,-0.999943,0
2631,0,0,0,0,367,87,3085,1733,4818,-0.00970049,0.00447828,-0.999943,0
2544,0,0,0,0,388,89,3021,1640,4661,-0.0135858,0.00995833,-0.999858,0
2607,0,0,0,0,365,87,3059,1552,4611,-0.0151859,0.0101826,-0.999833,0
2703,0,0,0,0,347,86,3136,1444,4580,-0.0200634,0.000466651,-0.999799,0
2683,0,0,0,0,347,85,3115,1430,4545,-0.0214666,-0.00647428,-0.999749,0
2742,0,0,0,0,357,96,3195,1248,4443,-0.0225524,-0.00844037,-0.99971,0
3009,0,0,0,0,354,85,3448,1201,4649,-0.0130365,0.0009135,-0.999915,0
2487,0,0,0,0,342,89,2918,1023,3941,-0.0179386,-0.0157868,-0.999714,0
2756,0,0,0,0,359,87,3202,1097,4299,-0.00118287,0.00381167,-0.999992,0
2603,0,0,0,0,370,108,3081,979,4060,-0.00808449,-0.00430445,-0.999958,0
2383,0,0,0,0,412,88,2883,1004,3887,-0.00737497,0.00247014,-0.99997,0
2500,0,0,0,0,345,86,2931,877,3808,-0.00260134,0.0100724,-0.999946,0
2579,0,0,0,0,334,84,2997,921,3918,-0.00623565,0.00661884,-0.999958,0
2619,0,0,0,0,325,92,3036,872,3908,-0.00875547,0.00505283,-0.999949,0
2990,0,0,0,0,337,83,3410,881,4291,-0.00709936,0.0073593,-0.999948,0
2544,0,0,0,0,330,83,2957,796,3753,-0.00853703,-0.00511347,-0.99995,0
2473,0,0,0,0,492,106,3071,863,3934,-0.00875909,-0.00457872,-0.999951,0
2614,0,0,0,0,344,87,3045,927,3972,-0.00982566,-0.00454643,-0.999941,0
2791,0,0,0,0,354,89,3234,942,4176,-0.0113403,-0.00595934,-0.999918,0
2465,0,0,0,0,370,92,2927,849,3776,-0.00749091,-0.00432418,-0.999963,0
2573,0,0,0,0,368,91,3032,937,3969,-0.00853347,-0.00505368,-0.999951,0
2719,0,0,0,0,450,102,3271,902,4173,-0.0104343,-0.00375384,-0.999939,0
2608,0,0,0,0,478,99,3185,813,3998,-0.00797837,-0.00429312,-0.999959,0
2605,0,0,0,0,358,85,3048,803,3851,-0.00789862,-0.00348747,-0.999963,0
2532,0,0,0,0,442,106,3080,843,3923,-0.00899481,-0.0048997,-0.999948,0
2531,0,0,0,0,350,87,2968,841,3809,-0.0104459,-0.00413795,-0.999937,0
2644,0,0,0,0,400,95,3139,811,3950,-0.0111327,-0.00548881,-0.999923,0
2904,0,0,0,0,445,87,3436,945,4381,-0.00815419,-0.00420231,-0.999958,0
2481,0,0,0,0,382,83,2946,814,3760,-0.00655026,-0.00475493,-0.999967,0
2735,0,0,0,0,372,80,3187,790,3977,-0.00688358,-0.00475044,-0.999965,0
2644,0,0,0,0,366,89,3099,949,4048,-0.00863692,-0.00457005,-0.999952,0
2529,0,0,0,0,355,89,2973,744,3717,-0.00928969,-0.00385874,-0.999949,0
2527,0,0,0,0,359,87,2973,887,3860,-0.00880872,-0.00488841,-0.999949,0
2554,0,0,0,0,376,98,3028,786,3814,-0.0112912,-0.00561424,-0.999921,0
2658,0,0,0,0,383,94,3135,804,3939,-0.00619164,-0.00469093,-0.99997,0
2745,0,0,0,0,464,104,3313,959,4272,-0.00949191,-0.00400916,-0.999947,0
