Downsample[ns],BuildFilTree[ns],SearchFil[ns],DeleteFil[ns],BuildTreeSub[ns],SearchSub[ns],DeleteSub[ns],PreProcTotal[ns],Plane[ns],Total[ns],nx,ny,nz,planeCount
4848,3387,79,410,0,757,212,9693,703,10396,-0.0503387,0.120573,-0.991428,0
4748,3302,38,386,0,780,213,9467,569,10036,-0.035745,0.032293,-0.998839,0
4708,3303,39,391,0,754,213,9408,1171,10579,-0.0127554,0.0109512,-0.999859,0
4902,3287,53,417,0,752,215,9626,1237,10863,-0.0359217,0.0114273,-0.999289,0
4768,3274,35,388,0,774,223,9462,1292,10754,-0.0126312,0.0191954,-0.999736,0
5370,3349,33,382,0,766,215,10115,1273,11388,-0.0212577,0.0118622,-0.999704,0
4630,3568,51,431,0,768,216,9664,1192,10856,-0.0308874,0.0112943,-0.999459,0
4702,3257,35,392,0,753,212,9351,1193,10544,-0.0309727,0.0116231,-0.999453,0
4814,3190,33,407,0,752,219,9415,1204,10619,-0.017762,0.0153935,-0.999724,0
4781,3327,34,384,0,754,212,9492,1201,10693,-0.0145401,0.00925357,-0.999852,0
4726,3310,35,383,0,768,212,9434,1315,10749,-0.0340012,0.00568017,-0.999406,0
4758,3557,41,521,0,826,219,9922,1291,11213,-0.0313214,0.0196196,-0.999317,0
5054,3289,33,379,0,769,213,9737,1218,10955,-0.0214807,0.00979961,-0.999721,0
5083,3466,34,387,0,753,212,9935,1234,11169,-0.0132026,0.0105332,-0.999858,0
4797,3293,34,407,0,1092,250,9873,1249,11122,-0.0225298,0.0183476,-0.999578,0
4634,3261,36,389,0,760,212,9292,1324,10616,-0.0131153,0.0191795,-0.99973,0
4720,2909,21,260,0,522,147,8579,814,9393,-0.0334244,0.00859624,-0.999404,0
4035,2675,28,314,0,663,178,7893,1044,8937,-0.0307643,0.00822648,-0.999493,0
5073,3426,35,388,0,756,213,9891,1201,11092,-0.0230255,0.0206834,-0.999521,0
4624,3182,32,455,0,748,213,9254,1216,10470,-0.0417418,0.00794298,-0.999097,0
4725,3279,33,389,0,752,212,9390,1242,10632,-0.0328104,0.0104707,-0.999407,0
4413,2858,30,347,0,672,187,8507,1063,9570,-0.0326163,0.00796411,-0.999436,0
4232,2960,35,412,0,671,193,8503,1079,9582,-0.0276016,0.0157121,-0.999495,0
4905,3546,36,387,0,751,211,9836,1241,11077,-0.0344123,0.0179725,-0.999246,0
4761,3251,32,376,0,773,213,9406,1233,10639,-0.0285559,0.0113428,-0.999528,0
5126,3729,33,387,0,891,236,10402,1252,11654,-0.0131799,0.0129166,-0.99983,0
4914,3397,33,418,0,751,213,9726,1240,10966,-0.0123702,0.0163213,-0.99979,0
4790,3343,33,383,0,944,312,9805,1520,11325,-0.0209777,0.00971085,-0.999733,0
2000,1383,14,162,0,322,90,3971,542,4513,-0.0337418,0.00680425,-0.999407,0
4960,3316,34,458,0,1036,218,10022,1130,11152,-0.0366319,0.0114057,-0.999264,0
4263,2981,31,343,0,674,189,8481,1054,9535,-0.0161722,0.0178162,-0.999711,0
4780,3412,29,344,0,730,224,9519,1175,10694,-0.0378059,0.0178676,-0.999125,0
4356,2878,31,361,0,672,191,8489,1062,9551,-0.0331798,0.0201431,-0.999247,0
4713,3320,34,380,0,751,210,9408,1229,10637,-0.0250349,0.0225016,-0.999433,0
4948,3400,36,390,0,749,213,9736,1205,10941,-0.0150627,0.0145484,-0.999781,0
4066,2284,22,264,0,521,146,7303,689,7992,-0.0138312,0.0154647,-0.999785,0
2530,1778,18,204,0,436,132,5098,653,5751,-0.0222091,0.0183821,-0.999584,0
4766,3207,34,378,0,785,215,9385,1191,10576,-0.0344204,0.00847976,-0.999371,0
4745,3131,29,341,0,691,189,9126,1151,10277,-0.0131456,0.010739,-0.999856,0
4727,3222,34,390,0,768,212,9353,1276,10629,-0.0336992,0.00889634,-0.999392,0
4832,3326,34,388,0,802,219,9601,1488,11089,-0.0175056,0.0166928,-0.999707,0
4733,3225,32,383,0,770,214,9357,1163,10520,-0.0263929,0.00928134,-0.999609,0
4882,3260,36,394,0,750,211,9533,1188,10721,-0.0345854,0.0107898,-0.999343,0
4731,3228,33,390,0,768,212,9362,1152,10514,-0.0366466,0.0109524,-0.999268,0
4693,3423,33,381,0,777,222,9529,1356,10885,-0.0119584,0.0118321,-0.999859,0
5534,3343,34,340,0,540,145,9936,848,10784,-0.0358228,0.00999832,-0.999308,0
3354,2320,24,264,0,543,167,6672,951,7623,-0.0151813,0.0163082,-0.999752,0
4942,3361,34,403,0,752,231,9723,1225,10948,-0.021033,0.00994862,-0.999729,0
4786,3398,34,382,0,753,244,9597,1309,10906,-0.035733,0.0105736,-0.999305,0
4793,3251,34,382,0,754,212,9426,1233,10659,-0.036,0.00940202,-0.999308,0
4856,3291,32,377,0,767,211,9534,1238,10772,-0.0440926,0.0179015,-0.998867,0
3268,1772,17,200,0,412,112,5781,665,6446,-0.0331051,0.0108726,-0.999393,0
3553,2442,27,301,0,708,203,7234,898,8132,-0.0140309,0.0133808,-0.999812,0
4721,3282,32,376,0,749,211,9371,1178,10549,-0.0336598,0.0150915,-0.999319,0
4629,3249,34,377,0,749,211,9249,1235,10484,-0.0394721,0.0257564,-0.998889,0
5009,3263,33,382,0,763,213,9663,1189,10852,-0.0291338,0.0217939,-0.999338,0
4768,2354,22,267,0,521,148,8080,838,8918,-0.0235599,0.0231534,-0.999454,0
2465,1695,18,199,0,398,119,4894,640,5534,-0.0123526,0.013366,-0.999834,0
4697,3247,31,378,0,779,214,9346,1189,10535,-0.0216663,0.010483,-0.99971,0
5012,3262,35,394,0,773,211,9687,1227,10914,-0.0116644,0.0120426,-0.99986,0
4724,3290,35,383,0,762,213,9407,1203,10610,-0.0227563,0.0147004,-0.999633,0
4817,3279,33,384,0,755,212,9480,1231,10711,-0.0348056,0.010677,-0.999337,0
4489,2993,31,344,0,693,190,8740,1105,9845,-0.0309783,0.00776896,-0.99949,0
4811,3275,33,397,0,778,215,9509,1213,10722,-0.0366144,0.00842273,-0.999294,0
4790,3271,33,383,0,819,223,9519,1176,10695,-0.0278937,0.0146279,-0.999504,0
4798,3463,34,381,0,792,214,9682,1297,10979,-0.0122827,0.0112511,-0.999861,0
5037,3317,40,422,0,756,217,9789,1223,11012,-0.0159781,0.0168676,-0.99973,0
4664,3348,41,545,0,853,219,9670,1181,10851,-0.0350571,0.0077529,-0.999355,0
5365,3390,34,387,0,753,234,10163,1106,11269,-0.0392062,0.00965447,-0.999184,0
3246,2254,24,264,0,519,146,6453,972,7425,-0.0320099,0.0121867,-0.999413,0
4922,3237,34,386,0,751,239,9569,1238,10807,-0.0364183,0.0105213,-0.999281,0
4787,3253,33,388,0,835,219,9515,1216,10731,-0.0358016,0.0101594,-0.999307,0
4778,3275,34,401,0,757,213,9458,1251,10709,-0.0345179,0.018792,-0.999227,0
4898,3376,33,388,0,755,213,9663,1352,11015,-0.0278509,0.0250739,-0.999298,0
4734,3292,35,388,0,768,214,9431,1245,10676,-0.0112564,0.0156638,-0.999814,0
4633,3340,35,455,0,847,220,9530,1250,10780,-0.0112887,0.0101824,-0.999885,0
4849,3242,36,411,0,754,213,9505,1255,10760,-0.0463927,0.0113145,-0.998859,0
4732,3204,34,381,0,751,211,9313,1167,10480,-0.0296132,0.0115262,-0.999495,0
4739,3319,33,386,0,831,237,9545,1229,10774,-0.0137166,0.0137724,-0.999811,0
4795,3692,35,391,0,874,175,9962,839,10801,-0.0329199,0.0103817,-0.999404,0
3424,2271,23,265,0,523,148,6654,868,7522,-0.0330152,0.00783004,-0.999424,0
5447,3360,33,393,0,759,214,10206,1149,11355,-0.0254758,0.0098078,-0.999627,0
4605,3318,33,383,0,762,213,9314,1184,10498,-0.0403384,0.0174753,-0.999033,0
4897,3268,33,424,0,779,225,9626,1233,10859,-0.0208491,0.0115015,-0.999717,0
4822,3813,43,494,0,823,218,10213,1290,11503,-0.0414819,0.0080935,-0.999107,0
4965,3291,34,384,0,750,211,9635,1265,10900,-0.0184732,0.0127377,-0.999748,0
3228,2246,23,260,0,556,146,6459,865,7324,-0.0179839,0.012014,-0.999766,0
4763,3320,34,394,0,776,214,9501,1137,10638,-0.0308097,0.00622735,-0.999506,0
4730,3238,34,379,0,797,243,9421,1274,10695,-0.0226553,0.0177862,-0.999585,0
4698,3333,33,409,0,762,216,9451,1221,10672,-0.0173074,0.0108216,-0.999792,0
5111,3390,35,386,0,750,212,9884,1175,11059,-0.0292357,0.0210552,-0.999351,0
4725,3356,34,385,0,769,215,9484,1188,10672,-0.0296974,0.0208728,-0.999341,0
4712,3251,29,376,0,774,192,9334,1079,10413,-0.0311599,0.00786807,-0.999483,0
4813,3326,43,391,0,805,258,9636,1263,10899,-0.0139214,0.0155739,-0.999782,0
4759,3373,32,411,0,781,225,9581,1114,10695,-0.0319795,0.012469,-0.999411,0
4841,3547,33,447,0,825,226,9919,1283,11202,-0.0119661,0.00967502,-0.999881,0
4783,3586,33,431,0,845,232,9910,1146,11056,-0.0222379,0.016259,-0.999621,0
4771,3609,33,410,0,812,248,9883,1185,11068,-0.0217735,0.0185328,-0.999591,0
4773,3515,37,416,0,814,227,9782,1117,10899,-0.0387567,0.0133047,-0.99916,0
4911,3518,33,406,0,802,245,9915,1175,11090,-0.0337903,0.0201557,-0.999226,0
4972,3619,33,410,0,795,223,10052,1119,11171,-0.0475808,0.0246559,-0.998563,0
4841,3634,37,408,0,1109,232,10261,1148,11409,-0.0320844,0.00915507,-0.999443,0
3328,2514,26,284,0,558,177,6887,815,7702,-0.013561,0.020206,-0.999704,0
4881,3843,35,419,0,887,235,10300,1089,11389,-0.023927,0.011608,-0.999646,0
4848,3604,38,476,0,806,232,10004,1190,11194,-0.0253731,0.0254756,-0.999353,0
5091,3899,35,422,0,853,247,10547,1221,11768,-0.0148924,0.0254507,-0.999565,0
4749,3451,32,413,0,812,226,9683,1157,10840,-0.0318698,0.00546261,-0.999477,0
4959,3819,34,480,0,815,232,10339,1309,11648,-0.0462252,0.00599128,-0.998913,0
4153,2390,23,277,0,548,143,7534,647,8181,-0.036031,0.00733591,-0.999324,0
1995,1541,16,179,0,343,98,4172,513,4685,-0.0369465,0.0116209,-0.99925,0
5223,3455,33,409,0,799,226,10145,1192,11337,-0.0435318,0.0235982,-0.998773,0
4718,3439,34,409,0,796,224,9620,1210,10830,-0.0351763,0.00966124,-0.999334,0
5773,3427,70,404,0,795,224,10693,1325,12018,-0.0521107,0.0237701,-0.998358,0
4705,3547,34,411,0,796,265,9758,1191,10949,-0.0175475,0.0130393,-0.999761,0
4669,3464,34,401,0,794,222,9584,1216,10800,-0.0285163,0.0072185,-0.999567,0
4952,3528,38,421,0,867,228,10034,1168,11202,-0.03471,0.00569421,-0.999381,0
4856,3530,34,397,0,781,243,9841,1210,11051,-0.0348561,0.00537247,-0.999378,0
4687,3430,33,400,0,784,221,9555,1149,10704,-0.0325877,0.00609321,-0.99945,0
4701,3371,33,395,0,787,221,9508,1264,10772,-0.0110487,0.00845397,-0.999903,0
3179,1808,17,223,0,418,117,5762,609,6371,-0.0222593,0.00525488,-0.999738,0
2359,1719,16,197,0,395,111,4797,589,5386,-0.0344176,0.0220314,-0.999164,0
4769,3355,33,392,0,773,216,9538,1191,10729,-0.0133721,0.016014,-0.999782,0
4663,3649,35,385,0,775,213,9720,1139,10859,-0.0343257,0.00937062,-0.999367,0
4671,3163,34,373,0,818,247,9306,1086,10392,-0.0372205,0.0133847,-0.999217,0
4823,3126,36,373,0,730,207,9295,1115,10410,-0.0399356,0.0147627,-0.999093,0
5057,3129,33,368,0,716,206,9509,1311,10820,-0.0246909,0.0167988,-0.999554,0
4971,3143,37,454,0,745,255,9605,1157,10762,-0.0154941,0.0211315,-0.999657,0
4939,2983,34,382,0,717,205,9260,1285,10545,-0.0146367,0.0177603,-0.999735,0
4779,2930,34,341,0,671,204,8959,1424,10383,-0.0143689,0.0347999,-0.999291,0
4993,2742,34,331,0,664,183,8947,1260,10207,-0.0133946,0.0382066,-0.99918,0
5340,2747,35,375,0,671,203,9371,1277,10648,-0.0287871,0.0539244,-0.99813,0
4949,2723,34,324,0,662,179,8871,304,9175,-0.0148234,0.0515817,-0.998559,0
5080,2655,35,319,0,615,225,8929,1264,10193,-0.0393054,0.0640677,-0.997171,0
5329,2999,35,319,0,635,172,9489,424,9913,0.0576298,0.113104,-0.991911,0
5217,2767,35,318,0,673,177,9187,782,9969,-0.0274691,0.0723325,-0.997002,0
5397,3116,30,303,0,470,124,9440,324,9764,-0.05127,0.107286,-0.992906,0
3583,1749,23,202,0,400,141,6098,403,6501,-0.0513222,0.100489,-0.993614,0
6047,2541,35,292,0,551,155,9621,456,10077,-0.0552483,0.114716,-0.991861,0
5320,2336,34,267,0,516,145,8618,471,9089,-0.046384,0.0949746,-0.994398,0
5367,2045,32,247,0,475,133,8299,491,8790,-0.0468382,0.107939,-0.993054,0
5310,1954,31,231,0,434,122,8082,548,8630,-0.0253233,0.057974,-0.997997,0
5222,1720,30,207,0,430,114,7723,435,8158,-0.0398256,0.102015,-0.993986,0
5629,1560,30,233,0,363,137,7952,552,8504,-0.0146308,0.0689313,-0.997514,0
5281,1411,30,201,0,337,98,7358,611,7969,0.00355885,0.0795861,-0.996822,0
5199,1333,30,170,0,309,89,7130,637,7767,0.0231034,0.0817142,-0.996388,0
5187,1263,31,215,0,311,92,7099,624,7723,0.0158593,0.103739,-0.994478,0
5310,1239,32,160,0,283,81,7105,663,7768,-0.00395776,0.0923837,-0.995716,0
5132,1405,38,196,0,381,110,7262,761,8023,-0.0256639,0.112914,-0.993273,0
4904,930,29,128,0,222,65,6278,653,6931,-0.0175149,0.0680225,-0.99753,0
4734,986,60,160,0,262,65,6267,555,6822,-0.00976807,0.0430835,-0.999024,0
4681,633,27,95,0,182,49,5667,539,6206,0.0315292,-0.0492564,-0.998288,0
4603,570,29,90,0,138,43,5473,556,6029,0.00968858,0.0145648,-0.999847,0
4388,533,28,80,0,117,37,5183,554,5737,0.0312287,-0.0480095,-0.998359,0
4344,545,29,78,0,114,35,5145,501,5646,0.0145642,0.0266246,-0.999539,0
4340,404,27,68,0,97,32,4968,546,5514,0.0395948,-0.0187309,-0.99904,0
4465,384,27,77,0,120,38,5111,456,5567,0.0617326,0.0645192,-0.996005,0
4513,395,29,72,0,110,45,5164,539,5703,0.0586723,0.0990306,-0.993353,0
4356,286,26,56,0,71,25,4820,454,5274,0.0596271,0.065398,-0.996076,0
4496,249,25,52,0,62,23,4907,435,5342,0.0391161,-0.0718268,-0.99665,0
3869,227,24,47,0,55,21,4243,455,4698,0.0673253,-0.163181,-0.984296,0
4420,237,29,52,0,57,21,4816,521,5337,0.0813203,-0.267124,-0.960225,0
4518,245,28,57,0,58,22,4928,425,5353,0.0649781,-0.193418,-0.978962,0
4292,319,28,61,0,103,38,4841,530,5371,0.0772146,-0.228941,-0.970373,0
3787,301,24,56,0,71,25,4264,487,4751,0.0806153,-0.234786,-0.968699,0
3804,311,24,59,0,76,30,4304,455,4759,0.07756,-0.23286,-0.969412,0
3806,348,26,62,0,76,27,4345,456,4801,0.077764,-0.257039,-0.963267,0
3615,316,25,57,0,92,41,4146,513,4659,0.0662369,-0.221891,-0.972819,0
4282,392,29,71,0,87,31,4892,577,5469,0.0713028,-0.2177,-0.973408,0
4107,406,28,74,0,98,34,4747,622,5369,0.0676823,-0.169737,-0.983163,0
3730,421,27,72,0,101,35,4386,642,5028,0.0619078,-0.134924,-0.98892,0
3683,497,40,103,0,115,39,4477,609,5086,0.0531662,-0.105286,-0.99302,0
3636,560,25,88,0,140,44,4493,592,5085,0.0643657,-0.154408,-0.985908,0
3671,706,26,100,0,162,51,4716,569,5285,0.0788424,-0.0261144,-0.996545,0
3896,747,28,146,0,207,62,5086,720,5806,0.0397706,-0.0601399,-0.997398,0
3770,835,26,120,0,204,61,5016,840,5856,0.0755397,-0.133682,-0.988141,0
3768,951,27,129,0,233,70,5178,1021,6199,0.0798826,-0.115953,-0.990037,0
3791,1026,27,142,0,257,76,5319,1060,6379,0.0286438,-0.0342341,-0.999003,0
4464,1215,29,157,0,280,83,6228,1068,7296,0.0167585,-0.0323283,-0.999337,0
3988,1308,28,171,0,325,90,5910,1203,7113,0.0114744,-0.0332464,-0.999381,0
4114,1418,39,185,0,344,106,6206,1379,7585,-0.0064393,-0.0194545,-0.99979,0
4045,1675,27,203,0,384,142,6476,1300,7776,-0.0396885,0.081604,-0.995874,0
4280,1760,36,231,0,472,128,6907,1085,7992,-0.0310211,0.0751677,-0.996689,0
4452,1882,28,233,0,464,128,7187,1111,8298,-0.0537766,0.0925947,-0.994251,0
4140,1961,27,242,0,485,136,6991,1109,8100,-0.0296538,0.0805374,-0.99631,0
4865,2393,28,257,0,564,161,8268,1392,9660,-0.0212318,0.0875746,-0.995932,0
4883,2178,27,267,0,584,154,8093,1222,9315,-0.0145818,0.0949933,-0.995371,0
4935,2259,27,280,0,571,170,8242,1075,9317,-0.0185151,0.0807824,-0.99656,0
5123,2784,32,355,0,657,187,9138,1316,10454,-0.0228981,0.0893248,-0.995739,0
4664,2602,28,316,0,692,179,8481,1124,9605,-0.0293718,0.0975904,-0.994793,0
5535,3238,32,382,0,789,235,10211,1080,11291,-0.044551,0.115163,-0.992347,0
4783,3308,29,389,0,865,218,9592,886,10478,-0.0740167,0.144346,-0.986755,0
5010,3727,29,416,0,892,233,10307,1427,11734,-0.09256,0.239452,-0.966486,0
4553,3528,26,409,0,861,228,9605,1208,10813,-0.372042,-0.351871,-0.858936,0
5202,4658,28,506,0,1048,284,11726,808,12534,0.0378493,0.0631843,-0.997284,0
5581,5285,29,621,0,1196,338,13050,1254,14304,0.0291912,0.0855857,-0.995903,0
4135,3987,20,447,0,944,249,9782,663,10445,0.00789047,0.0605984,-0.998131,0
6190,6294,31,695,0,1640,431,15281,1306,16587,0.0174974,0.0999793,-0.994836,0
6444,5655,22,541,0,1063,277,14002,759,14761,0.163394,-0.281709,-0.945486,0
3293,3372,15,395,0,855,217,8147,291,8438,0.17633,0.137155,-0.974729,0
5000,5374,26,670,0,1332,367,12769,2393,15162,0.100414,0.20439,-0.973726,0
5102,5847,29,976,0,1341,283,13578,1785,15363,0.0866907,0.20864,-0.974143,0
3021,3450,14,381,0,826,235,7927,1452,9379,-0.0357931,0.207511,-0.977577,0
7376,7254,28,816,0,1731,511,17716,3103,20819,-0.0469863,0.203071,-0.978036,0
3297,3711,14,401,0,882,230,8535,1661,10196,-0.0643727,0.172344,-0.982931,0
3048,3644,19,426,0,759,206,8102,1579,9681,-0.0559015,0.147728,-0.987447,0
6021,6924,31,725,0,1464,388,15553,3110,18663,-0.0581191,0.134803,-0.989166,0
4614,4101,19,463,0,1014,257,10468,1960,12428,-0.0775481,0.136383,-0.987616,0
5954,6133,29,652,0,1411,356,14535,2746,17281,-0.0360518,0.138393,-0.989721,0
4103,3733,23,468,0,892,251,9470,2236,11706,-0.0502178,0.114364,-0.992169,0
6080,4818,25,552,0,1149,299,12923,2503,15426,-0.0461638,0.0959119,-0.994319,0
3720,3230,18,355,0,786,237,8346,1576,9922,-0.0416541,0.0945185,-0.994651,0
5963,4934,29,592,0,1199,360,13077,2608,15685,-0.0535531,0.0857829,-0.994873,0
5572,4356,27,387,0,734,192,11268,1429,12697,-0.0604992,0.0920697,-0.993913,0
5752,4166,29,501,0,1068,295,11811,2166,13977,-0.071459,0.116474,-0.99062,0
6237,3940,30,443,0,978,172,11800,1408,13208,-0.0759188,0.112511,-0.990746,0
3805,2533,21,276,0,616,161,7412,1410,8822,-0.0841004,0.0693737,-0.99404,0
4082,2445,20,266,0,559,148,7520,1287,8807,-0.171895,0.101626,-0.979859,0
5302,3195,35,350,0,731,196,9809,1672,11481,-0.184837,0.122121,-0.975152,0
5029,2794,30,325,0,658,176,9012,1354,10366,-0.140796,0.131136,-0.981315,0
3375,1715,17,153,0,333,86,5679,728,6407,-0.140668,0.11341,-0.98354,0
2469,1144,14,136,0,282,75,4120,797,4917,-0.159429,0.113964,-0.980609,0
4510,1985,28,265,0,527,140,7455,1299,8754,-0.150222,0.107986,-0.982737,0
4197,1830,27,226,0,502,129,6911,1202,8113,-0.145276,0.128619,-0.980995,0
4293,1712,27,217,0,431,119,6799,1165,7964,-0.134469,0.147844,-0.979827,0
4271,1571,27,237,0,404,164,6674,1183,7857,-0.119001,0.124419,-0.985068,0
3968,1693,27,210,0,392,114,6404,1237,7641,-0.124837,0.123359,-0.984479,0
4116,1471,25,189,0,464,110,6375,1227,7602,-0.166706,0.197815,-0.96596,0
3825,1446,27,199,0,356,105,5958,1158,7116,-0.130111,0.148878,-0.980258,0
3830,1381,24,182,0,359,99,5875,1223,7098,-0.113165,0.143641,-0.983138,0
3848,1397,24,192,0,354,102,5917,1180,7097,-0.0751603,0.121249,-0.989773,0
3740,1358,24,178,0,330,96,5726,1092,6818,-0.0844758,0.132309,-0.987602,0
3767,1318,38,174,0,381,102,5780,1043,6823,-0.119211,0.216636,-0.968947,0
3648,1300,31,185,0,374,99,5637,1022,6659,-0.112485,0.194737,-0.974384,0
3667,1282,26,169,0,315,94,5553,997,6550,-0.101298,0.194175,-0.975723,0
3632,1325,26,171,0,310,91,5555,917,6472,-0.0944972,0.185531,-0.978084,0
3648,1327,32,168,0,311,91,5577,982,6559,-0.0881287,0.173412,-0.980898,0
3673,1400,26,175,0,318,93,5685,923,6608,-0.0829177,0.181383,-0.97991,0
3793,1307,25,204,0,316,94,5739,949,6688,-0.0816717,0.152232,-0.984964,0
3625,1393,26,173,0,317,93,5627,874,6501,-0.0735677,0.167816,-0.98307,0
3814,1406,25,173,0,317,93,5828,928,6756,-0.0817899,0.191078,-0.978161,0
3732,1362,30,179,0,320,97,5720,863,6583,-0.0673336,0.14176,-0.987608,0
3746,1361,26,173,0,316,93,5715,840,6555,-0.085891,0.189645,-0.978089,0
3782,1339,26,211,0,320,94,5772,804,6576,-0.0801983,0.182067,-0.98001,0
3694,1453,26,178,0,327,96,5774,738,6512,-0.0800753,0.184744,-0.979519,0
3770,1519,28,227,0,340,102,5986,759,6745,-0.0928383,0.211776,-0.972899,0
3759,1668,27,201,0,370,108,6133,644,6777,-0.107185,0.249484,-0.962429,0
4014,1777,27,213,0,400,114,6545,522,7067,-0.115245,0.280249,-0.952984,0
3884,1913,27,229,0,439,124,6616,443,7059,-0.117287,0.215075,-0.969529,0
3906,1973,26,238,0,450,130,6723,359,7082,-0.0417344,0.203231,-0.978241,0
3937,2029,27,241,0,474,135,6843,526,7369,-0.0571761,0.18147,-0.981733,0
3965,2089,29,246,0,472,136,6937,454,7391,-0.0562253,0.151464,-0.986862,0
3921,2096,27,247,0,476,136,6903,386,7289,-0.039753,0.091455,-0.995015,0
3846,2131,27,245,0,494,172,6915,414,7329,-0.0472695,0.108295,-0.992995,0
4041,2091,27,247,0,465,133,7004,421,7425,-0.0427232,0.104271,-0.993631,0
4910,2094,34,245,0,477,147,7907,369,8276,-0.0426979,0.109134,-0.99311,0
3951,2039,26,244,0,470,133,6863,369,7232,-0.0576179,0.128362,-0.990052,0
3987,2091,27,250,0,473,136,6964,320,7284,-0.0809464,0.211646,-0.973989,0
3962,2200,34,250,0,471,135,7052,363,7415,-0.0664097,0.137901,-0.988217,0
3966,2101,29,273,0,477,138,6984,691,7675,-0.0583509,0.141689,-0.98819,0
4074,2247,28,272,0,509,141,7271,342,7613,-0.0636865,0.167959,-0.983734,0
4057,2138,28,252,0,520,142,7137,304,7441,-0.0792529,0.401239,-0.912539,0
4026,2271,28,309,0,483,142,7259,517,7776,-0.0627391,0.155109,-0.985903,0
4162,2142,28,295,0,483,141,7251,352,7603,-0.109427,0.213378,-0.970822,0
4116,2179,29,274,0,491,144,7233,706,7939,-0.0629779,0.142409,-0.987802,0
4111,2298,28,259,0,488,140,7324,667,7991,-0.0598979,0.13967,-0.988385,0
3946,2158,27,259,0,490,141,7021,702,7723,-0.058043,0.140105,-0.988434,0
4012,2235,28,254,0,506,141,7176,665,7841,-0.0576361,0.141673,-0.988234,0
4114,2212,29,258,0,523,147,7283,949,8232,-0.0564965,0.134855,-0.989254,0
3926,2286,29,264,0,535,147,7187,697,7884,-0.0603334,0.14275,-0.987918,0
4014,2230,26,260,0,488,178,7196,697,7893,-0.0577793,0.137337,-0.988838,0
4166,2287,28,259,0,492,165,7397,730,8127,-0.0533635,0.137528,-0.989059,0
4388,2199,28,299,0,528,146,7588,358,7946,-0.0872164,0.21955,-0.971695,0
4105,2220,28,263,0,496,141,7253,432,7685,-0.0986137,0.248843,-0.96351,0
4122,2575,37,303,0,498,156,7691,403,8094,-0.103927,0.224591,-0.968896,0
4152,2191,27,256,0,488,141,7255,727,7982,-0.0564018,0.138593,-0.988742,0
4531,2258,28,290,0,525,147,7779,306,8085,-0.0982173,0.261646,-0.960154,0
4028,2162,26,258,0,493,140,7107,418,7525,-0.0915816,0.139594,-0.985965,0
4076,2147,27,255,0,501,142,7148,330,7478,-0.0652913,0.122915,-0.990267,0
4260,2345,28,281,0,543,149,7606,319,7925,-0.0241506,0.017983,-0.999547,0
4046,2262,28,301,0,834,148,7619,410,8029,-0.0521067,0.124933,-0.990796,0
4040,2250,27,262,0,495,142,7216,678,7894,-0.0493018,0.126459,-0.990746,0
4091,2178,34,259,0,528,147,7237,724,7961,-0.0521934,0.131111,-0.989993,0
4126,2224,28,256,0,540,147,7321,683,8004,-0.0614077,0.13934,-0.988339,0
3986,2210,28,265,0,527,170,7186,696,7882,-0.0562962,0.131233,-0.989752,0
4054,2250,27,258,0,489,141,7219,652,7871,-0.0550666,0.136999,-0.989039,0
4493,2207,29,260,0,492,141,7622,628,8250,-0.0526104,0.135748,-0.989346,0
3981,2185,30,257,0,486,141,7080,673,7753,-0.0537738,0.135335,-0.98934,0
3955,2131,28,254,0,506,141,7015,659,7674,-0.0535358,0.136186,-0.989236,0
3968,2525,29,259,0,516,142,7439,321,7760,-0.171831,0.522432,-0.835188,0
4520,2192,29,259,0,773,243,8016,448,8464,-0.0893865,0.149909,-0.984651,0
4113,2312,28,257,0,481,138,7329,701,8030,-0.0607687,0.142499,-0.987928,0
4104,2246,32,259,0,488,144,7273,659,7932,-0.061563,0.140436,-0.988174,0
4190,2252,27,257,0,484,139,7349,301,7650,-0.137096,0.411498,-0.901041,1
4138,2230,32,276,0,510,143,7329,398,7727,-0.0840375,0.150987,-0.984957,1
4069,2271,29,261,0,495,165,7290,319,7609,-0.0493638,0.210245,-0.976402,1
4178,2261,28,261,0,533,145,7406,427,7833,-0.0599354,0.135496,-0.988964,1
4104,2234,28,260,0,491,141,7258,692,7950,-0.060355,0.142955,-0.987887,1
4480,2263,27,259,0,490,175,7694,884,8578,-0.055081,0.134938,-0.989322,1
3972,2163,26,257,0,492,141,7051,689,7740,-0.0557463,0.137174,-0.988977,1
4166,2280,31,260,0,490,174,7401,705,8106,-0.0570028,0.13748,-0.988863,1
4881,2166,29,261,0,505,141,7983,657,8640,-0.0543012,0.134828,-0.98938,1
4130,2166,28,258,0,494,142,7218,651,7869,-0.0627326,0.144408,-0.987528,1
4200,2254,28,260,0,494,171,7407,676,8083,-0.0577424,0.140298,-0.988424,1
4060,2253,29,257,0,487,139,7225,-1000,-1000,-1,-1,-1,1
4735,2494,28,259,0,490,156,8162,428,8590,-0.0647421,0.119324,-0.990742,1
4008,2171,28,281,0,731,234,7453,921,8374,-0.0552576,0.138566,-0.988811,1
4198,2152,28,258,0,616,147,7399,305,7704,-0.142969,0.542841,-0.827577,1
3962,2263,28,291,0,493,143,7180,430,7610,-0.0580723,0.155052,-0.986198,1
4109,2172,27,257,0,489,141,7195,713,7908,-0.061266,0.145246,-0.987497,1
3968,2159,28,254,0,508,142,7059,625,7684,-0.0501729,0.144962,-0.988164,1
3981,2179,29,278,0,512,144,7123,302,7425,-0.199927,0.462758,-0.863646,1
3985,2210,27,267,0,498,141,7128,405,7533,-0.0538655,0.149392,-0.98731,1
4097,2231,31,261,0,620,142,7382,659,8041,-0.0597767,0.144772,-0.987658,1
1744,923,13,109,0,209,61,3059,310,3369,-0.0588601,0.139892,-0.988416,1
4074,2278,28,259,0,484,140,7263,-1000,-1000,-1,-1,-1,1
4051,2147,29,256,0,487,167,7137,426,7563,-0.0610127,0.157531,-0.985627,1
4069,2198,30,319,0,524,145,7285,303,7588,-0.062637,0.147074,-0.98714,1
4069,2123,30,258,0,486,141,7107,329,7436,0.111231,-0.397356,-0.910898,1
4051,2194,27,274,0,514,147,7207,485,7692,-0.0558611,0.135719,-0.989171,1
3912,2201,28,257,0,484,140,7022,298,7320,-0.0118318,-0.0183861,-0.999761,1
3985,2116,27,256,0,514,158,7056,408,7464,-0.0472019,0.131142,-0.990239,1
4344,2115,27,254,0,481,139,7360,316,7676,-0.126785,0.149142,-0.980654,1
3971,2127,29,271,0,510,143,7051,418,7469,-0.0147954,0.160657,-0.9869,1
4295,2169,28,259,0,487,177,7415,610,8025,-0.0652558,0.138086,-0.988268,1
4530,2460,28,261,0,600,173,8052,751,8803,-0.0577107,0.146444,-0.987534,1
3911,2092,28,250,0,491,139,6911,342,7253,-0.0825738,0.227771,-0.970207,1
4822,2217,30,259,0,590,142,8060,379,8439,-0.0679867,0.19672,-0.9781,1
4035,2143,29,252,0,523,142,7124,419,7543,-0.0794187,0.221283,-0.97197,1
3939,2176,28,253,0,513,141,7050,350,7400,-0.0505187,0.0845195,-0.99514,1
4062,2116,29,254,0,478,137,7076,673,7749,-0.049458,0.129222,-0.990382,1
4315,2079,28,271,0,477,139,7309,323,7632,-0.083582,0.232363,-0.969031,1
4149,2415,30,273,0,526,143,7536,397,7933,-0.0720496,0.113506,-0.990921,1
4483,2404,30,327,0,539,157,7940,393,8333,-0.0424799,0.159314,-0.986314,1
5088,2519,32,286,0,568,157,8650,473,9123,-0.0736696,0.150785,-0.985818,1
4986,2461,31,252,0,479,139,8348,674,9022,-0.0564408,0.137467,-0.988897,1
4036,2125,28,252,0,473,171,7085,312,7397,-0.0630238,0.157281,-0.985541,1
2795,1503,23,184,0,357,98,4960,209,5169,0.0325214,-0.166191,-0.985557,1
4174,2158,26,274,0,478,138,7248,471,7719,-0.054437,0.142702,-0.988267,1
4940,2222,30,313,0,490,143,8138,700,8838,-0.0517463,0.137134,-0.9892,1
3895,2090,27,247,0,491,138,6888,687,7575,-0.0551944,0.137699,-0.988935,1
4455,2089,27,251,0,506,141,7469,349,7818,-0.0571077,0.14024,-0.988469,1
3940,2108,27,277,0,479,138,6969,306,7275,-0.0847116,0.210488,-0.973919,1
4426,2295,29,251,0,513,141,7655,328,7983,0.0783762,-0.175238,-0.981401,1
3899,2088,27,275,0,481,140,6910,634,7544,-0.0507076,0.134254,-0.989649,1
4410,2442,31,287,0,480,137,7787,318,8105,0.0208887,-0.181162,-0.983231,1
3956,2133,28,253,0,480,138,6988,443,7431,-0.0693204,0.186488,-0.980009,1
4524,2428,26,257,0,484,139,7858,363,8221,-0.0883175,0.184468,-0.978863,1
4451,2416,31,303,0,582,216,7999,712,8711,-0.0516948,0.134658,-0.989543,1
6703,2699,30,286,0,485,141,10344,355,10699,-0.0765322,0.192628,-0.978283,1
4537,2409,33,286,0,539,160,7964,361,8325,-0.102406,0.223344,-0.969345,1
4557,2389,32,337,0,541,155,8011,350,8361,0.107987,-0.244871,-0.963523,1
4611,2391,30,285,0,538,154,8009,585,8594,-0.0439998,0.110702,-0.992879,1
4690,2475,33,285,0,555,155,8193,731,8924,-0.0551154,0.130181,-0.989957,1
4491,2353,31,298,0,543,208,7924,712,8636,-0.0615724,0.134554,-0.988992,1
4493,2483,38,291,0,540,155,8000,342,8342,-0.0964988,0.257758,-0.961379,1
4433,2403,30,283,0,538,155,7842,436,8278,-0.0887066,0.138944,-0.986319,1
4458,2510,30,284,0,562,156,8000,344,8344,-0.021822,-0.0849538,-0.996146,1
3941,2194,27,279,0,479,140,7060,436,7496,-0.0518466,0.144903,-0.988086,1
4370,2233,27,281,0,487,143,7541,339,7880,0.0888792,-0.416456,-0.904801,1
4004,2211,27,253,0,475,135,7105,453,7558,-0.0563421,0.130708,-0.989819,1
4418,2217,28,250,0,473,137,7523,313,7836,-0.0215595,0.0112918,-0.999704,1
4048,2214,28,252,0,521,140,7203,457,7660,-0.0546557,0.131526,-0.989805,1
4782,2946,39,329,0,571,161,8828,435,9263,-0.132617,0.379246,-0.915743,1
4692,2447,31,332,0,586,182,8270,525,8795,-0.0832924,0.150204,-0.98514,1
4533,2365,32,282,0,565,159,7936,835,8771,-0.057086,0.149664,-0.987088,1
4563,2401,31,291,0,551,159,7996,853,8849,-0.0634927,0.167202,-0.983876,1
4667,2547,32,292,0,617,167,8322,645,8967,-0.0716227,0.179597,-0.981129,1
4634,2635,32,311,0,591,171,8374,669,9043,-0.0795786,0.191237,-0.978313,1
4679,2812,33,320,0,635,188,8667,734,9401,-0.048516,0.216626,-0.975049,1
4821,3111,40,342,0,624,179,9117,372,9489,0.148405,-0.00793973,-0.988895,1
4631,2762,38,330,0,721,196,8678,566,9244,-0.0525347,0.17289,-0.983539,1
5303,2893,33,345,0,658,188,9420,722,10142,-0.0709806,0.184747,-0.980219,1
4720,3013,35,364,0,700,195,9027,745,9772,-0.063486,0.206065,-0.976477,1
4929,3324,36,380,0,881,217,9767,772,10539,-0.0757107,0.199995,-0.976867,1
4989,4005,36,416,0,825,275,10546,900,11446,-0.0707613,0.195243,-0.978199,1
5141,3824,36,441,0,864,278,10584,874,11458,-0.0718304,0.190435,-0.979068,1
5196,3912,30,408,0,846,238,10630,853,11483,-0.0549139,0.197699,-0.978724,1
4567,3709,33,423,0,867,246,9845,817,10662,-0.0416924,0.18028,-0.982731,1
5211,4245,35,485,0,1049,276,11301,821,12122,-0.0202987,0.191506,-0.981282,1
5274,4176,38,491,0,1010,275,11264,821,12085,-0.0302063,0.168751,-0.985196,1
5406,4307,36,495,0,1041,284,11569,848,12417,-0.0235858,0.177454,-0.983847,1
5340,4877,26,350,0,647,184,11424,238,11662,-0.0396806,0.174373,-0.98388,1
3223,2661,23,302,0,612,168,6989,497,7486,-0.0474027,0.140716,-0.988915,1
5414,4426,37,521,0,981,266,11645,702,12347,-0.0375725,0.150836,-0.987845,1
5261,4287,32,444,0,934,259,11217,687,11904,-0.0124074,0.166314,-0.985995,1
5290,4727,39,509,0,991,296,11852,358,12210,-0.036507,0.13173,-0.990613,1
5548,4620,37,514,0,994,281,11994,808,12802,-0.032756,0.17592,-0.983859,1
5559,4641,39,505,0,985,277,12006,460,12466,-0.0542689,0.18086,-0.982011,1
3453,2162,18,233,0,445,153,6464,351,6815,-0.0349803,0.181162,-0.982831,1
5491,3212,38,356,0,802,306,10205,749,10954,-0.00235542,0.17619,-0.984354,1
4502,2619,29,321,0,601,173,8245,337,8582,0.022515,0.0672122,-0.997485,1
4480,2426,38,286,0,602,158,7990,333,8323,-0.000125875,0.113622,-0.993524,1
4322,2226,28,255,0,482,139,7452,882,8334,-0.0157386,0.144035,-0.989447,1
3013,1360,19,158,0,301,87,4938,718,5656,-0.019677,0.159667,-0.986975,1
3054,1263,20,174,0,289,86,4886,862,5748,-0.0275558,0.191617,-0.981083,1
4452,1834,28,252,0,413,123,7102,1743,8845,-0.0280479,0.151643,-0.988037,1
4542,1824,30,257,0,409,118,7180,335,7515,0.00729532,0.169666,-0.985475,1
4662,1625,28,198,0,373,106,6992,442,7434,-0.0251874,0.12554,-0.991769,1
5568,1498,49,191,0,348,99,7753,458,8211,-0.0413717,0.164369,-0.985531,1
4407,1395,27,177,0,327,104,6437,436,6873,-0.0256267,0.124902,-0.991838,1
5328,1446,32,192,0,342,99,7439,563,8002,-0.0304828,0.173386,-0.984382,1
3286,854,20,115,0,179,46,4500,310,4810,-0.0250001,0.160433,-0.98673,1
2518,600,14,82,0,150,43,3407,300,3707,0.0259792,0.166592,-0.985684,1
5097,1202,30,230,0,286,84,6929,461,7390,0.401798,0.172751,-0.899286,1
4861,1038,30,146,0,273,78,6426,1379,7805,0.430214,0.262865,-0.863608,1
5105,1029,31,146,0,290,96,6697,-1000,-1000,-1,-1,-1,1
4592,842,27,119,0,209,61,5850,697,6547,-0.0150466,0.209203,-0.977756,1
4967,809,28,114,0,193,55,6166,691,6857,-0.0373563,0.281018,-0.958975,1
4827,696,25,106,0,181,53,5888,695,6583,0.0264732,0.200166,-0.979405,1
5315,784,30,117,0,228,61,6535,807,7342,0.036113,0.216112,-0.975701,1
6504,697,30,189,0,214,59,7693,876,8569,0.0443488,0.217113,-0.975139,1
5504,637,30,101,0,217,57,6546,948,7494,0.0634388,0.219471,-0.973554,1
5255,568,29,89,0,198,49,6188,878,7066,0.0604866,0.211896,-0.975418,1
5184,551,27,82,0,133,39,6016,775,6791,0.0613554,0.197779,-0.978325,1
5493,517,27,81,0,125,37,6280,760,7040,0.0618635,0.222316,-0.97301,1
4686,453,27,74,0,115,35,5390,825,6215,0.0502421,0.195433,-0.979429,1
4204,365,26,66,0,106,32,4799,932,5731,0.0424031,0.214489,-0.975806,1
4372,379,27,68,0,103,32,4981,1046,6027,0.0630278,0.228387,-0.971528,1
4056,437,27,71,0,120,37,4748,961,5709,0.0398294,0.218673,-0.974985,1
3531,339,21,63,0,101,30,4085,662,4747,0.0527137,0.239313,-0.96951,1
4550,692,30,105,0,167,51,5595,1210,6805,0.0474437,0.2337,-0.971151,1
4038,703,27,103,0,163,51,5085,823,5908,0.0654189,0.221526,-0.972958,1
4083,751,25,118,0,184,57,5218,813,6031,0.0892366,0.22823,-0.969509,1
4616,923,33,141,0,237,71,6021,1004,7025,0.081577,0.20431,-0.975501,1
4554,1209,51,280,0,456,89,6639,1052,7691,0.0354266,0.207945,-0.977499,1
4641,1558,34,184,0,327,95,6839,1224,8063,0.0716884,0.208899,-0.975307,1
4639,1662,32,209,0,394,114,7050,1262,8312,0.0955872,0.225528,-0.969536,1
4709,1958,32,244,0,528,137,7608,1253,8861,0.0191394,0.186515,-0.982266,1
5082,2418,31,294,0,583,192,8600,1380,9980,0.0672202,0.193972,-0.978701,1
5503,2285,19,220,0,511,126,8664,983,9647,0.0418013,0.175666,-0.983562,1
2526,1753,15,220,0,418,115,5047,777,5824,0.00941041,0.140352,-0.990057,1
5612,4170,28,456,0,1015,263,11544,1219,12763,-0.000233574,0.178287,-0.983979,1
5616,5111,30,584,0,1189,349,12879,936,13815,7.09134e-05,0.217114,-0.976146,1
4077,4134,22,438,0,938,247,9856,616,10472,0.194651,0.156421,-0.96832,1
4298,4258,21,474,0,997,267,10315,1459,11774,-0.00449685,0.130381,-0.991454,1
5710,6377,38,708,0,1389,371,14593,972,15565,-0.00540183,0.143228,-0.989675,1
4048,4340,22,520,0,1047,276,10253,609,10862,-0.019602,0.124377,-0.992042,1
5803,5968,29,646,0,1319,351,14116,512,14628,0.0104879,0.129347,-0.991544,1
3836,4271,17,485,0,1007,264,9880,580,10460,-0.0180351,0.167238,-0.985752,1
6517,7025,28,831,0,1654,457,16512,938,17450,-0.0338873,0.24588,-0.968708,1
4269,4561,19,561,0,1054,300,10764,1834,12598,-0.0631954,0.281947,-0.957347,1
3839,3798,18,441,0,998,245,9339,2343,11682,-0.0412114,0.275485,-0.960422,1
4799,4324,28,663,0,1079,352,11245,3623,14868,-0.0838807,0.261655,-0.961509,1
5810,4552,27,551,0,1130,299,12369,4227,16596,-0.0742639,0.289637,-0.954251,1
2842,2078,14,235,0,515,135,5819,2831,8650,-0.0475106,0.270356,-0.961587,1
5366,3383,28,387,0,841,222,10227,4203,14430,0.052132,0.282968,-0.957712,1
5247,3036,30,359,0,750,199,9621,2181,11802,0.102763,0.24582,-0.963853,1
5130,2857,32,367,0,700,192,9278,1708,10986,0.0980885,0.250673,-0.96309,1
5211,2634,29,326,0,671,179,9050,1581,10631,0.0960978,0.24338,-0.965159,1
4962,2495,30,331,0,613,165,8596,1383,9979,0.100176,0.234056,-0.967048,1
4920,2321,31,288,0,603,158,8321,1253,9574,0.0708533,0.235088,-0.969388,1
4801,2389,29,271,0,623,153,8266,1384,9650,0.0655569,0.225786,-0.971968,1
4594,2258,27,259,0,527,170,7835,1222,9057,0.0988414,0.22616,-0.969063,1
4486,2055,28,268,0,494,137,7468,988,8456,0.0548322,0.195893,-0.979091,1
4339,1862,28,238,0,469,130,7066,1214,8280,0.0478549,0.214606,-0.975527,1
4237,1840,28,227,0,445,125,6902,1084,7986,0.0627431,0.216996,-0.974154,1
4122,1727,28,220,0,426,122,6645,985,7630,0.0606297,0.227457,-0.971899,1
4089,1692,27,215,0,412,116,6551,975,7526,0.0402286,0.227825,-0.972871,1
3925,1616,27,206,0,397,113,6284,981,7265,0.0183714,0.233572,-0.972166,1
4354,1776,28,228,0,518,133,7037,1099,8136,-0.0569102,0.203116,-0.977499,1
3855,1548,25,198,0,376,108,6110,961,7071,-0.0540687,0.206246,-0.977005,1
3754,1547,25,197,0,366,109,5998,925,6923,-0.0573902,0.192521,-0.979613,1
3808,1340,24,180,0,331,97,5780,897,6677,-0.0655734,0.21227,-0.975009,1
3938,1361,26,204,0,313,94,5936,802,6738,-0.0717944,0.211486,-0.974741,1
3809,1207,33,164,0,297,88,5598,797,6395,-0.0695741,0.238737,-0.968589,1
3880,1335,29,181,0,316,103,5844,718,6562,-0.0834387,0.270403,-0.959125,1
3775,1195,26,205,0,296,89,5586,674,6260,-0.0367556,0.289731,-0.956402,1
3925,1361,50,178,0,307,90,5911,659,6570,-0.0742149,0.274917,-0.958599,1
3694,1334,24,185,0,319,94,5650,732,6382,-0.0867106,0.259521,-0.961837,1
3756,1379,25,222,0,353,100,5835,627,6462,-0.04332,0.301886,-0.952359,1
3871,2111,33,262,0,346,108,6731,558,7289,-0.0942827,0.313543,-0.944882,1
4091,1524,27,197,0,363,107,6309,671,6980,-0.0395733,0.303168,-0.952115,1
4008,1614,26,203,0,388,114,6353,455,6808,-0.115882,0.193132,-0.974306,1
3843,1675,26,209,0,392,123,6268,535,6803,-0.0467039,0.303526,-0.951678,1
4032,1790,26,224,0,419,123,6614,449,7063,-0.0758163,0.284904,-0.955553,1
3985,2007,26,235,0,449,137,6839,423,7262,-0.0808274,0.318163,-0.944584,1
4060,2109,28,250,0,554,145,7146,422,7568,-0.0312271,0.305381,-0.951718,1
4578,2394,28,261,0,518,176,7955,507,8462,-0.126618,0.301966,-0.944873,1
4403,2341,27,284,0,541,159,7755,483,8238,-0.02548,0.311162,-0.950015,1
4358,2642,28,337,0,588,173,8126,343,8469,-0.11786,0.313308,-0.94231,1
4535,2770,29,335,0,798,216,8683,575,9258,-0.0772683,0.325651,-0.942327,1
4991,3669,33,392,0,805,247,10137,522,10659,-0.0620261,0.334973,-0.940184,1
5321,4156,34,469,0,940,259,11179,488,11667,-0.0697388,0.315015,-0.946521,1
5332,4438,35,521,0,1062,292,11680,510,12190,-0.0678886,0.426305,-0.902028,1
5296,4692,36,543,0,1134,317,12018,526,12544,-0.0497272,0.352635,-0.934439,1
5332,4908,45,565,0,1138,314,12302,508,12810,-0.0470651,0.31877,-0.946663,1
4972,4546,33,514,0,1001,284,11350,429,11779,-0.0776873,0.302752,-0.949898,1
5094,4818,35,524,0,1026,286,11783,467,12250,-0.0938835,0.298575,-0.949758,1
5811,5581,36,548,0,1094,205,13275,344,13619,-0.0681301,0.327214,-0.942491,1
2318,2062,14,231,0,455,124,5204,179,5383,-0.0828212,0.251007,-0.964436,1
5043,4246,33,457,0,900,252,10931,332,11263,-0.0743991,0.304003,-0.949762,1
4818,3361,34,409,0,763,261,9646,551,10197,-0.00337413,0.309866,-0.950775,1
4616,2858,32,355,0,622,179,8662,412,9074,-0.0961377,0.284272,-0.953912,1
5260,2807,31,290,0,570,158,9116,436,9552,0.0225119,0.260003,-0.965346,1
4513,2011,29,242,0,467,156,7418,421,7839,-0.0860679,0.215308,-0.972746,1
5020,1652,30,238,0,379,113,7432,494,7926,0.0445927,0.26714,-0.962625,1
4288,1392,31,179,0,324,94,6308,389,6697,-0.0172397,0.300017,-0.953778,1
4296,1237,29,162,0,294,113,6131,413,6544,-0.0122252,0.307132,-0.951588,1
2936,792,18,101,0,200,70,4117,294,4411,0.000986927,0.240371,-0.970681,1
4810,1348,30,173,0,327,90,6778,530,7308,-0.0205727,0.277403,-0.960534,1
4334,1332,28,162,0,289,85,6230,614,6844,-0.0327074,0.294188,-0.955188,1
4451,1338,28,227,0,290,88,6422,701,7123,-0.0341129,0.305758,-0.951498,1
4633,1171,28,156,0,277,80,6345,711,7056,-0.0301845,0.298586,-0.953905,1
4696,1077,29,145,0,263,76,6286,757,7043,-0.0202196,0.270857,-0.962407,1
5046,972,33,197,0,323,83,6654,777,7431,-0.0320074,0.298542,-0.95386,1
4761,844,30,129,0,223,65,6052,921,6973,-0.0364612,0.268863,-0.962488,1
4611,778,25,119,0,208,61,5802,927,6729,-0.0410769,0.330647,-0.94286,1
4042,511,19,75,0,136,40,4823,706,5529,-0.0394031,0.277524,-0.95991,1
3347,541,20,84,0,138,34,4164,524,4688,0.0347577,0.285927,-0.957621,1
4323,631,26,103,0,166,49,5298,921,6219,0.046321,0.291067,-0.955581,1
4350,608,26,94,0,185,68,5331,1048,6379,0.0514587,0.287985,-0.956251,1
4167,646,28,91,0,146,44,5122,923,6045,0.0694146,0.298426,-0.951905,1
4129,537,26,83,0,140,42,4957,876,5833,0.0651636,0.280678,-0.957588,1
4019,466,27,74,0,122,40,4748,972,5720,-0.0101442,0.180331,-0.983554,1
3996,430,24,97,0,113,37,4697,1037,5734,-0.103578,0.242765,-0.96454,1
3958,376,26,68,0,103,33,4564,790,5354,-0.0474828,0.21313,-0.975869,1
4027,371,27,66,0,97,32,4620,879,5499,-0.0615454,0.222145,-0.973069,1
3988,352,29,65,0,94,31,4559,948,5507,-0.141253,0.282365,-0.948851,1
4063,392,27,72,0,104,33,4691,707,5398,-0.112325,0.29018,-0.950358,1
3928,514,25,82,0,133,42,4724,776,5500,-0.104599,0.2461,-0.963584,1
3945,693,27,103,0,171,54,4993,813,5806,-0.061899,0.251524,-0.96587,1
3952,902,31,140,0,211,64,5300,816,6116,-0.0493336,0.196436,-0.979275,1
4011,1095,33,154,0,255,76,5624,970,6594,-0.0497594,0.211019,-0.976215,1
4043,1346,28,190,0,317,94,6018,996,7014,-0.0430584,0.197404,-0.979376,1
4175,1758,27,213,0,406,116,6695,1113,7808,-0.0402563,0.191152,-0.980735,1
4441,2012,26,239,0,469,132,7319,1154,8473,-0.0382448,0.190853,-0.980873,1
4411,2966,29,315,0,534,151,8406,1210,9616,-0.0638243,0.192633,-0.979193,1
4516,2577,27,297,0,587,199,8203,1319,9522,-0.0368448,0.145981,-0.988601,1
4633,2631,28,311,0,701,175,8479,1468,9947,-0.0466175,0.134985,-0.989751,1
4677,2708,28,317,0,656,178,8564,1788,10352,-0.063655,0.146883,-0.987104,1
4666,2760,34,368,0,675,212,8715,1707,10422,-0.0525647,0.137348,-0.989127,1
4895,2898,34,339,0,936,290,9392,1876,11268,-0.0679343,0.16793,-0.983455,1
5058,3071,28,344,0,696,193,9390,1619,11009,-0.0758588,0.205167,-0.975783,1
4677,3123,31,379,0,735,201,9146,1383,10529,-0.0807064,0.212991,-0.973715,1
4804,3430,27,380,0,787,215,9643,1433,11076,-0.0894157,0.208097,-0.974013,1
4918,3646,28,415,0,855,232,10094,1478,11572,-0.0881601,0.197245,-0.976383,1
5481,4419,30,473,0,982,266,11651,1536,13187,-0.0749027,0.213498,-0.974068,1
5469,4700,29,534,0,1123,300,12155,1182,13337,-0.0800328,0.241027,-0.967213,1
5823,5304,29,621,0,1212,331,13320,875,14195,-0.0857502,0.26029,-0.961715,1
4229,3972,24,431,0,898,238,9792,693,10485,-0.166209,0.111751,-0.979738,1
4634,3915,21,500,0,979,255,10304,1544,11848,-0.0807749,0.177057,-0.98088,1
5857,5762,27,620,0,1261,316,13843,800,14643,-0.0865997,0.222273,-0.971131,1
4066,4133,19,468,0,978,254,9918,586,10504,-0.0649259,0.271809,-0.960159,1
6087,5457,24,631,0,1267,337,13803,1274,15077,-0.149124,0.300518,-0.942046,1
3869,4016,17,456,0,954,265,9577,1703,11280,-0.0559753,0.332841,-0.94132,1
6441,5131,21,568,0,1174,323,13658,2105,15763,-0.0531567,0.340534,-0.938728,1
4947,4838,23,516,0,1075,312,11711,2457,14168,-0.0476922,0.330908,-0.942457,1
5699,5161,27,596,0,1194,324,13001,3166,16167,-0.0602335,0.312905,-0.947873,1
3847,3396,23,375,0,803,217,8661,2345,11006,-0.0627926,0.274997,-0.959393,1
3521,2955,16,330,0,753,187,7762,1921,9683,-0.044321,0.262606,-0.963885,1
5952,4928,27,542,0,1147,305,12901,3020,15921,-0.0643253,0.252225,-0.965528,1
5866,4560,38,350,0,769,202,11785,2245,14030,-0.0488423,0.227762,-0.972491,1
5726,4522,27,506,0,1129,295,12205,2234,14439,-0.0325419,0.227575,-0.973217,1
5157,4042,24,453,0,1014,261,10951,2394,13345,-0.0629209,0.215179,-0.974546,1
5903,4500,27,508,0,1163,294,12395,2734,15129,-0.0545124,0.203423,-0.977572,1
4043,3136,20,356,0,764,222,8541,1703,10244,-0.0560961,0.207211,-0.976687,1
5962,4523,29,521,0,1116,313,12464,2184,14648,-0.0531397,0.205779,-0.977155,1
4029,3195,19,384,0,779,211,8617,1638,10255,-0.0568208,0.207125,-0.976663,1
5938,4709,28,550,0,1188,304,12717,2346,15063,-0.0544452,0.208321,-0.976544,1
5870,4814,25,532,0,1139,301,12681,2191,14872,-0.0594408,0.212953,-0.975253,1
4049,3418,19,374,0,784,206,8850,1711,10561,-0.0531975,0.215555,-0.975042,1
5342,4264,25,494,0,1099,277,11501,2181,13682,-0.0608236,0.219335,-0.973752,1
5420,4369,23,498,0,1022,270,11602,1970,13572,-0.0481347,0.223837,-0.973437,1
3753,3052,19,343,0,730,192,8089,1611,9700,-0.0393895,0.227159,-0.973061,1
5876,4641,27,530,0,1212,306,12592,2582,15174,-0.0437363,0.225976,-0.97315,1
6891,4609,28,529,0,1131,299,13487,2881,16368,-0.0527996,0.223367,-0.973303,1
3820,2496,15,279,0,599,157,7366,1243,8609,-0.0461508,0.231803,-0.971667,1
1842,1421,9,161,0,351,91,3875,864,4739,-0.0556727,0.232519,-0.970997,1
5815,5088,29,534,0,1140,318,12924,2922,15846,-0.0465681,0.217601,-0.974926,1
5958,4567,29,527,0,994,208,12283,1705,13988,-0.0450584,0.215261,-0.975517,1
4336,3353,21,391,0,805,208,9114,1625,10739,-0.0584427,0.213517,-0.97519,1
6322,4601,62,531,0,1385,400,13301,2487,15788,-0.0468969,0.216705,-0.97511,1
4052,3296,20,365,0,779,207,8719,1636,10355,-0.0516062,0.208323,-0.976698,1
5362,4454,32,613,0,1025,272,11758,2122,13880,-0.0474911,0.214954,-0.975469,1
5420,4234,25,502,0,842,194,11217,1510,12727,-0.0437357,0.213241,-0.97602,1
2917,2325,14,263,0,570,149,6238,1266,7504,-0.0579895,0.215133,-0.974862,1
6372,4708,29,532,0,1222,306,13169,2522,15691,-0.0524923,0.229903,-0.971797,1
6237,4650,28,533,0,1167,301,12916,2043,14959,-0.0647246,0.223614,-0.972526,1
3064,2478,14,317,0,601,161,6635,1417,8052,-0.0276089,0.229292,-0.972966,1
5793,4670,27,531,0,1155,301,12477,2480,14957,-0.0438631,0.212906,-0.976088,1
6070,4800,29,564,0,1140,307,12910,2326,15236,-0.0284095,0.217958,-0.975545,1
6130,4689,34,848,0,1612,309,13622,1614,15236,-0.0417794,0.228658,-0.97261,1
4051,3199,20,389,0,899,213,8771,1783,10554,-0.0362055,0.21845,-0.975177,1
6357,4858,29,534,0,1138,298,13214,2272,15486,-0.0499211,0.21536,-0.975258,1
4080,3193,25,380,0,792,210,8680,1641,10321,-0.0635579,0.215916,-0.974341,1
6617,4909,29,571,0,1134,302,13562,2596,16158,-0.0658156,0.224396,-0.972273,1
5885,4604,27,529,0,854,206,12105,1929,14034,-0.0447212,0.211704,-0.97631,1
3045,2468,15,280,0,630,162,6600,1300,7900,-0.0591601,0.222271,-0.973188,1
5842,5125,35,822,0,1728,444,13996,3219,17215,-0.062064,0.220175,-0.973484,1
3069,2420,14,289,0,645,159,6596,1339,7935,-0.0535349,0.22698,-0.972427,1
6590,5024,28,536,0,1148,324,13650,2233,15883,-0.0567714,0.218149,-0.974263,1
4095,3229,19,370,0,783,210,8706,1730,10436,-0.059801,0.220274,-0.973603,1
5406,4119,25,496,0,1015,270,11331,2216,13547,-0.0745014,0.217379,-0.97324,1
6575,4684,33,530,0,1250,307,13379,2572,15951,-0.0574228,0.216223,-0.974654,1
4044,3342,20,363,0,786,208,8763,1683,10446,-0.0564511,0.210333,-0.975998,1
5979,4810,28,533,0,1140,300,12790,2223,15013,-0.0458232,0.219207,-0.974602,1
4236,3300,37,366,0,789,204,8932,1672,10604,-0.0561541,0.232577,-0.970956,1
5905,4686,32,367,0,788,207,11985,1909,13894,-0.0671533,0.221234,-0.972906,1
3067,2498,15,279,0,660,219,6738,1472,8210,-0.0667086,0.233424,-0.970084,1
5801,4672,27,524,0,1134,299,12457,2739,15196,-0.0342106,0.2188,-0.97517,1
4037,3662,23,428,0,786,209,9145,1598,10743,-0.0413099,0.219365,-0.974768,1
6575,4852,28,695,0,1336,310,13796,1728,15524,-0.0550595,0.21308,-0.975482,1
4078,3952,20,374,0,799,209,9432,1584,11016,-0.0694028,0.215394,-0.974058,1
5860,5050,28,572,0,1146,303,12959,2560,15519,-0.0546047,0.232105,-0.971157,1
5893,4741,28,542,0,1149,331,12684,2633,15317,-0.0545434,0.212686,-0.975597,1
6160,4855,29,591,0,1159,307,13101,2491,15592,-0.0537571,0.212798,-0.975616,1
3076,2512,16,375,0,723,178,6880,1074,7954,-0.0414769,0.218509,-0.974953,2
2094,1678,13,238,0,514,110,4647,861,5508,-0.0605276,0.21297,-0.975182,2
5395,4248,24,495,0,1059,275,11496,2070,13566,-0.0631542,0.219975,-0.973459,2
5924,4764,27,571,0,1164,303,12753,2551,15304,-0.0679855,0.215023,-0.97424,2
6313,4893,50,573,0,1133,301,13263,2604,15867,-0.0695287,0.207635,-0.975732,2
5365,3055,15,281,0,601,158,9475,1213,10688,-0.0663367,0.220684,-0.973087,2
2489,2004,11,226,0,493,133,5356,1095,6451,-0.0508281,0.238561,-0.969796,2
5916,4730,27,536,0,1143,302,12654,2769,15423,-0.0479209,0.222403,-0.973776,2
5892,4898,27,536,0,1145,302,12800,2511,15311,-0.0613135,0.218256,-0.973964,2
5854,4704,32,530,0,1149,302,12571,2495,15066,-0.0499109,0.214081,-0.97554,2
3380,2493,14,315,0,551,173,6926,1014,7940,-0.0580845,0.216115,-0.974639,2
2430,1922,12,318,0,664,126,5472,1021,6493,-0.0455707,0.222007,-0.973979,2
5993,4839,26,535,0,1202,327,12922,2478,15400,-0.0702142,0.221854,-0.972549,2
6118,4810,27,535,0,1149,303,12942,2477,15419,-0.0600138,0.216319,-0.974477,2
4065,3288,19,368,0,791,207,8738,1673,10411,-0.0579428,0.223004,-0.973094,2
5954,4706,27,530,0,1180,302,12699,2573,15272,-0.0475816,0.236664,-0.970426,2
5356,4195,25,487,0,1021,269,11353,2629,13982,-0.0499471,0.228333,-0.972301,2
5369,4351,25,479,0,1026,289,11539,2348,13887,-0.0575745,0.218663,-0.9741,2
3814,3179,18,341,0,792,197,8341,1610,9951,-0.0594444,0.207452,-0.976437,2
6745,4787,31,587,0,1361,310,13821,2366,16187,-0.0563297,0.218905,-0.974119,2
5993,4804,20,368,0,794,208,12187,1919,14106,-0.0643768,0.223673,-0.972536,2
3089,2617,15,281,0,606,159,6767,1397,8164,-0.065878,0.219577,-0.973368,2
5785,5347,37,821,0,1711,408,14109,3183,17292,-0.0619696,0.212372,-0.975222,2
3205,2577,17,287,0,489,128,6703,1023,7726,-0.0501414,0.213505,-0.975655,2
5945,4714,29,535,0,1136,300,12659,2284,14943,-0.0435183,0.228421,-0.97259,2
6031,4428,19,370,0,793,224,11865,1771,13636,-0.0371832,0.230391,-0.972388,2
6134,4956,28,397,0,790,223,12528,1772,14300,-0.0417708,0.218005,-0.975054,2
3120,2554,14,279,0,600,157,6724,1218,7942,-0.053056,0.213567,-0.975486,2
6121,4768,28,530,0,1143,317,12907,2285,15192,-0.0479009,0.217176,-0.974957,2
5896,4831,28,499,0,784,206,12244,1710,13954,-0.0615852,0.223482,-0.972761,2
3231,2499,14,277,0,605,207,6833,1457,8290,-0.0538818,0.245198,-0.967974,2
6517,4974,29,569,0,1145,342,13576,3429,17005,-0.0464897,0.236119,-0.970611,2
5973,4836,28,430,0,786,222,12275,2000,14275,-0.0432598,0.211035,-0.976521,2
3138,2536,15,280,0,600,157,6726,1218,7944,-0.0457193,0.228027,-0.972581,2
5896,4681,28,552,0,1126,300,12583,2675,15258,-0.0590504,0.216902,-0.974406,2
6013,4913,30,539,0,782,208,12485,1794,14279,-0.0578784,0.230944,-0.971244,2
3631,2600,14,279,0,657,174,7355,1524,8879,-0.0517336,0.221449,-0.973799,2
6018,4891,34,528,0,1230,475,13176,2922,16098,-0.0684272,0.22756,-0.971357,2
4469,3468,19,388,0,801,229,9374,1961,11335,-0.055162,0.222148,-0.973451,2
5998,4840,28,542,0,1140,298,12846,1980,14826,-0.0580452,0.221811,-0.97336,2
4049,3241,15,290,0,599,161,8355,1445,9800,-0.0529422,0.224233,-0.973097,2
4370,3538,21,399,0,857,224,9409,2008,11417,-0.0736177,0.216083,-0.973596,2
5960,4743,28,532,0,1153,300,12716,3061,15777,-0.0721301,0.216778,-0.973553,2
4052,3167,20,384,0,790,203,8616,1803,10419,-0.051039,0.23801,-0.969921,2
5769,4481,27,531,0,1081,287,12176,2857,15033,-0.0738,0.243678,-0.967044,2
5835,4371,27,486,0,1072,280,12071,3004,15075,-0.047106,0.253663,-0.966145,2
3971,2946,19,324,0,748,189,8197,2144,10341,-0.0376495,0.247873,-0.968061,2
5728,4005,29,455,0,1021,265,11503,3195,14698,-0.0515497,0.254864,-0.965602,2
5772,3972,28,447,0,999,275,11493,2440,13933,-0.0314993,0.259996,-0.965096,2
5632,3705,28,427,0,932,243,10967,3237,14204,-0.0147757,0.257203,-0.966244,2
3817,2577,20,281,0,624,161,7480,2211,9691,-0.0100245,0.261298,-0.965206,2
5496,3453,35,394,0,865,247,10490,3291,13781,-0.0423196,0.25057,-0.967173,2
5437,3332,28,385,0,852,221,10255,1985,12240,-0.0609366,0.220645,-0.973449,2
5423,3342,29,380,0,824,214,10212,2145,12357,-0.0710104,0.225865,-0.971567,2
5346,3315,30,377,0,812,213,10093,2063,12156,-0.0528329,0.203841,-0.977577,2
3780,2177,21,250,0,539,141,6908,1147,8055,-0.0469593,0.189506,-0.980756,2
5341,3157,30,354,0,759,199,9840,1551,11391,-0.0543485,0.162532,-0.985205,2
5344,2998,29,342,0,736,192,9641,1469,11110,-0.0609473,0.185971,-0.980663,2
5341,2873,27,335,0,720,188,9484,1471,10955,-0.0507997,0.151198,-0.987197,2
5160,2783,29,325,0,697,185,9179,1460,10639,-0.0587448,0.184483,-0.981078,2
5216,2834,35,337,0,669,177,9268,1404,10672,-0.0586458,0.169344,-0.983811,2
5240,2683,30,308,0,640,170,9071,1385,10456,-0.0794559,0.227132,-0.970617,2
4980,2485,29,302,0,643,167,8606,1478,10084,-0.0767151,0.192128,-0.978367,2
4996,2294,30,291,0,625,199,8435,1348,9783,-0.08018,0.201972,-0.976104,2
4907,2271,29,270,0,593,185,8255,1272,9527,-0.0787344,0.192034,-0.978225,2
4780,2148,30,266,0,542,144,7910,1211,9121,-0.0850934,0.22017,-0.971743,2
4586,1978,31,244,0,511,137,7487,1288,8775,-0.135933,0.245289,-0.959872,2
4575,1883,41,236,0,482,130,7347,1360,8707,-0.213182,0.278913,-0.936355,2
4379,1804,29,273,0,460,126,7071,1150,8221,-0.227119,0.271417,-0.93528,2
4454,1680,29,217,0,436,118,6934,958,7892,-0.146958,0.31206,-0.938628,2
4076,1597,28,206,0,438,117,6462,1135,7597,-0.0748116,0.299095,-0.951286,2
4147,1571,25,213,0,433,115,6504,1233,7737,0.0264899,0.351776,-0.935709,2
4569,1548,27,200,0,381,145,6870,1206,8076,0.0259304,0.327589,-0.944464,2
3789,1463,27,191,0,371,105,5946,1078,7024,0.0128838,0.319473,-0.947508,2
3782,1482,26,191,0,371,105,5957,1245,7202,-0.00355648,0.31477,-0.949161,2
4395,1600,26,195,0,368,105,6689,1252,7941,-0.104987,0.298075,-0.948751,2
3753,1465,26,206,0,417,110,5977,993,6970,-0.101438,0.288428,-0.952113,2
4252,1790,27,191,0,352,102,6714,940,7654,-0.0987638,0.286144,-0.953083,2
3694,1477,27,214,0,347,105,5864,916,6780,-0.0941487,0.291726,-0.951857,2
3728,1418,27,188,0,373,103,5837,950,6787,-0.0867257,0.329128,-0.940294,2
3864,1425,25,186,0,376,108,5984,949,6933,-0.0816832,0.316399,-0.945103,2
3838,1478,25,195,0,393,110,6039,985,7024,-0.073763,0.343117,-0.936392,2
3958,1620,25,204,0,388,113,6308,1038,7346,-0.0706025,0.371864,-0.925599,2
3903,1737,26,255,0,415,124,6460,984,7444,-0.0661243,0.373745,-0.925171,2
3947,1888,34,237,0,441,127,6674,768,7442,-0.0699531,0.37017,-0.926327,2
4031,1916,28,236,0,450,129,6790,865,7655,-0.0611266,0.385979,-0.92048,2
4020,1887,28,233,0,465,129,6762,715,7477,-0.0578038,0.384508,-0.921311,2
4095,1854,27,256,0,458,129,6819,605,7424,-0.054872,0.385562,-0.921049,2
4070,1972,26,241,0,463,133,6905,557,7462,-0.04382,0.392418,-0.918743,2
4163,2226,29,264,0,526,147,7355,447,7802,-0.0548139,0.38008,-0.923328,2
4264,2417,27,294,0,566,161,7729,447,8176,-0.030109,0.374775,-0.926627,2
4330,2831,30,337,0,644,183,8355,348,8703,-0.031589,0.290455,-0.956367,2
4432,3072,29,361,0,718,202,8814,707,9521,-0.0451679,0.360678,-0.931596,2
4560,3426,28,416,0,787,224,9441,721,10162,-0.0401522,0.384835,-0.922112,2
4704,3625,31,436,0,857,241,9894,333,10227,-0.0421099,0.44512,-0.89448,2
4720,3776,32,449,0,921,252,10150,525,10675,-0.0393553,0.361511,-0.931537,2
4834,4060,34,473,0,936,263,10600,986,11586,-0.056401,0.360095,-0.931209,2
4841,4302,37,635,0,990,272,11077,388,11465,-0.0460528,0.351513,-0.93505,2
4978,4238,33,512,0,994,275,11030,331,11361,-0.051981,0.385372,-0.921296,2
5671,4879,38,566,0,1133,313,12600,483,13083,-0.0429179,0.346401,-0.937104,2
5051,4393,39,528,0,1039,284,11334,445,11779,-0.0301656,0.343612,-0.938627,2
5247,4788,34,541,0,1098,295,12003,443,12446,-0.0164271,0.343124,-0.939146,2
5258,4732,33,537,0,1074,296,11930,497,12427,-0.0353541,0.328125,-0.943973,2
3435,3014,29,353,0,676,200,7707,359,8066,-0.033156,0.31849,-0.947346,2
4728,3900,33,436,0,876,264,10237,418,10655,-0.046027,0.310251,-0.94954,2
4484,3360,35,388,0,760,250,9277,408,9685,-0.0268875,0.344384,-0.938444,2
5229,3033,29,334,0,642,182,9449,469,9918,-0.0122312,0.299301,-0.95408,2
4202,2539,29,289,0,546,155,7760,399,8159,-0.0822379,0.276064,-0.957614,2
3924,2068,29,246,0,469,134,6870,530,7400,-0.0276593,0.327816,-0.944337,2
3968,1782,28,206,0,381,109,6474,433,6907,-0.0593782,0.346043,-0.936338,2
3965,1312,45,201,0,330,96,5949,422,6371,-0.0515979,0.319933,-0.946034,2
4038,970,29,134,0,233,70,5474,476,5950,-0.0551218,0.327452,-0.943258,2
4087,803,28,117,0,190,57,5282,482,5764,-0.0110245,0.355982,-0.934428,2
5214,667,25,102,0,161,50,6219,-1000,-1000,-1,-1,-1,2
4330,570,27,90,0,144,44,5205,-1000,-1000,-1,-1,-1,2
4451,512,27,86,0,133,43,5252,1330,6582,0.0194096,0.407212,-0.913127,2
5295,484,46,99,0,128,40,6092,457,6549,0.0356043,0.443051,-0.895789,2
3916,309,17,52,0,84,25,4403,294,4697,0.0674398,0.289019,-0.954945,2
4811,463,34,77,0,124,37,5546,409,5955,0.0183115,0.409515,-0.91212,2
4693,449,27,76,0,129,40,5414,702,6116,0.0628506,0.385009,-0.92077,2
4895,453,27,76,0,114,34,5599,597,6196,0.0652654,0.394182,-0.916712,2
4513,347,26,64,0,96,30,5076,720,5796,0.0534586,0.369009,-0.927887,2
4306,378,26,69,0,98,30,4907,792,5699,0.0643259,0.372708,-0.925717,2
4953,499,28,77,0,113,35,5705,798,6503,0.0694465,0.376321,-0.923883,2
4094,420,25,70,0,118,36,4763,794,5557,0.073112,0.356869,-0.931289,2
4734,512,30,85,0,132,40,5533,1102,6635,0.0777602,0.364852,-0.927813,2
4111,347,26,65,0,100,50,4699,873,5572,0.0726878,0.327646,-0.942,2
4766,403,32,74,0,106,33,5414,1093,6507,0.074867,0.428941,-0.900225,2
5246,420,33,76,0,104,33,5912,1050,6962,0.0711804,0.371153,-0.92584,2
2743,249,19,46,0,69,21,3147,645,3792,0.0922236,0.307558,-0.94705,2
2166,247,15,41,0,68,20,2557,522,3079,0.0753631,0.331172,-0.940556,2
4040,613,28,93,0,158,46,4978,1051,6029,0.0739643,0.342382,-0.936645,2
4084,778,28,111,0,202,59,5262,1125,6387,0.0539224,0.320233,-0.945803,2
4651,980,28,134,0,248,70,6111,1425,7536,0.0760388,0.355386,-0.931622,2
4279,1221,28,158,0,304,86,6076,1264,7340,0.0595165,0.339371,-0.938768,2
4467,1547,28,196,0,382,106,6726,1459,8185,0.0565715,0.355864,-0.932824,2
4684,2040,28,284,0,510,137,7683,1476,9159,0.0772675,0.375097,-0.92376,2
5474,2653,31,316,0,811,182,9467,1565,11032,0.0607212,0.380621,-0.922735,2
5303,3451,31,435,0,853,233,10306,1379,11685,0.0164821,0.384932,-0.922798,2
6331,4594,30,547,0,1112,310,12924,1062,13986,-0.0143755,0.381429,-0.924287,2
4260,3541,20,423,0,838,221,9303,487,9790,-0.00454471,0.281088,-0.959672,2
4403,3847,20,446,0,929,246,9891,1070,10961,-0.0591705,0.310274,-0.948804,2
6756,6276,29,727,0,1465,393,15646,1306,16952,-0.129894,0.371689,-0.919225,2
4629,4495,28,505,0,978,249,10884,1234,12118,-0.136136,0.348743,-0.927278,2
3538,3627,15,454,0,873,221,8728,1462,10190,-0.107433,0.33364,-0.936559,2
7397,6998,33,746,0,1384,289,16847,1972,18819,-0.0452746,0.338865,-0.939745,2
3465,3577,15,410,0,856,216,8539,1460,9999,-0.0591478,0.339182,-0.938859,2
6434,6462,32,746,0,1468,403,15545,2696,18241,-0.0356794,0.3467,-0.937297,2
4373,4062,18,430,0,920,244,10047,2177,12224,-0.040856,0.343777,-0.938162,2
3927,3463,24,371,0,759,203,8747,2130,10877,-0.0521458,0.349571,-0.935458,2
4825,3622,21,419,0,844,225,9956,3052,13008,-0.0658058,0.369525,-0.926888,2
4609,2974,23,331,0,714,187,8838,3219,12057,-0.0662731,0.370376,-0.926515,2
4018,1952,21,262,0,583,141,6977,3357,10334,-0.159916,0.368705,-0.915687,2
4977,2142,29,259,0,603,153,8163,2811,10974,-0.187128,0.371295,-0.909463,2
5196,1919,28,262,0,496,132,8033,2124,10157,-0.195818,0.392161,-0.898813,2
6216,1780,30,225,0,513,147,8911,1804,10715,-0.176309,0.387047,-0.905047,2
5066,2029,38,328,0,653,149,8263,1800,10063,-0.199489,0.422759,-0.884013,2
4914,1688,22,181,0,302,90,7197,1078,8275,-0.180569,0.395708,-0.90045,2
2709,857,15,107,0,220,61,3969,852,4821,-0.178456,0.346565,-0.920895,2
3628,1162,20,149,0,321,83,5363,1090,6453,-0.173492,0.339247,-0.924561,2
4977,1546,28,199,0,403,108,7261,1515,8776,-0.18582,0.388566,-0.902489,2
4520,987,18,129,0,293,75,6022,775,6797,-0.183628,0.339522,-0.9225,2
4467,1426,28,184,0,355,97,6557,842,7399,-0.178866,0.320863,-0.930083,2
4292,1275,27,165,0,316,87,6162,642,6804,-0.0430804,0.359666,-0.932086,2
4475,1127,27,149,0,292,82,6152,1258,7410,0.0296024,0.377676,-0.925464,2
4212,1058,25,142,0,270,75,5782,861,6643,-0.0853795,0.338709,-0.93701,2
4138,1068,25,147,0,271,77,5726,1211,6937,0.012437,0.402455,-0.915355,2
4010,1092,26,147,0,278,79,5632,677,6309,-0.0856785,0.373104,-0.923825,2
3880,1193,26,155,0,324,88,5666,921,6587,-0.0980044,0.348204,-0.932282,2
3957,1212,26,190,0,290,87,5762,819,6581,-0.11303,0.378411,-0.918711,2
3909,1241,26,160,0,314,86,5736,685,6421,-0.116576,0.414754,-0.902435,2
3976,1199,25,161,0,292,102,5755,643,6398,-0.096959,0.431503,-0.896886,2
3839,1388,29,176,0,318,93,5843,630,6473,-0.0935531,0.427787,-0.899025,2
3893,1459,25,187,0,384,104,6052,583,6635,-0.0909461,0.427845,-0.899265,2
4108,1675,27,203,0,394,140,6547,671,7218,-0.0956312,0.439864,-0.892958,2
4025,1917,26,229,0,425,123,6745,496,7241,-0.112465,0.469682,-0.875643,2
4379,2110,33,297,0,514,144,7477,408,7885,-0.12176,0.43712,-0.891123,2
4245,2267,30,333,0,555,159,7589,460,8049,-0.0573059,0.441611,-0.895374,2
4761,2681,27,304,0,586,166,8525,352,8877,-0.113603,0.480397,-0.869662,2
4367,2798,39,334,0,677,184,8399,401,8800,-0.126228,0.41666,-0.900256,2
4542,3242,29,368,0,781,211,9173,410,9583,-0.0806016,0.443961,-0.892414,2
4795,4184,47,477,0,891,235,10629,601,11230,-0.0816507,0.425189,-0.901414,2
4935,3419,29,413,0,807,227,9830,663,10493,-0.073094,0.43425,-0.897822,2
7490,5059,39,642,0,1185,336,14751,889,15640,-0.0731511,0.415274,-0.90675,2
5003,3527,31,422,0,903,356,10242,1118,11360,-0.0688119,0.407911,-0.910425,2
5022,3844,32,453,0,912,253,10516,1575,12091,-0.0638602,0.395824,-0.916103,2
3465,3216,23,321,0,640,183,7848,952,8800,-0.0749358,0.39431,-0.915917,2
5189,4113,33,483,0,960,270,11048,1306,12354,-0.0829198,0.399264,-0.913078,2
5231,4150,33,495,0,990,274,11173,1174,12347,-0.0682474,0.412666,-0.908322,2
5409,4294,34,506,0,630,176,11049,247,11296,-0.0650876,0.43651,-0.897342,2
3337,2498,22,359,0,586,158,6960,401,7361,-0.060629,0.404037,-0.912731,2
4696,3267,35,467,0,687,199,9351,371,9722,-0.0566588,0.425722,-0.903079,2
4297,2536,29,305,0,585,168,7920,346,8266,-0.0753465,0.419929,-0.904424,2
5479,2618,32,321,0,497,146,9093,563,9656,-0.0350001,0.384391,-0.922507,2
4458,1728,27,220,0,431,120,6984,576,7560,-0.0173286,0.355268,-0.934604,2
4338,1927,44,366,0,529,123,7327,636,7963,-0.0229805,0.34396,-0.938703,2
4272,1241,31,170,0,296,88,6098,851,6949,-0.0248508,0.3636,-0.931224,2
3818,962,29,127,0,253,70,5259,364,5623,0.0224672,0.387364,-0.921653,2
4570,756,28,115,0,248,79,5796,450,6246,-0.00694991,0.364076,-0.931343,2
4329,713,39,123,0,172,53,5429,-1000,-1000,-1,-1,-1,2
4290,585,37,102,0,202,43,5259,-1000,-1000,-1,-1,-1,2
4566,622,27,88,0,178,54,5535,1192,6727,-0.00201025,0.381519,-0.924359,2
4350,467,26,77,0,123,37,5080,321,5401,0.174084,-0.249896,-0.952495,2
4981,636,46,136,0,141,45,5985,518,6503,0.0133803,0.325947,-0.945293,2
4374,469,25,77,0,122,37,5104,447,5551,0.0116411,0.354261,-0.935074,2
5301,561,30,91,0,142,43,6168,533,6701,0.00446184,0.404557,-0.914502,2
4868,549,30,93,0,142,43,5725,485,6210,0.00944554,0.407818,-0.913015,2
5003,580,32,93,0,173,47,5928,630,6558,-0.00275694,0.479911,-0.877313,2
5255,534,28,90,0,142,43,6092,641,6733,0.00311015,0.478869,-0.877881,2
4648,451,32,97,0,170,56,5454,816,6270,0.0131808,0.45503,-0.890378,2
3275,335,19,52,0,79,23,3783,523,4306,0.0212357,0.427581,-0.903728,2
4976,381,21,64,0,109,31,5582,555,6137,0.0536666,0.387372,-0.92036,2
2102,193,12,33,0,69,18,2427,355,2782,0.0527805,0.378042,-0.924283,2
1271,157,8,24,0,43,12,1515,286,1801,0.0476977,0.375163,-0.925731,2
3071,386,26,64,0,110,31,3688,839,4527,0.039673,0.396272,-0.917275,2
4377,663,29,96,0,165,46,5376,1278,6654,0.0656709,0.383942,-0.921019,2
4440,595,29,93,0,167,47,5371,1099,6470,0.0467721,0.443176,-0.895213,2
4544,596,28,93,0,169,47,5477,1214,6691,0.0648553,0.428561,-0.901182,2
4156,628,28,96,0,175,49,5132,1164,6296,0.0767994,0.425744,-0.901579,2
4521,795,29,117,0,207,60,5729,1126,6855,0.0999717,0.417207,-0.903296,2
4240,1040,29,141,0,284,77,5811,1090,6901,0.120207,0.408803,-0.904672,2
4856,1618,28,234,0,412,114,7262,1091,8353,0.1175,0.419187,-0.900265,2
5469,2391,31,289,0,566,156,8902,1299,10201,0.126743,0.411668,-0.902478,2
4677,2798,26,357,0,689,187,8734,1321,10055,0.00962507,0.415382,-0.909596,2
6531,4044,29,465,0,1065,265,12399,1321,13720,-0.0732945,0.452163,-0.888919,2
6313,4592,28,532,0,1144,298,12907,1328,14235,-0.118853,0.365173,-0.923322,2
4288,3445,19,405,0,887,240,9284,1863,11147,-0.12587,0.374386,-0.91869,2
4222,3416,19,415,0,836,222,9130,1808,10938,-0.103866,0.353343,-0.92971,2
6263,5572,39,632,0,1364,354,14224,3687,17911,-0.0787162,0.34195,-0.936416,2
4320,3642,18,402,0,863,228,9473,2911,12384,-0.0703498,0.347553,-0.935018,2
4733,3857,23,423,0,899,235,10170,3596,13766,-0.0331441,0.338621,-0.940339,2
4507,2834,22,335,0,737,193,8628,3101,11729,-0.0474904,0.354165,-0.933977,2
4388,2085,21,251,0,552,143,7440,3251,10691,-0.0362225,0.357297,-0.933288,2
5015,2184,28,272,0,627,161,8287,3491,11778,-0.0482223,0.357282,-0.932751,2
5071,1803,28,233,0,504,132,7771,2735,10506,-0.0135347,0.392483,-0.91966,2
3491,1141,22,176,0,340,86,5256,1611,6867,-0.00490284,0.387762,-0.921746,2
3379,1154,20,146,0,328,83,5110,1431,6541,-0.012655,0.403595,-0.91485,2
5086,1553,30,209,0,423,112,7413,1879,9292,-0.0237992,0.408384,-0.9125,2
4869,1581,31,201,0,452,114,7248,1904,9152,-0.0982941,0.433986,-0.895541,2
4672,1658,32,204,0,405,109,7080,2029,9109,-0.138778,0.399889,-0.905996,2
5125,1693,27,191,0,388,130,7554,1879,9433,-0.136581,0.39278,-0.909434,2
5176,1652,32,216,0,433,118,7627,1935,9562,-0.0924405,0.402408,-0.910782,2
4654,1573,31,207,0,535,166,7166,2162,9328,-0.0836844,0.382095,-0.920326,2
4128,1420,25,184,0,363,101,6221,1709,7930,-0.0830812,0.395162,-0.914847,2
4547,1900,27,233,0,395,116,7218,1948,9166,-0.0671676,0.41109,-0.909117,2
4492,1495,29,198,0,387,108,6709,1557,8266,-0.0943469,0.412987,-0.905837,2
5220,1339,28,215,0,439,129,7370,1334,8704,-0.074181,0.433236,-0.898223,2
3973,1386,24,182,0,349,110,6024,1310,7334,-0.0782718,0.44885,-0.890173,2
4988,1708,28,217,0,415,117,7473,1253,8726,-0.0973238,0.489609,-0.866494,2
4579,1762,28,224,0,476,194,7263,1039,8302,-0.0965497,0.493664,-0.864277,2
4635,1929,31,231,0,435,143,7404,600,8004,-0.0964351,0.400309,-0.911292,2
5193,1812,28,229,0,568,157,7987,503,8490,-0.0842981,0.423476,-0.901977,2
4482,1664,27,212,0,411,118,6914,391,7305,-0.489762,-0.228915,-0.841267,2
4844,1871,45,387,0,407,121,7675,494,8169,-0.114284,0.402748,-0.908148,2
4914,1989,29,246,0,474,139,7791,643,8434,-0.0919477,0.378845,-0.920881,2
4969,2318,31,275,0,652,244,8489,698,9187,-0.144786,0.26555,-0.953164,2
4833,3406,30,402,0,624,180,9475,548,10023,-0.0537202,0.365055,-0.929435,2
5126,3009,30,374,0,692,198,9429,588,10017,0.0156446,0.517345,-0.855634,2
5171,2983,32,376,0,795,211,9568,619,10187,0.0451473,0.530281,-0.846619,2
5324,3108,35,370,0,740,204,9781,800,10581,-0.0896803,0.357699,-0.929521,2
5238,2591,28,319,0,633,178,8987,879,9866,-0.0345713,0.307701,-0.950855,2
5432,2611,33,365,0,756,195,9392,819,10211,-0.0335116,0.307479,-0.950965,2
8690,3620,30,333,0,632,183,13488,478,13966,-0.00859616,0.275994,-0.961121,2
2810,1314,17,167,0,319,91,4718,220,4938,-0.0310309,0.325128,-0.945161,2
4945,2433,32,307,0,572,164,8453,540,8993,0.0743738,0.387467,-0.918879,2
4823,2194,31,277,0,515,149,7989,524,8513,0.14301,0.588023,-0.796102,2
4594,1804,30,234,0,490,126,7278,450,7728,-0.0490362,0.463062,-0.884968,2
4679,1483,28,196,0,354,104,6844,363,7207,-0.0902088,0.474978,-0.875362,2
4167,1333,26,207,0,360,102,6195,401,6596,-0.0433488,0.469157,-0.88205,2
4083,1203,26,192,0,288,87,5879,-1000,-1000,-1,-1,-1,2
4130,928,29,148,0,233,70,5538,615,6153,0.181135,0.60566,-0.774833,2
3938,759,25,114,0,188,113,5137,-1000,-1000,-1,-1,-1,2
4410,700,29,134,0,174,59,5506,-1000,-1000,-1,-1,-1,2
4578,616,38,98,0,149,48,5527,-1000,-1000,-1,-1,-1,2
3877,511,27,82,0,123,40,4660,-1000,-1000,-1,-1,-1,2
4095,501,27,83,0,124,40,4870,-1000,-1000,-1,-1,-1,2
4384,489,26,83,0,118,38,5138,305,5443,0.0271956,0.381775,-0.923855,2
5254,516,28,92,0,167,59,6116,1979,8095,0.00130505,0.34807,-0.937468,2
4425,513,27,83,0,127,38,5213,293,5506,-0.241775,0.655147,-0.715771,2
4894,439,41,88,0,150,40,5652,491,6143,-0.0417454,0.379065,-0.924428,2
4636,428,32,84,0,121,36,5337,421,5758,-0.0497378,0.435684,-0.898725,2
5562,421,29,74,0,151,38,6275,507,6782,-0.0798953,0.44432,-0.892299,2
5361,425,26,83,0,150,41,6086,748,6834,-0.0738009,0.46727,-0.881029,2
4909,402,22,85,0,139,37,5594,557,6151,-0.0547501,0.448182,-0.892264,2
3019,233,14,40,0,61,18,3385,411,3796,-0.0196019,0.366373,-0.930262,2
2621,262,15,45,0,73,22,3038,485,3523,-0.0107256,0.358365,-0.93352,2
5302,494,26,88,0,131,40,6081,761,6842,-0.00925574,0.393606,-0.919233,2
4261,476,27,79,0,127,39,5009,882,5891,-0.000414854,0.374255,-0.927326,2
4197,426,26,75,0,163,44,4931,1004,5935,0.00921204,0.375821,-0.926647,2
4231,467,27,79,0,119,36,4959,1312,6271,0.00273881,0.353619,-0.935386,2
4167,494,28,81,0,129,39,4938,1152,6090,-0.044317,0.310216,-0.949633,2
4284,653,27,100,0,167,51,5282,1429,6711,-0.0535253,0.335378,-0.940562,2
4398,933,27,140,0,265,72,5835,1751,7586,-0.0534959,0.327797,-0.943232,2
4398,1299,28,238,0,316,92,6371,1472,7843,-0.0705642,0.354501,-0.932389,2
4587,1776,29,223,0,424,119,7158,1374,8532,-0.0561448,0.350894,-0.934731,2
4747,2359,28,292,0,599,162,8187,1374,9561,-0.0266917,0.402216,-0.915156,2
5231,3210,29,377,0,761,209,9817,1384,11201,-0.035358,0.4181,-0.907713,2
5047,3465,27,399,0,869,229,10036,1407,11443,-0.0633962,0.40604,-0.911654,2
6181,4434,29,491,0,1042,275,12452,1458,13910,-0.0598165,0.386597,-0.920307,2
4445,3143,23,372,0,807,240,9030,1834,10864,-0.0814509,0.414003,-0.906624,2
5896,4560,26,508,0,1109,287,12386,1662,14048,-0.0540899,0.303237,-0.951379,2
4194,3314,20,395,0,806,214,8943,4818,13761,-0.0533941,0.393461,-0.917789,2
5086,3969,23,451,0,994,271,10794,2194,12988,-0.0243885,0.282166,-0.959055,2
4883,3505,23,427,0,868,232,9938,4205,14143,-0.036446,0.296574,-0.954314,2
3339,2216,18,243,0,558,142,6516,2970,9486,-0.0417757,0.265684,-0.963155,2
5376,2821,28,353,0,783,200,9561,4737,14298,-0.0636898,0.296661,-0.952857,2
5364,2346,29,292,0,674,171,8876,3905,12781,-0.0771489,0.306608,-0.948704,2
3523,1479,20,178,0,384,101,5685,2302,7987,-0.0854352,0.289555,-0.953341,2
5157,1958,30,263,0,515,137,8060,2954,11014,-0.082314,0.312552,-0.946327,2
5093,1860,32,239,0,494,131,7849,2586,10435,-0.0582687,0.348197,-0.935609,2
4950,1728,30,223,0,462,124,7517,2315,9832,-0.046264,0.342457,-0.938394,2
4870,1637,31,210,0,451,116,7315,2228,9543,-0.0545208,0.350648,-0.934919,2
4706,1553,29,223,0,399,110,7020,2106,9126,-0.0532386,0.345869,-0.936771,2
4587,1402,27,185,0,377,126,6704,2129,8833,-0.0559826,0.366672,-0.928664,2
4256,1422,26,177,0,411,104,6396,1767,8163,-0.0874239,0.465762,-0.880581,2
4017,1315,19,119,0,230,76,5776,1082,6858,-0.074212,0.403472,-0.911978,2
2025,676,13,88,0,168,48,3018,722,3740,-0.0707447,0.367794,-0.927212,2
3971,1211,24,166,0,311,89,5772,1346,7118,-0.0798884,0.389344,-0.917621,2
4386,1258,32,183,0,415,96,6370,1094,7464,-0.0881738,0.38675,-0.91796,2
3927,1245,24,167,0,316,91,5770,1068,6838,-0.0770483,0.401908,-0.912433,2
3987,1284,27,205,0,329,95,5927,744,6671,-0.0847026,0.42021,-0.903465,2
4204,1560,25,214,0,374,105,6482,635,7117,-0.0829376,0.411772,-0.907505,2
3946,1546,48,200,0,366,105,6211,496,6707,-0.0952279,0.405462,-0.909138,2
3928,1613,26,206,0,382,110,6265,419,6684,-0.0763366,0.397704,-0.914333,2
4068,1644,26,214,0,398,126,6476,797,7273,-0.0707297,0.380335,-0.922141,2
4513,1950,29,245,0,463,136,7336,781,8117,-0.0765052,0.311898,-0.947031,2
4226,1855,27,233,0,448,132,6921,600,7521,-0.0744117,0.315389,-0.946041,2
4741,2328,27,289,0,508,170,8063,516,8579,-0.0453423,0.208895,-0.976886,2
5012,2841,30,329,0,622,196,9030,728,9758,-0.00931249,0.240324,-0.970648,2
4994,2305,29,321,0,552,200,8401,1001,9402,-0.00905545,0.248019,-0.968713,2
5206,2200,27,261,0,504,141,8339,1003,9342,-0.00208419,0.292665,-0.956213,2
4886,2020,31,259,0,481,138,7815,736,8551,0.0051102,0.287867,-0.957657,2
4857,2101,40,258,0,516,145,7917,700,8617,0.063667,0.527825,-0.846964,2
4817,1805,28,259,0,435,128,7472,755,8227,-0.0211485,0.501651,-0.864812,2
4529,1781,27,221,0,407,117,7082,636,7718,-0.0715482,0.475155,-0.876989,2
4357,1542,26,192,0,347,103,6567,-1000,-1000,-1,-1,-1,2
4871,1180,25,141,0,251,76,6544,1313,7857,0.502617,0.109318,-0.857569,2
4975,862,30,131,0,216,66,6280,-1000,-1000,-1,-1,-1,2
4303,533,25,83,0,136,42,5122,-1000,-1000,-1,-1,-1,2
4882,418,30,78,0,113,36,5557,-1000,-1000,-1,-1,-1,2
4816,383,30,71,0,128,35,5463,1707,7170,-0.0554946,0.310794,-0.948856,2
4713,360,26,63,0,101,34,5297,497,5794,-0.0722516,0.401431,-0.913035,2
5149,365,37,72,0,112,32,5767,816,6583,-0.0601075,0.373088,-0.925847,2
5071,369,26,62,0,93,27,5648,912,6560,-0.0469796,0.379636,-0.923942,2
5134,271,25,57,0,87,25,5599,908,6507,-0.0764673,0.467921,-0.880456,2
5085,275,26,75,0,79,25,5565,888,6453,-0.0193751,0.348923,-0.936951,2
4441,232,26,48,0,71,22,4840,914,5754,-0.0229399,0.33488,-0.941982,2
4910,232,29,51,0,98,27,5347,997,6344,-0.0867505,0.467616,-0.879664,2
4947,227,29,51,0,67,22,5343,1029,6372,-0.0954363,0.451646,-0.887079,2
5153,217,38,66,0,63,22,5559,1008,6567,-0.0598745,0.392736,-0.917701,2
4668,174,42,42,0,48,18,4992,907,5899,-0.057887,0.372249,-0.926326,2
4776,195,32,47,0,55,20,5125,1004,6129,-0.101302,0.416021,-0.903695,2
4669,190,31,44,0,55,20,5009,1147,6156,-0.0684121,0.342297,-0.937098,2
4116,192,39,43,0,53,19,4462,1001,5463,-0.0570859,0.302347,-0.951487,2
4716,252,29,88,0,73,25,5183,1255,6438,-0.0576395,0.315578,-0.947147,2
4671,344,31,67,0,94,40,5247,1016,6263,-0.0433412,0.265947,-0.963013,2
4847,506,31,83,0,127,48,5642,829,6471,-0.0332897,0.186917,-0.981812,2
4710,771,33,118,0,192,59,5883,1273,7156,-0.0279958,0.33196,-0.942878,2
5003,1355,34,177,0,320,92,6981,1536,8517,-0.0378128,0.344263,-0.938111,2
5280,2158,33,266,0,553,151,8441,1338,9779,-0.0410586,0.325682,-0.944588,2
5777,2820,20,279,0,536,192,9624,1291,10915,-0.0519325,0.368222,-0.928286,2
3224,2165,18,318,0,526,140,6391,730,7121,0.0150952,0.265117,-0.964098,2
6108,4188,29,487,0,1064,299,12175,4319,16494,-0.0841453,0.423619,-0.901924,2
3209,2473,15,279,0,619,158,6753,803,7556,-0.0472338,0.279482,-0.958988,2
7216,5556,31,726,0,1443,369,15341,5065,20406,-0.0245348,0.191533,-0.981179,2
3306,2602,14,296,0,688,168,7074,3301,10375,-0.0139428,0.186159,-0.982421,2
3911,2992,17,361,0,748,207,8236,4014,12250,-0.0087834,0.158294,-0.987353,2
6696,4300,28,463,0,1172,288,12947,5400,18347,-0.020131,0.164602,-0.986155,2
2973,1839,14,223,0,481,121,5651,3076,8727,-0.0235639,0.143345,-0.989392,2
5476,2791,28,324,0,771,192,9582,4041,13623,-0.0344883,0.184924,-0.982148,2
3439,1576,20,207,0,411,108,5761,2876,8637,-0.0299931,0.179018,-0.983389,2
5853,2267,34,327,0,594,156,9231,4055,13286,-0.0483031,0.217826,-0.974792,2
3705,1499,22,179,0,416,105,5926,2371,8297,-0.0430823,0.19458,-0.97994,2
4825,1794,45,224,0,466,122,7476,2894,10370,-0.0408797,0.255779,-0.965871,2
4410,1445,29,186,0,397,105,6572,2574,9146,-0.0433818,0.254616,-0.966069,2
4858,1503,32,201,0,508,118,7220,2627,9847,-0.0234714,0.365269,-0.930606,2
4548,1449,29,192,0,375,104,6697,2575,9272,-0.0357421,0.350569,-0.935855,2
4097,879,17,118,0,261,70,5442,1532,6974,-0.0352359,0.262017,-0.96442,2
2621,805,18,124,0,213,60,3841,1443,5284,-0.0353407,0.2639,-0.963902,2
4134,1274,34,205,0,339,99,6085,2227,8312,-0.0179804,0.287012,-0.957758,2
4336,1364,87,194,0,384,102,6467,2254,8721,-0.0232514,0.286271,-0.957866,2
4315,1489,29,253,0,383,113,6582,2209,8791,-0.028207,0.31679,-0.948076,2
4384,1758,27,212,0,415,115,6911,1731,8642,-0.0321544,0.382606,-0.923352,2
4403,1790,28,231,0,454,146,7052,1382,8434,-0.0429651,0.414136,-0.909201,2
4023,1782,26,220,0,438,121,6610,1017,7627,-0.0592436,0.423792,-0.90382,2
4183,2042,27,240,0,501,134,7127,950,8077,-0.060134,0.376015,-0.924661,2
4324,2190,28,258,0,551,147,7498,959,8457,-0.0553444,0.367629,-0.928325,2
5001,2562,33,294,0,830,174,8894,944,9838,-0.05839,0.368058,-0.927967,2
4188,2518,28,298,0,617,170,7819,935,8754,-0.047742,0.3273,-0.943714,2
4301,2565,29,307,0,621,199,8022,642,8664,-0.0623013,0.322646,-0.944467,2
4500,2801,30,328,0,661,203,8523,817,9340,-0.0871379,0.31356,-0.945562,2
4495,3024,35,344,0,718,210,8826,895,9721,-0.0372655,0.308861,-0.950377,2
5852,3090,32,352,0,722,194,10242,594,10836,-0.096906,0.301609,-0.948494,2
4482,3058,31,355,0,769,203,8898,1050,9948,-0.0633065,0.267494,-0.961478,2
5074,3062,30,390,0,749,201,9506,796,10302,-0.0606043,0.262791,-0.962947,2
5280,4289,35,425,0,864,203,11096,804,11900,-0.0582043,0.255366,-0.965091,2
4637,3129,31,383,0,922,244,9346,644,9990,-0.0503471,0.252059,-0.966401,2
5957,3090,31,364,0,744,207,10393,3007,13400,0.0164028,0.117951,-0.992884,2
5168,3328,31,363,0,760,202,9852,2129,11981,0.010815,0.125108,-0.992084,2
5162,3559,35,440,0,872,236,10304,2336,12640,0.0163508,0.129756,-0.991411,2
5710,2579,24,274,0,586,153,9326,1637,10963,0.0267027,0.130177,-0.991131,2
2623,1366,14,163,0,338,105,4609,924,5533,0.0187882,0.128313,-0.991556,2
2670,1889,19,220,0,452,122,5372,1560,6932,0.0133762,0.124571,-0.992121,2
4946,3039,30,360,0,749,204,9328,2066,11394,0.0101953,0.124252,-0.992198,2
5075,3304,31,371,0,781,207,9769,1854,11623,0.0100442,0.12165,-0.992522,2
4649,3196,32,412,0,803,214,9306,2125,11431,0.0135922,0.120721,-0.992593,2
4845,3157,30,397,0,761,209,9399,2336,11735,0.0132099,0.117259,-0.993013,2
5956,3481,41,463,0,967,280,11188,2395,13583,0.0167253,0.118758,-0.992782,2
5226,3597,37,418,0,1101,240,10619,2429,13048,0.0133247,0.123788,-0.992219,2
2832,1742,16,257,0,486,120,5453,1007,6460,0.0114442,0.118174,-0.992927,2
1687,1158,11,135,0,285,76,3352,863,4215,0.012485,0.118594,-0.992865,2
5183,3571,37,452,0,978,290,10511,2467,12978,0.0108171,0.121495,-0.992533,2
4736,3321,32,373,0,785,207,9454,2136,11590,0.016577,0.120349,-0.992593,2
5069,3535,35,411,0,907,268,10225,2375,12600,0.0108854,0.121624,-0.992516,2
5353,3596,38,440,0,855,264,10546,2480,13026,0.0122213,0.119216,-0.992793,2
5133,3545,33,429,0,862,233,10235,2429,12664,0.00681786,0.118197,-0.992967,2
4556,3239,35,369,0,759,204,9162,2092,11254,0.00933001,0.119249,-0.992821,2
5194,3662,50,418,0,864,273,10461,2522,12983,0.0131743,0.117914,-0.992937,2
5214,3770,33,420,0,857,231,10525,2526,13051,0.0141029,0.120745,-0.992583,2
6002,3483,36,431,0,865,253,11070,2605,13675,0.0125903,0.119079,-0.992805,2
5583,3697,36,432,0,919,269,10936,2631,13567,0.0112979,0.117493,-0.99301,2
4836,3346,30,374,0,789,239,9614,2364,11978,0.0114645,0.116311,-0.993147,2
4606,3226,31,366,0,796,210,9235,2609,11844,0.0106026,0.116903,-0.993087,2
7226,4206,32,376,0,763,233,12836,2239,15075,0.0120861,0.116537,-0.993113,2
3249,2199,22,252,0,548,145,6415,1626,8041,0.0109101,0.119902,-0.992726,2
4897,3278,32,372,0,808,208,9595,2474,12069,0.0115451,0.122627,-0.992386,2
4734,3340,35,371,0,808,235,9523,2089,11612,0.0143829,0.121779,-0.992453,2
4584,3069,34,375,0,775,205,9042,2178,11220,0.0126901,0.118172,-0.992912,2
6207,3498,38,413,0,853,250,11259,2257,13516,0.0142952,0.117142,-0.993012,2
4766,3101,33,394,0,790,206,9290,2405,11695,0.0117739,0.119259,-0.992794,2
5054,3292,32,366,0,757,203,9704,2298,12002,0.0109494,0.116315,-0.993152,2
4525,3157,46,370,0,801,207,9106,2188,11294,0.011992,0.115978,-0.993179,2
4640,3139,32,366,0,773,206,9156,2251,11407,0.00817318,0.116976,-0.993101,2
5476,3128,33,366,0,786,208,9997,2038,12035,0.0128939,0.116226,-0.993139,2
4553,3064,31,380,0,785,204,9017,2228,11245,0.01337,0.116118,-0.993145,2
5435,3097,38,394,0,763,205,9932,2317,12249,0.0108895,0.115953,-0.993195,2
4552,3367,39,403,0,826,210,9397,2387,11784,0.008932,0.114475,-0.993386,2
4725,3058,31,373,0,795,208,9190,2361,11551,0.0105454,0.112811,-0.993561,2
5247,3525,38,416,0,863,231,10320,2623,12943,0.0104103,0.112109,-0.993641,2
5129,3480,38,411,0,868,251,10177,2794,12971,0.0129136,0.115175,-0.993261,2
5125,3130,32,365,0,770,224,9646,2231,11877,0.0156643,0.116794,-0.993033,2
4552,3111,35,361,0,759,202,9020,1766,10786,0.013152,0.114402,-0.993348,2
4664,3228,32,370,0,836,211,9341,2045,11386,0.0185794,0.117553,-0.992893,2
5309,3544,36,411,0,892,230,10422,2430,12852,0.00940882,0.116551,-0.99314,2
4624,3085,32,364,0,761,204,9070,2084,11154,0.00798356,0.116356,-0.993175,2
5144,3515,58,410,0,935,237,10299,2357,12656,0.00764891,0.115838,-0.993239,2
5130,3700,41,455,0,910,233,10469,2492,12961,0.00854926,0.115936,-0.99322,2
4733,3080,40,389,0,769,204,9215,2115,11330,0.0118819,0.115961,-0.993182,2
5027,3707,43,367,0,771,204,10119,2208,12327,0.0115659,0.113572,-0.993462,2
5105,3248,40,367,0,774,235,9769,2532,12301,0.00583404,0.114211,-0.99344,2
4826,3087,32,397,0,759,207,9308,2150,11458,0.00774863,0.114723,-0.993367,2
4942,3346,32,369,0,819,264,9772,2622,12394,0.00679907,0.115529,-0.993281,2
4717,3096,32,388,0,840,215,9288,2264,11552,0.00750728,0.116409,-0.993173,2
4672,3094,34,360,0,913,299,9372,1986,11358,0.015078,0.119988,-0.992661,2
4850,3039,31,365,0,764,203,9252,2050,11302,0.0085377,0.118896,-0.99287,2
4550,3771,33,369,0,768,203,9694,1876,11570,0.0140317,0.119451,-0.992741,2
4601,3012,34,363,0,766,207,8983,2180,11163,0.0117485,0.117341,-0.993022,2
5118,3406,37,410,0,853,226,10050,2294,12344,0.012441,0.116853,-0.993071,2
5278,3400,33,364,0,814,208,10097,2153,12250,0.0119709,0.116966,-0.993064,2
5464,3444,37,413,0,860,227,10445,2370,12815,0.0135124,0.117714,-0.992956,2
5160,3224,31,358,0,877,228,9878,2380,12258,0.010522,0.116907,-0.993087,2
4666,3042,33,361,0,763,201,9066,1959,11025,0.010104,0.114852,-0.993331,2
5620,3709,38,423,0,761,203,10754,1969,12723,0.0162447,0.11527,-0.993201,3
4689,3151,31,369,0,764,202,9206,2162,11368,0.00980305,0.110671,-0.993809,3
5418,3471,34,414,0,920,230,10487,2733,13220,0.00569605,0.112385,-0.993649,3
5222,3409,36,443,0,913,231,10254,2225,12479,0.00848095,0.115126,-0.993315,3
5355,3511,36,425,0,934,233,10494,2280,12774,0.0102333,0.118305,-0.992925,3
5251,3554,43,434,0,863,233,10378,1855,12233,0.0132401,0.121796,-0.992467,3
4728,3183,32,366,0,794,206,9309,1837,11146,0.0138903,0.124601,-0.99211,3
4790,3052,31,387,0,1061,210,9531,1563,11094,0.00789036,0.126585,-0.991924,3
4704,3184,36,367,0,808,205,9304,972,10276,0.00934718,0.125118,-0.992098,3
5441,3635,35,417,0,984,279,10791,1311,12102,0.0152804,0.127157,-0.991765,3
5601,3507,32,414,0,909,240,10703,1814,12517,0.0126043,0.126579,-0.991877,3
4252,2646,30,326,0,770,187,8211,1136,9347,0.0152167,0.12962,-0.991447,3
6213,3484,35,410,0,921,251,11314,1320,12634,0.0130298,0.128717,-0.991596,3
5224,3415,36,437,0,917,259,10288,1162,11450,0.0170481,0.128162,-0.991607,3
5394,3428,36,410,0,877,229,10374,1525,11899,0.0158168,0.125146,-0.992012,3
5268,3361,36,440,0,879,250,10234,1474,11708,0.0111161,0.120478,-0.992654,3
5585,3008,31,365,0,775,203,9967,1011,10978,0.0112322,0.12174,-0.992498,3
5930,3477,37,414,0,863,250,10971,1099,12070,0.0137274,0.120518,-0.992616,3
5616,3524,35,461,0,891,230,10757,1474,12231,0.0140868,0.119052,-0.992788,3
3741,2261,25,320,0,571,151,7069,1059,8128,0.0164633,0.117417,-0.992946,3
4838,3054,33,363,0,817,226,9331,1746,11077,0.016082,0.119362,-0.992721,3
5353,3416,40,418,0,919,234,10380,1707,12087,0.0154021,0.121756,-0.992441,3
5358,3432,37,432,0,878,236,10373,1423,11796,0.0148793,0.1221,-0.992406,3
5297,3349,37,439,0,874,230,10226,1233,11459,0.01827,0.124569,-0.992043,3
5392,3476,39,415,0,899,231,10452,1533,11985,0.0158042,0.129119,-0.991503,3
5405,3372,54,406,0,884,225,10346,893,11239,0.0154308,0.128179,-0.991631,3
4973,2894,33,353,0,847,202,9302,757,10059,0.0161404,0.124526,-0.992085,3
4840,2929,32,344,0,719,188,9052,848,9900,0.0170392,0.12472,-0.992046,3
5349,3102,33,376,0,844,188,9892,744,10636,0.0210365,0.121493,-0.99237,3
5518,3279,36,385,0,822,213,10253,1470,11723,0.0138949,0.115897,-0.993164,3
5433,3133,37,419,0,829,219,10070,1073,11143,0.0136812,0.114402,-0.99334,3
3778,1762,20,241,0,497,112,6410,488,6898,0.0173532,0.11345,-0.993392,3
1536,907,12,112,0,236,61,2864,445,3309,0.0161961,0.11268,-0.9935,3
4895,3019,32,383,0,739,197,9265,1302,10567,0.0124394,0.113213,-0.993493,3
4979,2914,33,449,0,766,200,9341,1047,10388,0.0137722,0.113187,-0.993478,3
5079,2916,32,350,0,745,195,9317,1196,10513,0.0126663,0.114958,-0.993289,3
4819,2912,31,355,0,745,196,9058,1025,10083,0.0147517,0.116792,-0.993046,3
4870,3245,34,380,0,758,198,9485,984,10469,0.0212364,0.119892,-0.99256,3
4864,2895,33,350,0,737,225,9104,1210,10314,0.0236616,0.122803,-0.992149,3
4825,2871,37,386,0,815,193,9127,1130,10257,0.0213602,0.122315,-0.992262,3
4842,2969,33,356,0,772,199,9171,997,10168,0.0248534,0.124958,-0.991851,3
2549,1554,18,189,0,389,115,4814,529,5343,0.0221889,0.127075,-0.991645,3
4887,2929,47,353,0,741,213,9170,781,9951,0.0195712,0.131512,-0.991121,3
4944,2977,32,365,0,750,200,9268,512,9780,0.0172949,0.125506,-0.991942,3
4952,2991,31,359,0,739,196,9268,458,9726,0.0160992,0.124996,-0.992027,3
4903,2955,32,359,0,754,206,9209,467,9676,0.0147137,0.130522,-0.991337,3
4921,2953,33,374,0,749,237,9267,382,9649,0.0204692,0.138253,-0.990185,3
4973,2995,32,361,0,743,206,9310,335,9645,0.0221538,0.139343,-0.989996,3
4992,2933,32,362,0,736,197,9252,343,9595,0.0262006,0.111429,-0.993427,3
4926,2892,37,356,0,769,197,9177,1183,10360,0.0229838,0.109528,-0.993718,3
4863,2914,31,349,0,730,193,9080,1267,10347,0.0217671,0.109169,-0.993785,3
4906,2891,32,352,0,729,192,9102,1281,10383,0.0201708,0.108016,-0.993944,3
4953,2906,33,352,0,755,196,9195,1193,10388,0.0157861,0.106487,-0.994189,3
5600,3005,33,369,0,728,195,9930,1042,10972,0.0166855,0.106706,-0.99415,3
4941,3006,37,356,0,775,198,9313,1062,10375,0.0179637,0.111292,-0.993626,3
4898,3012,32,358,0,842,234,9376,976,10352,0.0159859,0.114165,-0.993333,3
5548,2987,33,356,0,781,211,9916,828,10744,0.0143414,0.121257,-0.992518,3
4964,2947,32,361,0,761,198,9263,423,9686,0.0152139,0.14138,-0.989839,3
5186,3174,34,375,0,770,233,9772,326,10098,0.0107727,0.174346,-0.984625,3
5011,3141,39,511,0,1074,227,10003,4196,14199,-0.014744,0.156417,-0.987581,3
5051,3339,32,409,0,842,225,9898,3727,13625,-0.0150299,0.157789,-0.987358,3
3488,2535,25,287,0,562,154,7051,3327,10378,-0.00952754,0.157647,-0.987449,3
4523,2972,29,345,0,749,198,8816,4102,12918,-0.00655228,0.174127,-0.984701,3
5013,3277,33,404,0,810,215,9752,5093,14845,-0.000680896,0.175358,-0.984505,3
3325,1933,22,231,0,487,130,6128,4027,10155,-0.000282764,0.171734,-0.985143,3
5127,2684,38,334,0,633,174,8990,5439,14429,-0.0276454,0.234546,-0.971712,3
4522,2291,31,281,0,587,154,7866,358,8224,-0.033642,0.317896,-0.947528,3
4315,1848,28,226,0,436,148,7001,777,7778,-0.0427043,0.328862,-0.943412,3
4250,1395,27,184,0,382,102,6340,504,6844,-0.0574235,0.467636,-0.882054,3
4274,1177,26,159,0,298,108,6042,583,6625,-0.0274672,0.406859,-0.913078,3
4258,997,28,137,0,252,69,5741,412,6153,-0.023212,0.350187,-0.936392,3
3819,738,25,104,0,201,54,4941,761,5702,-0.00588583,0.29256,-0.956229,3
4625,787,29,114,0,210,56,5821,1075,6896,0.0218473,0.289959,-0.95679,3
4739,776,26,113,0,219,58,5931,1371,7302,0.0246746,0.277473,-0.960417,3
4793,732,26,106,0,215,56,5928,1666,7594,0.0186191,0.22378,-0.974462,3
4837,681,27,105,0,204,56,5910,2135,8045,0.00463758,0.22469,-0.974419,3
4618,683,26,103,0,204,55,5689,2340,8029,-0.00300096,0.210346,-0.977622,3
4978,663,26,106,0,205,55,6033,2324,8357,-0.020184,0.223265,-0.974549,3
4596,686,28,106,0,209,58,5683,2521,8204,-0.0233641,0.214281,-0.976492,3
4716,675,27,103,0,217,57,5795,2811,8606,-0.0163499,0.20407,-0.97882,3
4615,673,47,118,0,229,59,5741,2389,8130,-0.0136766,0.203265,-0.979028,3
4244,572,27,93,0,183,50,5169,2723,7892,-0.0121035,0.203991,-0.978898,3
4082,490,24,80,0,154,42,4872,2255,7127,-0.0430012,0.22461,-0.9735,3
4761,617,29,104,0,195,54,5760,2882,8642,-0.0803653,0.302992,-0.949599,3
3374,385,18,64,0,120,33,3994,1640,5634,-0.0619125,0.250199,-0.966213,3
2196,337,15,52,0,98,27,2725,1089,3814,-0.0462652,0.198427,-0.979023,3
4168,1001,28,136,0,255,72,5660,1561,7221,-0.0744329,0.301525,-0.950549,3
5201,2090,30,234,0,455,126,8136,1149,9285,-0.0428992,0.215464,-0.975569,3
4748,2696,40,319,0,654,184,8641,2691,11332,-0.0437147,0.254269,-0.966145,3
3540,2358,21,292,0,572,156,6939,1668,8607,-0.0170048,0.172961,-0.984782,3
5766,3931,30,442,0,947,255,11371,4171,15542,-0.00959858,0.184917,-0.982707,3
3741,3023,21,345,0,751,198,8079,3738,11817,0.00224155,0.151188,-0.988503,3
5791,4610,31,518,0,1120,296,12366,5014,17380,0.0143405,0.147622,-0.98894,3
3964,3101,21,355,0,776,204,8421,3712,12133,0.0121617,0.142327,-0.989745,3
5823,4454,30,513,0,1121,293,12234,5399,17633,-0.0175245,0.136253,-0.990519,3
6120,3961,25,466,0,1049,239,11860,3549,15409,-0.0316013,0.135188,-0.990316,3
2618,1902,14,217,0,497,127,5375,2548,7923,-0.0323933,0.12804,-0.99124,3
6277,4486,30,522,0,1145,298,12758,5897,18655,-0.0411715,0.136005,-0.989852,3
4208,3200,18,362,0,817,212,8817,4645,13462,-0.0382798,0.13596,-0.989974,3
5477,4362,25,489,0,1075,277,11705,4582,16287,-0.0335624,0.126269,-0.991428,3
2961,2281,13,251,0,608,146,6260,3776,10036,-0.0233497,0.107653,-0.993914,3
5930,4239,28,474,0,1071,277,12019,7355,19374,-0.022894,0.120786,-0.992415,3
3216,2051,14,233,0,536,137,6187,3994,10181,-0.0191565,0.102678,-0.99453,3
5504,3813,36,641,0,1199,314,11507,6957,18464,-0.00674372,0.123316,-0.992345,3
3756,2292,29,264,0,593,163,7097,3923,11020,-0.0100068,0.111707,-0.993691,3
5523,2981,29,349,0,761,226,9869,5595,15464,-0.0165713,0.147102,-0.988982,3
3465,1796,20,217,0,463,122,6083,3066,9149,-0.0207888,0.142921,-0.989516,3
4850,2336,29,280,0,699,164,8358,4317,12675,-0.0287096,0.150809,-0.988146,3
4665,1969,29,244,0,533,138,7578,4198,11776,-0.0188208,0.13421,-0.990774,3
4102,1463,24,187,0,416,107,6299,3231,9530,-0.0204097,0.152882,-0.988034,3
4240,1450,27,182,0,390,103,6392,3001,9393,-0.02135,0.17683,-0.98401,3
4091,1270,31,168,0,347,93,6000,3219,9219,-0.020032,0.184606,-0.982608,3
4177,1208,24,161,0,325,87,5982,2784,8766,-0.0236761,0.208199,-0.9778,3
3753,1116,25,150,0,308,85,5437,2741,8178,-0.0267079,0.219471,-0.975253,3
3744,1093,23,153,0,302,83,5398,2442,7840,-0.0257446,0.233303,-0.972063,3
3860,1137,23,152,0,319,104,5595,2711,8306,-0.0213238,0.243326,-0.96971,3
3894,1136,23,156,0,304,84,5597,2052,7649,-0.0269207,0.232011,-0.972341,3
3853,1251,26,173,0,349,92,5744,2241,7985,-0.0383297,0.247595,-0.968105,3
3846,1433,28,179,0,354,97,5937,1737,7674,-0.0578228,0.285674,-0.956581,3
4027,1569,24,196,0,389,106,6311,1396,7707,-0.0620913,0.299076,-0.952207,3
3858,1767,24,214,0,433,133,6429,1024,7453,-0.0660108,0.332452,-0.940807,3
6478,2376,30,272,0,536,146,9838,915,10753,-0.0361682,0.385406,-0.922038,3
4923,3024,30,345,0,651,180,9153,772,9925,-0.0126538,0.37015,-0.928886,3
4993,3049,33,350,0,874,202,9501,1062,10563,0.00214669,0.346423,-0.938076,3
4967,3244,35,368,0,775,240,9629,1886,11515,-0.0201615,0.4175,-0.908454,3
5056,3511,53,466,0,789,212,10087,1116,11203,0.00299781,0.345902,-0.938266,3
3456,2248,24,262,0,643,157,6790,1434,8224,-0.00347724,0.368757,-0.929519,3
4432,2869,32,309,0,684,168,8494,1690,10184,-0.0192538,0.3296,-0.943924,3
4201,2181,33,283,0,535,160,7393,1129,8522,-0.00362104,0.31658,-0.948559,3
4097,1818,28,215,0,431,144,6733,816,7549,-0.0050467,0.34728,-0.937748,3
3859,1515,25,180,0,360,96,6035,939,6974,0.00185735,0.28476,-0.958597,3
4339,1289,29,174,0,342,93,6266,908,7174,-0.0202271,0.335133,-0.941954,3
4266,1121,27,140,0,298,76,5928,1028,6956,-0.0515598,0.250662,-0.966701,3
4374,632,28,99,0,178,49,5360,1428,6788,-0.0670886,0.250645,-0.965752,3
4589,625,27,97,0,178,49,5565,1487,7052,-0.0572163,0.221245,-0.973539,3
4673,723,26,106,0,203,55,5786,1648,7434,-0.0376497,0.21665,-0.975523,3
4518,719,27,106,0,202,56,5628,1810,7438,-0.0156277,0.210562,-0.977456,3
4522,719,27,106,0,198,55,5627,1866,7493,0.00409447,0.21379,-0.976871,3
4592,772,27,114,0,215,60,5780,1873,7653,0.00403997,0.224522,-0.974461,3
3018,547,18,78,0,168,43,3872,1534,5406,-0.00675456,0.22615,-0.974069,3
4306,867,28,119,0,273,70,5663,2059,7722,-0.0217875,0.231007,-0.972708,3
4564,802,27,143,0,224,64,5824,2251,8075,-0.0377465,0.230795,-0.97227,3
4406,912,28,147,0,233,82,5808,2629,8437,-0.055533,0.23304,-0.97088,3
4359,920,30,126,0,240,67,5742,2578,8320,-0.0536315,0.226142,-0.972617,3
4320,993,26,136,0,267,74,5816,3228,9044,-0.0457458,0.214336,-0.975688,3
4548,1219,29,191,0,319,90,6396,2614,9010,-0.0331495,0.214083,-0.976253,3
5574,1655,28,202,0,406,109,7974,2162,10136,-0.032071,0.229111,-0.972872,3
4868,2030,25,247,0,520,136,7826,1929,9755,-0.0351331,0.217081,-0.975521,3
5030,2702,27,307,0,705,190,8961,1603,10564,-0.0262751,0.200586,-0.979324,3
5721,3722,29,408,0,903,229,11012,1746,12758,-0.0202459,0.184133,-0.982693,3
5902,4433,37,490,0,1093,289,12244,2594,14838,-0.0252078,0.185836,-0.982257,3
6297,4883,28,569,0,1203,311,13291,2973,16264,-0.0165537,0.177513,-0.983979,3
3376,2709,15,309,0,704,179,7292,2712,10004,-0.0102199,0.157765,-0.987424,3
6531,5225,28,575,0,1264,326,13949,3932,17881,0.00837195,0.213832,-0.976835,3
3116,2208,15,245,0,548,142,6274,3013,9287,0.00822127,0.163207,-0.986558,3
5422,3077,28,356,0,802,207,9892,6111,16003,0.00580331,0.193302,-0.981122,3
3661,1726,20,206,0,458,118,6189,4562,10751,-0.000660596,0.185987,-0.982552,3
4107,1743,22,211,0,468,140,6691,4343,11034,-0.0163451,0.174233,-0.984569,3
4984,2016,30,244,0,546,163,7983,5111,13094,-0.0299716,0.170599,-0.984885,3
4771,1822,30,255,0,479,127,7484,4009,11493,-0.0397672,0.180421,-0.982785,3
3240,1086,20,162,0,339,89,4936,2805,7741,-0.0418592,0.176116,-0.983479,3
4363,1532,35,205,0,400,107,6642,3972,10614,-0.0486288,0.179879,-0.982486,3
4402,1397,26,180,0,378,102,6485,3069,9554,-0.0514933,0.188565,-0.98071,3
4085,1497,28,230,0,387,103,6330,2938,9268,-0.0389308,0.212332,-0.976422,3
3952,1294,23,169,0,351,95,5884,2763,8647,-0.0332811,0.255236,-0.966306,3
3860,1301,24,169,0,342,93,5789,2474,8263,-0.0401383,0.243358,-0.969106,3
3821,1253,28,165,0,337,93,5697,2064,7761,-0.0622205,0.259842,-0.963645,3
3830,1338,24,174,0,356,96,5818,1898,7716,-0.0667994,0.234261,-0.969876,3
3882,1430,25,184,0,372,100,5993,1622,7615,-0.10073,0.266173,-0.958648,3
4272,1534,24,198,0,402,110,6540,1665,8205,-0.112615,0.270577,-0.956089,3
3978,1796,27,232,0,458,124,6615,1532,8147,-0.118155,0.295923,-0.947876,3
4182,2257,29,265,0,534,146,7413,1327,8740,-0.106523,0.29329,-0.950071,3
4465,2623,31,360,0,629,204,8312,1037,9349,-0.0791625,0.308985,-0.947767,3
4728,3234,34,449,0,938,206,9589,1643,11232,-0.0445737,0.403238,-0.914009,3
4989,3421,33,438,0,900,228,10009,1736,11745,-0.0302506,0.353586,-0.934913,3
3625,2378,23,293,0,630,160,7109,1329,8438,-0.0214758,0.328873,-0.94413,3
3340,2161,22,279,0,509,141,6452,1323,7775,-0.00827817,0.286117,-0.958159,3
4402,2196,30,253,0,498,138,7517,1083,8600,-0.0230785,0.298804,-0.954035,3
4913,1337,46,159,0,296,96,6847,972,7819,-0.0532638,0.481373,-0.874896,3
4279,812,27,113,0,213,60,5504,602,6106,-0.0544418,0.406754,-0.911914,3
3000,470,18,70,0,132,36,3726,657,4383,-0.0179996,0.267521,-0.963384,3
4600,684,36,121,0,216,57,5714,1026,6740,-0.0453517,0.263788,-0.963514,3
4920,655,28,107,0,185,51,5946,1451,7397,-0.0385402,0.269521,-0.962223,3
4896,660,25,100,0,194,52,5927,1755,7682,-0.0186327,0.236024,-0.971569,3
4759,560,26,90,0,171,55,5661,1948,7609,-0.00786509,0.237776,-0.971288,3
4537,509,26,81,0,156,43,5352,1827,7179,0.00287166,0.237765,-0.971318,3
4334,440,26,74,0,142,50,5066,1821,6887,-0.00640616,0.22963,-0.973257,3
4358,351,29,67,0,115,34,4954,1755,6709,0.00326693,0.197518,-0.980294,3
4315,282,28,67,0,111,29,4832,1831,6663,0.00260884,0.199335,-0.979928,3
4092,207,27,55,0,67,21,4469,1561,6030,0.0088805,0.186464,-0.982422,3
4013,212,26,44,0,64,20,4379,1520,5899,0.0205859,0.211908,-0.977073,3
4021,307,27,61,0,92,29,4537,1585,6122,0.0231365,0.198845,-0.979758,3
4147,511,28,84,0,147,42,4959,1515,6474,0.0239073,0.178241,-0.983696,3
4153,825,27,118,0,223,62,5408,1978,7386,0.0152238,0.17441,-0.984556,3
4480,1145,28,157,0,327,88,6225,1959,8184,-0.0103667,0.20273,-0.97918,3
4552,1599,28,205,0,400,109,6893,1990,8883,-0.00238548,0.184843,-0.982765,3
2571,975,14,119,0,247,66,3992,743,4735,-0.00859622,0.151424,-0.988432,3
2811,1353,17,161,0,341,90,4773,675,5448,0.0415169,0.101861,-0.993932,3
4972,2848,28,334,0,714,188,9084,3183,12267,0.00985642,0.15182,-0.988359,3
5496,3750,27,421,0,914,237,10845,1792,12637,0.036619,0.141954,-0.989196,3
3992,3077,20,349,0,742,195,8375,2070,10445,0.0396749,0.129041,-0.990845,3
6098,4955,30,635,0,1197,315,13230,3944,17174,0.0369451,0.143713,-0.988929,3
4333,3512,20,404,0,866,229,9364,3028,12392,0.0338483,0.122657,-0.991872,3
5051,4085,24,459,0,1048,292,10959,4433,15392,0.0182633,0.127561,-0.991663,3
5967,4584,29,530,0,1277,455,12842,5350,18192,-0.0440758,0.196883,-0.979436,3
2904,1515,11,173,0,390,102,5095,2544,7639,-0.0129007,0.127559,-0.991747,3
1883,961,11,116,0,256,66,3293,2079,5372,0.00331216,0.0834975,-0.996502,3
5114,2133,28,260,0,649,156,8340,4883,13223,-0.00119972,0.132044,-0.991243,3
5003,1903,30,235,0,503,132,7806,4350,12156,-0.00925509,0.133247,-0.99104,3
4941,1798,29,221,0,467,123,7579,4108,11687,-0.0105087,0.131822,-0.991218,3
4873,1539,28,202,0,427,114,7183,3339,10522,-0.0297565,0.321614,-0.946403,3
4208,993,19,128,0,272,71,5691,2299,7990,-0.0186287,0.226078,-0.973931,3
4401,1322,26,192,0,366,97,6404,2757,9161,-0.0288401,0.227153,-0.973432,3
4134,1177,26,156,0,310,83,5886,2062,7948,-0.039433,0.241753,-0.969536,3
3809,865,25,120,0,232,65,5116,1839,6955,-0.0475917,0.261709,-0.963973,3
3734,825,24,118,0,228,66,4995,1752,6747,-0.049266,0.26943,-0.961759,3
4501,1018,24,147,0,266,75,6031,1683,7714,-0.050271,0.303145,-0.951617,3
3698,1225,24,160,0,318,89,5514,1762,7276,-0.0450202,0.296402,-0.954002,3
4362,1518,25,200,0,367,102,6574,1646,8220,-0.0399859,0.424164,-0.904702,3
4007,1848,40,335,0,657,186,7073,1748,8821,-0.0166608,0.419537,-0.907585,3
4357,2189,19,184,0,392,103,7244,877,8121,-0.0159424,0.348729,-0.937088,3
4427,2854,32,342,0,668,182,8505,1649,10154,-0.00141607,0.4147,-0.909957,3
4591,3257,34,375,0,804,213,9274,1864,11138,0.0067855,0.343212,-0.939233,3
3282,2278,22,268,0,571,149,6570,1602,8172,0.0108365,0.284328,-0.958666,3
4828,3598,37,456,0,1225,239,10383,2135,12518,0.0106256,0.258934,-0.965837,3
5538,3676,36,463,0,922,243,10878,2259,13137,0.0109778,0.227856,-0.973633,3
5093,3797,34,435,0,935,243,10537,2225,12762,0.00780306,0.211364,-0.977376,3
5107,3815,35,440,0,929,241,10567,2264,12831,0.000574079,0.193685,-0.981064,3
5165,3937,35,493,0,950,272,10852,2422,13274,-0.00324142,0.179387,-0.983773,3
4748,3653,30,440,0,874,232,9977,2139,12116,-0.00515385,0.166612,-0.986009,3
4739,3551,40,403,0,860,225,9818,1871,11689,-0.00254177,0.159071,-0.987264,3
5220,4084,33,464,0,1002,257,11060,2400,13460,-0.00686048,0.153161,-0.988178,3
5217,4289,43,501,0,974,256,11280,2234,13514,-0.00117364,0.141805,-0.989894,3
3626,2543,17,255,0,545,140,7126,1017,8143,0.0103492,0.132073,-0.991186,3
2131,1551,12,171,0,364,95,4324,142,4466,0.0141064,0.125971,-0.991933,3
2733,2286,18,275,0,541,146,5999,2465,8464,0.0412405,0.0996195,-0.994171,3
5276,4364,34,560,0,1033,283,11550,4715,16265,0.0357973,0.102411,-0.994098,3
5181,4413,34,488,0,962,192,11270,3203,14473,0.0419097,0.0908014,-0.994987,3
2761,2291,18,258,0,545,155,6028,2500,8528,0.0406234,0.103779,-0.993771,3
5170,4401,34,491,0,1023,284,11403,4642,16045,0.0417773,0.0950644,-0.994594,3
5236,4252,22,354,0,712,191,10767,3244,14011,0.0329993,0.110868,-0.993287,3
2740,2305,18,256,0,541,145,6005,2417,8422,0.0373307,0.107361,-0.993519,3
5196,4384,33,496,0,1095,282,11486,4568,16054,0.0420791,0.116816,-0.992262,3
5243,4520,38,487,0,1043,276,11607,3875,15482,0.0435865,0.108114,-0.993183,3
3535,2919,22,332,0,720,190,7718,3154,10872,0.0367888,0.104048,-0.993892,3
5192,4411,33,487,0,1034,275,11432,4481,15913,0.0411922,0.101297,-0.994003,3
3537,3008,23,360,0,707,191,7826,3190,11016,0.0334233,0.119501,-0.992271,3
5385,4261,35,513,0,1069,295,11558,4512,16070,0.0352033,0.109426,-0.993371,3
5267,4488,34,490,0,1026,276,11581,4166,15747,0.0432508,0.108677,-0.993136,3
2756,2242,17,255,0,543,147,5960,2507,8467,0.0419,0.110491,-0.992994,3
5330,4413,35,490,0,1052,279,11599,4565,16164,0.0406541,0.108158,-0.993302,3
3607,2971,25,333,0,706,189,7831,3171,11002,0.0408192,0.10525,-0.993608,3
5291,4377,34,487,0,1024,274,11487,5014,16501,0.047617,0.0992883,-0.993919,3
4737,3870,32,434,0,911,247,10231,3783,14014,0.0498547,0.112034,-0.992453,3
3311,2825,28,313,0,694,178,7349,3007,10356,0.0475211,0.114739,-0.992259,3
5261,4378,32,485,0,1011,272,11439,4808,16247,0.0420798,0.125783,-0.991165,3
3557,2984,22,328,0,698,206,7795,3127,10922,0.044379,0.116335,-0.992218,3
5357,4226,34,479,0,1008,271,11375,4995,16370,0.0315897,0.11889,-0.992405,3
5378,4329,38,540,0,1074,228,11587,3277,14864,0.0397637,0.110943,-0.993031,3
2717,2237,18,254,0,533,143,5902,2300,8202,0.038505,0.111286,-0.993042,3
5256,4365,34,479,0,1010,274,11418,4653,16071,0.0469817,0.0976568,-0.994111,3
3540,3179,24,330,0,696,187,7956,3121,11077,0.0357995,0.101821,-0.994158,3
5147,4168,35,473,0,1025,272,11120,4398,15518,0.0263652,0.112081,-0.993349,3
5269,4347,35,483,0,1011,305,11450,4192,15642,0.0365848,0.118638,-0.992263,3
5246,4296,35,479,0,1105,278,11439,4396,15835,0.0502856,0.123109,-0.991118,3
4673,2968,23,340,0,631,147,8782,2437,11219,0.0440808,0.12165,-0.991594,3
2093,1499,11,170,0,363,97,4233,1638,5871,0.0359932,0.125645,-0.991422,3
1758,1426,12,160,0,348,92,3796,1523,5319,0.0407992,0.11332,-0.992721,3
5244,4278,33,533,0,1038,277,11403,4665,16068,0.0466695,0.0932491,-0.994548,3
5269,4196,35,479,0,1064,275,11318,3572,14890,0.0344496,0.107166,-0.993644,3
3647,2916,24,326,0,684,184,7781,3063,10844,0.0324579,0.108463,-0.99357,3
5157,4269,34,480,0,1000,270,11210,4621,15831,0.0352197,0.109457,-0.993367,3
5278,4317,34,479,0,1025,271,11404,3494,14898,0.0301049,0.120526,-0.992254,3
2759,2249,18,251,0,532,147,5956,2452,8408,0.038264,0.112556,-0.992909,3
5139,4289,34,507,0,998,270,11237,4357,15594,0.0324032,0.114498,-0.992895,3
5219,4278,35,484,0,1180,278,11474,4360,15834,0.0346597,0.120683,-0.992086,3
3622,2931,25,356,0,713,190,7837,3073,10910,0.0354406,0.114464,-0.992795,3
4705,3804,31,430,0,1009,277,10256,4206,14462,0.0439139,0.108493,-0.993127,3
5242,4299,36,480,0,1115,317,11489,4693,16182,0.0458521,0.103952,-0.993525,3
3600,2927,23,379,0,730,191,7850,3161,11011,0.0289679,0.113027,-0.993169,3
4750,3857,31,443,0,1002,271,10354,4045,14399,0.0422202,0.11319,-0.992676,3
3287,2712,22,304,0,869,190,7384,3189,10573,0.0311472,0.118254,-0.992495,3
5288,4487,34,475,0,1040,273,11597,5188,16785,0.0320237,0.11928,-0.992344,3
3617,2958,24,337,0,691,194,7821,3147,10968,0.0430921,0.109376,-0.993066,3
4691,3817,30,426,0,914,243,10121,4076,14197,0.0340568,0.123655,-0.99174,3
4714,3770,30,441,0,917,244,10116,4039,14155,0.0311869,0.124222,-0.991764,3
3331,2702,22,322,0,690,175,7242,2975,10217,0.0428907,0.112264,-0.992752,3
4264,3452,27,391,0,833,222,9189,3474,12663,0.0380975,0.107235,-0.993503,3
5228,4140,31,478,0,1070,275,11222,4213,15435,0.0387398,0.105418,-0.993673,3
5134,4219,33,477,0,997,269,11129,3732,14861,0.0424291,0.106295,-0.993429,3
4692,3925,31,429,0,993,250,10320,3979,14299,0.0358914,0.10641,-0.993674,3
4966,3880,30,431,0,902,266,10475,3532,14007,0.0390948,0.113783,-0.992736,3
2649,2109,17,236,0,496,133,5640,2200,7840,0.040597,0.107526,-0.993373,3
4850,4098,32,450,0,906,289,10625,3998,14623,0.0372644,0.112892,-0.992908,3
4617,3733,28,425,0,898,243,9944,4159,14103,0.0359808,0.111319,-0.993133,3
5305,4233,33,477,0,1016,271,11335,4298,15633,0.0356631,0.110119,-0.993278,3
3562,2886,23,323,0,688,185,7667,3301,10968,0.0333999,0.118161,-0.992432,3
5239,4175,31,476,0,994,248,11163,4293,15456,0.033546,0.111995,-0.993143,3
4704,3889,32,433,0,898,242,10198,3007,13205,0.0347526,0.106449,-0.993711,3
2615,2078,17,249,0,496,135,5590,2241,7831,0.0393855,0.114038,-0.992695,3
5318,4162,32,488,0,1029,273,11302,4443,15745,0.034574,0.107139,-0.993643,3
5208,4229,40,503,0,1029,274,11283,3931,15214,0.0414915,0.102877,-0.993828,3
3563,2933,24,326,0,697,186,7729,3045,10774,0.0325264,0.115141,-0.992816,3
4758,3811,30,430,0,925,244,10198,3913,14111,0.0326733,0.113363,-0.993016,3
3285,2697,22,299,0,632,170,7105,2886,9991,0.0304946,0.113465,-0.993074,3
4787,3774,30,418,0,886,236,10131,4114,14245,0.0358048,0.109502,-0.993341,3
4561,3531,29,402,0,1134,314,9971,4301,14272,0.0314814,0.114795,-0.99289,3
3286,2559,21,289,0,635,168,6958,2898,9856,0.0322814,0.119691,-0.992286,3
4936,3567,31,409,0,926,244,10113,4082,14195,0.0342892,0.11293,-0.993011,3
5274,3905,29,510,0,995,263,10976,4373,15349,0.0375616,0.108162,-0.993423,3
5349,4081,33,466,0,1018,268,11215,3298,14513,0.0362902,0.116101,-0.992574,3
