Downsample[ns],BuildFilTree[ns],SearchFil[ns],DeleteFil[ns],BuildTreeSub[ns],SearchSub[ns],DeleteSub[ns],PreProcTotal[ns],Plane[ns],Total[ns],nx,ny,nz,planeCount
5060,3715,91,411,3227,47,226,12777,1551,14328,-0.0306877,0.0171776,-0.999381,0
4794,3246,41,386,3221,34,236,11958,1607,13565,-0.00948254,0.0239938,-0.999667,0
4169,2944,29,340,2915,33,194,10624,1406,12030,-0.0129662,0.0182668,-0.999749,0
4227,3186,30,342,2950,40,195,10970,1284,12254,-0.0231857,0.0160289,-0.999603,0
3086,2114,22,248,2045,21,135,7671,1081,8752,-0.0179961,0.0140481,-0.999739,0
4769,3301,34,382,3197,50,216,11949,1478,13427,-0.0107969,0.0123985,-0.999865,0
4985,3232,33,385,3175,33,233,12076,1452,13528,-0.0226232,0.0196827,-0.99955,0
3323,2248,24,265,2161,23,146,8190,1079,9269,-0.0246199,0.00735703,-0.99967,0
4837,3176,33,384,3206,42,232,11910,1459,13369,-0.0198028,0.0146727,-0.999697,0
3293,2724,24,317,2259,23,149,8789,1022,9811,-0.027857,0.0128578,-0.999529,0
4373,2898,31,344,2855,30,200,10731,1534,12265,-0.0153421,0.00791649,-0.999851,0
5503,3562,33,421,3483,36,220,13258,1528,14786,-0.0384455,0.0132185,-0.999173,0
3375,2278,22,263,2198,32,164,8332,1145,9477,-0.012862,0.0223072,-0.999668,0
4290,3116,30,366,2930,31,196,10959,1444,12403,-0.0221749,0.0228224,-0.999494,0
5527,3890,38,431,3643,50,220,13799,1538,15337,-0.0146235,0.0167843,-0.999752,0
4785,2971,24,345,2273,25,173,10596,983,11579,-0.033218,0.0151817,-0.999333,0
2051,1395,13,138,1154,12,77,4840,566,5406,-0.00960103,0.0148884,-0.999843,0
1827,1277,14,147,1259,13,84,4621,570,5191,-0.0232358,0.0217025,-0.999495,0
5483,3540,34,384,3184,34,219,12878,2015,14893,-0.0380681,0.0126492,-0.999195,0
4774,3301,35,521,3304,26,153,12114,1048,13162,-0.036243,0.0112068,-0.99928,0
4838,3335,34,390,3271,34,213,12115,1445,13560,-0.0248673,0.0141678,-0.99959,0
5077,3197,34,378,3086,34,211,12017,1228,13245,-0.0379722,0.0216449,-0.999044,0
2448,1703,18,200,1400,15,92,5876,728,6604,-0.0101758,0.0185004,-0.999777,0
1753,1318,14,155,1299,13,86,4638,694,5332,-0.0243998,0.0235855,-0.999424,0
4797,4009,34,387,3175,33,234,12669,1552,14221,-0.0242986,0.0196364,-0.999512,0
4733,3283,39,382,3194,35,216,11882,1471,13353,-0.0143745,0.011467,-0.999831,0
5033,3340,35,385,3178,35,217,12223,1550,13773,-0.0111067,0.0169708,-0.999794,0
4725,3313,40,409,3296,29,151,11963,1064,13027,-0.0213293,0.0162048,-0.999641,0
3251,2324,23,266,2199,22,148,8233,1163,9396,-0.0163383,0.0187933,-0.99969,0
4784,3199,34,384,3208,34,217,11860,1658,13518,-0.0211877,0.0132496,-0.999688,0
4739,3288,34,416,3230,34,219,11960,1536,13496,-0.0139177,0.0132549,-0.999815,0
4955,3431,35,387,3322,34,218,12382,1568,13950,-0.0124632,0.0224027,-0.999671,0
4608,3248,43,383,3148,33,214,11677,1689,13366,-0.0409299,0.023623,-0.998883,0
3259,2241,24,263,2194,22,145,8148,1143,9291,-0.0362364,0.0266436,-0.998988,0
4831,3299,36,383,3224,34,215,12022,1782,13804,-0.012062,0.0156225,-0.999805,0
4249,2327,22,264,1979,17,112,8970,788,9758,-0.0224515,0.0186576,-0.999574,0
2508,1796,25,230,1756,15,93,6423,787,7210,-0.0272656,0.00397383,-0.99962,0
3615,2409,30,284,2319,26,157,8840,1212,10052,-0.0208896,0.018596,-0.999609,0
5010,3284,34,391,3186,35,214,12154,1573,13727,-0.0360278,0.0119915,-0.999279,0
3656,2373,23,267,2239,23,150,8731,982,9713,-0.0242303,0.0112511,-0.999643,0
4848,3393,36,427,3828,37,220,12789,1484,14273,-0.00973839,0.0172976,-0.999803,0
4993,3359,32,415,3237,34,218,12288,1553,13841,-0.0372894,0.0209403,-0.999085,0
5475,3364,35,416,3299,35,248,12872,1199,14071,-0.0211988,0.0167006,-0.999636,0
3314,2330,25,264,2261,27,150,8371,1180,9551,-0.0404734,0.0100311,-0.99913,0
4767,3352,33,387,3215,33,213,12000,1483,13483,-0.0206754,0.0187867,-0.99961,0
4714,3243,35,383,3160,35,212,11782,1643,13425,-0.0186813,0.0146398,-0.999719,0
5296,3262,34,387,3132,36,216,12363,1462,13825,-0.0369336,0.0112801,-0.999254,0
5212,3281,35,386,3217,34,218,12383,1460,13843,-0.0251493,0.0140886,-0.999585,0
3434,2256,27,287,2281,24,171,8480,1164,9644,-0.00853258,0.0149398,-0.999852,0
5490,3612,34,382,3181,34,215,12948,1824,14772,-0.0112576,0.020375,-0.999729,0
4842,3448,32,384,3264,36,254,12260,1506,13766,-0.0216299,0.017208,-0.999618,0
4054,2121,19,226,1639,19,116,8194,787,8981,-0.0346838,0.0111876,-0.999336,0
1998,1393,15,192,1368,15,93,5074,684,5758,-0.0235199,0.0248153,-0.999415,0
4733,3349,33,384,3337,36,219,12091,1439,13530,-0.0239965,0.0209145,-0.999493,0
5258,3275,38,804,2590,25,154,12144,1126,13270,-0.0100522,0.0237037,-0.999669,0
4712,3270,34,383,3213,49,213,11874,1709,13583,-0.0393316,0.00986989,-0.999177,0
3021,1728,18,201,1680,14,91,6753,617,7370,-0.0384011,0.0149834,-0.99915,0
1700,1283,17,207,1264,14,91,4576,557,5133,-0.0295817,0.0230134,-0.999297,0
3311,2315,23,266,2253,22,146,8336,1117,9453,-0.0349066,0.00885673,-0.999351,0
4850,3225,34,386,3152,34,216,11897,1502,13399,-0.0221454,0.0129266,-0.999671,0
4853,3383,34,389,3362,37,185,12243,1112,13355,-0.0242728,0.0226973,-0.999448,0
3075,2091,20,247,2119,22,139,7713,1090,8803,-0.0344146,0.00949082,-0.999363,0
4937,3301,34,448,3475,37,221,12453,1647,14100,-0.0366122,0.0202449,-0.999125,0
4879,3543,35,387,3204,33,217,12298,1740,14038,-0.00850247,0.0211249,-0.999741,0
3297,2296,23,266,2251,23,150,8306,1124,9430,-0.0403686,0.0104444,-0.99913,0
4209,2948,55,370,2949,32,194,10757,1374,12131,-0.0362391,0.0137718,-0.999248,0
4997,3285,32,382,3242,39,250,12227,1453,13680,-0.0341415,0.0114824,-0.999351,0
4870,3686,41,437,3280,34,217,12565,1618,14183,-0.0283312,0.017146,-0.999452,0
4799,3362,33,386,3315,37,219,12151,1585,13736,-0.0349554,0.0081065,-0.999356,0
3329,2351,24,271,2300,24,149,8448,1313,9761,-0.0428196,0.0112764,-0.999019,0
4453,2936,32,360,3032,33,197,11043,1474,12517,-0.0162662,0.018464,-0.999697,0
4223,2961,30,343,2866,30,194,10647,1349,11996,-0.0202442,0.0091433,-0.999753,0
4887,3278,33,386,3250,35,220,12089,1631,13720,-0.0345312,0.0074859,-0.999376,0
4786,3293,33,383,3235,34,215,11979,1459,13438,-0.034123,0.0165336,-0.999281,0
4927,3222,34,406,3249,35,218,12091,1576,13667,-0.013525,0.0137803,-0.999814,0
4649,3457,35,423,3283,34,219,12100,1572,13672,-0.0238617,0.0191704,-0.999532,0
4809,3283,35,385,3206,34,218,11970,1512,13482,-0.0166911,0.0103299,-0.999807,0
4871,3439,36,393,3234,37,220,12230,1562,13792,-0.0344664,0.00958193,-0.99936,0
4717,3389,35,393,3209,45,242,12030,1658,13688,-0.0341944,0.00757515,-0.999387,0
3428,2308,23,327,2263,24,177,8550,1031,9581,-0.0370513,0.017555,-0.999159,0
5708,3509,33,386,3463,47,235,13381,1540,14921,-0.0382433,0.0109698,-0.999208,0
4891,3428,34,386,2971,23,151,11884,1099,12983,-0.0108832,0.0246008,-0.999638,0
2679,1782,18,214,1791,18,116,6618,891,7509,-0.0238756,0.0179496,-0.999554,0
4812,3865,36,388,3407,34,218,12760,1617,14377,-0.020509,0.0178318,-0.99963,0
4739,3241,33,378,3140,27,170,11728,1058,12786,-0.0385937,0.0112511,-0.999191,0
3271,2359,51,281,2164,26,147,8299,1039,9338,-0.0207853,0.0169587,-0.99964,0
4832,3359,40,395,3239,35,252,12152,1573,13725,-0.00893176,0.0141855,-0.99986,0
4791,3282,33,387,3216,34,218,11961,1453,13414,-0.0327991,0.0144,-0.999358,0
4211,2910,31,369,2837,31,194,10583,1293,11876,-0.0113452,0.0137988,-0.99984,0
4732,3358,33,388,3258,37,220,12026,1439,13465,-0.0332866,0.0115194,-0.99938,0
4748,3323,34,382,3219,33,250,11989,1461,13450,-0.0129815,0.011665,-0.999848,0
4681,3284,40,400,3307,35,221,11968,1319,13287,-0.00943169,0.0206071,-0.999743,0
4411,2953,29,365,2959,31,198,10946,1386,12332,-0.0385023,0.0125339,-0.99918,0
5905,3358,34,423,3339,45,221,13325,1463,14788,-0.0190218,0.0131436,-0.999733,0
3256,2406,23,271,2297,22,176,8451,1038,9489,-0.0331258,0.0101092,-0.9994,0
4453,3306,32,362,3113,31,206,11503,1387,12890,-0.0241865,0.0207568,-0.999492,0
4309,3302,30,404,3218,31,216,11510,1316,12826,-0.0219228,0.0199109,-0.999561,0
5254,3666,35,453,2938,23,160,12529,1037,13566,-0.00817101,0.0150964,-0.999852,0
3263,2448,24,337,2373,23,158,8626,1024,9650,-0.0122613,0.0251586,-0.999608,0
4853,3552,33,408,3453,34,270,12603,1525,14128,-0.00897528,0.0224099,-0.999709,0
2503,1830,18,211,1817,18,120,6517,937,7454,-0.0216169,0.0269571,-0.999403,0
3938,2875,29,329,2770,27,186,10154,1258,11412,-0.032738,0.00977834,-0.999416,0
4982,3726,35,451,3649,43,251,13137,1547,14684,-0.0234994,0.0230541,-0.999458,0
5010,3529,34,421,3415,32,231,12672,1643,14315,-0.0341438,0.0218635,-0.999178,0
3361,2486,24,280,2408,24,160,8743,999,9742,-0.0232921,0.0219796,-0.999487,0
4852,3607,35,467,3613,36,232,12842,1701,14543,-0.0352705,0.0109287,-0.999318,0
4778,3487,38,403,3354,34,264,12358,1294,13652,-0.0127273,0.0139615,-0.999821,0
3528,2411,23,282,2349,28,159,8780,1097,9877,-0.0235764,0.0196239,-0.99953,0
5133,3584,35,415,3430,34,238,12869,1534,14403,-0.0104378,0.0163976,-0.999811,0
4724,3479,34,422,3512,35,234,12440,1655,14095,-0.0382767,0.0229091,-0.999005,0
3682,2529,24,282,2431,23,159,9130,1076,10206,-0.0206143,0.0209809,-0.999567,0
4723,3485,36,406,3736,36,233,12655,1736,14391,-0.0391219,0.00857683,-0.999198,0
4832,3505,35,405,3429,33,230,12469,1554,14023,-0.0366065,0.0189803,-0.99915,0
4497,3485,33,385,3216,31,210,11857,1180,13037,-0.0259812,0.00562337,-0.999647,0
4697,3495,36,399,3375,30,205,12237,1543,13780,-0.02193,0.0171453,-0.999612,0
5023,3354,31,361,3071,33,206,12079,1548,13627,-0.0270771,0.00561875,-0.999617,0
3207,2218,21,254,2172,21,141,8034,1055,9089,-0.0211693,0.00662753,-0.999754,0
5001,3594,36,407,3958,116,313,13425,1621,15046,-0.00454049,0.0165955,-0.999852,0
4923,3454,35,405,3607,36,229,12689,1385,14074,-0.023269,0.0123461,-0.999653,0
2514,1817,17,213,1490,13,94,6158,637,6795,-0.0193039,0.00603066,-0.999795,0
1948,1423,14,164,1367,14,105,5035,600,5635,-0.0263421,0.0108045,-0.999595,0
4822,3369,41,413,3356,34,225,12260,1698,13958,-0.013937,0.0191641,-0.999719,0
4747,3324,37,386,3232,36,219,11981,1584,13565,-0.0414476,0.0123641,-0.999064,0
5074,3336,40,429,3117,55,215,12266,1607,13873,-0.036309,0.0129377,-0.999257,0
3405,2146,24,258,2165,23,146,8167,1198,9365,-0.00899362,0.0173044,-0.99981,0
4856,3146,35,369,3212,38,209,11865,1598,13463,-0.0222596,0.0233908,-0.999478,0
4891,3159,40,461,3146,49,210,11956,1642,13598,-0.0243915,0.0216962,-0.999467,0
5159,2792,25,245,2033,27,140,10421,1044,11465,-0.0259211,0.0321807,-0.999146,0
2557,1577,20,183,1525,25,101,5988,755,6743,-0.0175815,0.016933,-0.999702,0
5222,2786,36,343,2862,59,189,11497,1545,13042,-0.0193637,0.0477595,-0.998671,0
5085,3238,36,368,2382,24,129,11262,982,12244,-0.0252217,0.0470357,-0.998575,0
4405,2616,29,267,2142,35,165,9659,1170,10829,-0.0214144,0.055569,-0.998225,0
4065,2188,28,273,2078,34,145,8811,1197,10008,-0.0273168,0.0540389,-0.998165,0
6366,2791,33,363,2331,24,124,12032,991,13023,-0.0265625,0.0703599,-0.997168,0
3504,1873,24,218,1800,25,123,7567,972,8539,-0.032109,0.0573936,-0.997835,0
5243,2617,37,312,2590,42,177,11018,1569,12587,-0.0397643,0.0610617,-0.997342,0
5344,2520,34,311,2567,58,170,11004,1507,12511,-0.040693,0.0611589,-0.997298,0
5388,2448,36,290,2267,28,113,10570,1219,11789,-0.0358997,0.0622473,-0.997415,0
3762,1639,25,188,1577,27,106,7324,1160,8484,-0.0232574,0.0419988,-0.998847,0
5593,2101,35,310,1995,38,175,10247,1898,12145,-0.0227513,0.070738,-0.997236,0
5190,1867,31,226,1787,46,125,9272,1774,11046,-0.0279842,0.0544269,-0.998126,0
5282,1762,32,211,1693,36,121,9137,1925,11062,-0.0208887,0.0543956,-0.998301,0
5257,1589,31,216,1484,40,109,8726,1866,10592,-0.0161097,0.0521166,-0.998511,0
5255,1420,30,180,1383,42,111,8421,1687,10108,-0.00186282,0.0563386,-0.99841,0
5249,1352,30,171,1267,51,107,8227,2631,10858,0.0010606,0.0821752,-0.996618,0
5122,1306,30,164,1204,52,87,7965,2839,10804,0.0239957,0.100246,-0.994673,0
5107,1212,31,155,1167,43,87,7802,2498,10300,-0.00302436,0.106246,-0.994335,0
4961,1111,30,144,1039,48,78,7411,2570,9981,-0.0251359,0.124338,-0.991922,0
4993,941,29,127,935,51,74,7150,6007,13157,-0.026553,0.108702,-0.99372,0
3445,532,20,76,538,40,44,4695,5420,10115,-0.0109817,0.0506727,-0.998655,0
4605,559,24,79,484,42,42,5835,6902,12737,0.0317645,-0.042828,-0.998578,0
4685,594,30,91,506,53,45,6004,-1000,-1000,-1,-1,-1,0
2286,262,15,41,214,18,20,2856,-1000,-1000,-1,-1,-1,0
3223,284,17,46,249,21,24,3864,-1000,-1000,-1,-1,-1,0
2032,189,13,32,163,17,16,2462,-1000,-1000,-1,-1,-1,0
1678,152,11,27,126,12,12,2018,-1000,-1000,-1,-1,-1,0
1177,95,9,16,76,10,8,1391,-1000,-1000,-1,-1,-1,0
4129,353,27,58,236,31,27,4861,-1000,-1000,-1,-1,-1,0
1429,92,10,18,73,15,9,1646,-1000,-1000,-1,-1,-1,0
3583,204,22,45,165,39,20,4078,-1000,-1000,-1,-1,-1,0
3398,187,23,40,140,28,19,3835,-1000,-1000,-1,-1,-1,0
2402,160,16,30,124,22,15,2769,-1000,-1000,-1,-1,-1,0
1537,110,10,20,97,16,12,1802,-1000,-1000,-1,-1,-1,0
1664,136,12,24,112,19,12,1979,-1000,-1000,-1,-1,-1,0
1685,178,12,26,119,22,13,2055,-1000,-1000,-1,-1,-1,0
1720,143,12,27,119,22,15,2058,-1000,-1000,-1,-1,-1,0
1175,104,10,19,87,17,9,1421,5814,7235,0.0655324,-0.216213,-0.974144,0
3056,294,23,54,246,41,26,3740,7090,10830,0.0721274,-0.215964,-0.973734,0
3622,359,25,61,307,40,32,4446,13367,17813,-0.257967,0.328222,-0.908693,0
3686,434,26,73,365,30,36,4650,4484,9134,0.0542705,-0.101448,-0.99336,0
3763,478,33,79,427,30,40,4850,6266,11116,0.0537405,-0.100729,-0.993462,0
3807,565,26,91,546,38,65,5138,12378,17516,0.0543243,-0.134018,-0.989489,0
3758,689,26,102,623,31,52,5281,-1000,-1000,-1,-1,-1,0
1958,397,15,58,366,16,31,2841,2048,4889,0.0588571,-0.114949,-0.991626,0
4179,1100,35,164,837,34,70,6419,2802,9221,0.0786489,-0.12126,-0.9895,0
3822,1039,27,176,884,33,70,6051,2162,8213,0.0765832,-0.144343,-0.98656,0
3877,1031,29,144,982,30,76,6169,1984,8153,0.0316879,-0.0530096,-0.998091,0
3955,1111,28,200,1140,40,90,6564,2002,8566,0.0630634,-0.108422,-0.992103,0
4040,1344,28,209,1228,34,99,6982,2344,9326,0.00660124,-0.0399803,-0.999179,0
3936,1377,30,205,1365,46,103,7062,1886,8948,-0.00382037,-0.0311927,-0.999506,0
3996,1618,28,206,1526,42,119,7535,1831,9366,-0.0221507,0.00480035,-0.999743,0
4048,1753,29,246,1726,43,130,7975,1675,9650,-0.0317949,0.0730596,-0.996821,0
4074,1802,28,281,1818,40,134,8177,1546,9723,-0.0349638,0.0633954,-0.997376,0
4207,1997,28,247,1943,40,141,8603,1443,10046,-0.0326547,0.0691367,-0.997073,0
4270,2117,30,260,2075,36,145,8933,1490,10423,-0.0251381,0.0849803,-0.996066,0
2109,921,12,113,911,20,65,4151,593,4744,-0.0143142,0.0676947,-0.997603,0
4294,2308,27,334,2184,48,155,9350,1398,10748,-0.0247271,0.0672715,-0.997428,0
5026,2388,28,307,2526,51,169,10495,1432,11927,-0.025048,0.0856765,-0.996009,0
5289,2761,28,315,2628,46,181,11248,1512,12760,-0.0305472,0.0852817,-0.995888,0
5652,3015,33,341,2654,29,135,11859,1033,12892,-0.0423098,0.0925696,-0.994807,0
3353,2253,19,260,2206,43,150,8284,991,9275,-0.0484398,0.0858113,-0.995133,0
5639,3618,29,456,3606,72,254,13674,1399,15073,-0.0544756,0.0905924,-0.994397,0
4992,4026,31,457,3484,27,182,13199,965,14164,-0.0510111,0.105717,-0.993087,0
3061,2435,16,281,2321,24,149,8287,740,9027,-0.0510791,0.0871511,-0.994884,0
1935,1329,9,161,1341,12,87,4874,418,5292,-0.0404778,0.0783691,-0.996103,0
5915,5924,30,656,4052,66,252,16895,982,17877,-0.0475214,0.0880625,-0.994981,0
3142,3204,17,361,3166,26,205,10121,797,10918,-0.0379817,0.0670248,-0.997028,0
5304,5307,24,590,4650,28,243,16146,966,17112,-0.0276699,0.0687443,-0.997251,0
2970,3302,16,389,2982,24,196,9879,746,10625,-0.0328264,0.0524356,-0.998084,0
5434,5869,32,917,5850,77,273,18452,948,19400,-0.0312185,0.11523,-0.992848,0
3909,4325,20,494,4283,54,282,13367,886,14253,-0.0383961,0.100065,-0.99424,0
5529,5964,25,692,5947,54,274,18485,835,19320,-0.0433874,0.128308,-0.990785,0
3791,4323,17,485,4238,37,272,13163,853,14016,-0.0317238,0.125225,-0.991621,0
3538,3970,16,440,3930,33,269,12196,779,12975,-0.0484152,0.135873,-0.989543,0
5609,6300,26,661,5836,39,265,18736,914,19650,-0.0482766,0.139627,-0.989027,0
6315,6179,21,485,4247,30,207,17484,735,18219,-0.0294045,0.101286,-0.994422,0
2733,2547,12,306,2546,23,157,8324,608,8932,-0.0396685,0.0934285,-0.994835,0
6368,5665,29,653,4231,37,240,17223,972,18195,-0.0430507,0.0859725,-0.995367,0
3216,2837,15,315,2805,27,201,9416,778,10194,-0.0455852,0.0777738,-0.995928,0
5863,5346,29,588,5248,88,330,17492,1422,18914,-0.0395642,0.0740195,-0.996472,0
3951,3443,20,401,3449,37,219,11520,904,12424,-0.0290189,0.0604473,-0.99775,0
5770,4787,30,535,4827,48,304,16301,1378,17679,-0.0332058,0.0673545,-0.997176,0
5605,4344,29,521,4287,48,292,15126,1263,16389,-0.0576844,0.0785269,-0.995242,0
5591,4106,30,457,3511,37,182,13914,993,14907,-0.0551609,0.0827376,-0.995044,0
2869,2040,16,227,2015,25,128,7320,734,8054,-0.050734,0.0590561,-0.996965,0
5560,3569,38,406,3519,52,249,13393,1407,14800,-0.0766172,0.112664,-0.990675,0
5214,3382,30,383,3316,51,218,12594,1182,13776,-0.0713432,0.10498,-0.991912,0
3447,2096,21,246,2052,33,137,8032,1022,9054,-0.0513589,0.1025,-0.993407,0
5007,2744,31,318,2643,43,202,10988,1927,12915,-0.0595349,0.104734,-0.992717,0
4687,2476,29,305,2423,42,166,10128,1851,11979,-0.0642369,0.0981869,-0.993093,0
5305,2105,28,261,2101,42,148,9990,1227,11217,-0.0624581,0.144327,-0.987557,0
3923,1770,26,218,1726,57,124,7844,1964,9808,-0.0684726,0.126204,-0.989638,0
4238,1788,25,204,1665,34,121,8075,1860,9935,-0.0594652,0.148634,-0.987103,0
4204,1729,27,226,1665,37,131,8019,2011,10030,-0.112021,0.132918,-0.984776,0
4074,1574,26,201,1527,48,128,7578,1948,9526,-0.111232,0.12308,-0.986143,0
3980,1634,27,233,1499,45,116,7534,1592,9126,-0.12282,0.124973,-0.984529,0
3836,1463,25,186,1420,35,107,7072,2013,9085,-0.15996,0.221435,-0.961967,0
3759,1414,28,183,1374,38,103,6899,1575,8474,-0.134281,0.176625,-0.975075,0
4529,1384,25,212,1327,50,101,7628,1511,9139,-0.12003,0.150653,-0.981273,0
3681,1403,25,177,1362,34,101,6783,1631,8414,-0.12318,0.133452,-0.98337,0
3685,1365,25,183,1295,37,96,6686,1665,8351,-0.0890445,0.177048,-0.980166,0
3674,1536,42,268,1594,41,103,7258,1735,8993,-0.166838,0.223037,-0.960427,0
3893,1808,27,192,1300,38,99,7357,1707,9064,-0.119501,0.226093,-0.966748,0
3989,1663,32,223,1268,38,97,7310,2147,9457,-0.10036,0.17889,-0.978737,0
3624,1280,26,229,1138,34,95,6426,2183,8609,-0.0951836,0.161076,-0.982342,0
4137,1562,26,172,1256,33,95,7281,1821,9102,-0.0773527,0.147817,-0.985985,0
3524,1282,38,156,1132,30,84,6246,1462,7708,-0.0839464,0.162387,-0.98315,0
3668,1295,25,169,1266,45,94,6562,1627,8189,-0.0761761,0.173779,-0.981834,0
3291,1519,29,238,1440,45,113,6675,1671,8346,-0.0696037,0.140333,-0.987655,0
3846,1468,26,181,1238,34,90,6883,1625,8508,-0.0680714,0.139266,-0.987912,0
3714,1384,27,174,1334,56,99,6788,1932,8720,-0.0708181,0.132951,-0.988589,0
3747,1380,27,173,1536,71,121,7055,1765,8820,-0.0820523,0.177852,-0.980631,0
4444,1356,26,176,1289,34,95,7420,1657,9077,-0.082416,0.187679,-0.978767,0
3903,1381,28,209,1332,34,114,7001,1893,8894,-0.0792219,0.19757,-0.977082,0
3713,1447,27,182,1375,49,90,6883,1876,8759,-0.0904172,0.225237,-0.9701,0
4036,1584,27,200,1535,47,109,7538,1775,9313,-0.0942873,0.232527,-0.968009,0
4492,1907,30,243,2011,49,126,8858,2212,11070,-0.0981947,0.207653,-0.973262,0
3683,1936,36,270,1642,33,117,7717,2040,9757,-0.0854359,0.202301,-0.97559,0
3602,1852,30,226,1744,33,121,7608,2342,9950,-0.0653643,0.15392,-0.985919,0
3574,1855,26,218,1914,41,128,7756,2089,9845,-0.0712949,0.144027,-0.987002,0
4012,1918,27,225,1828,35,156,8201,2323,10524,-0.0546562,0.108674,-0.992574,0
3974,2239,27,252,2286,62,179,9019,2372,11391,-0.0782955,0.143792,-0.986506,0
4082,2046,28,244,2055,59,147,8661,2177,10838,-0.0499111,0.118648,-0.991681,0
5093,2185,29,277,2337,40,144,10105,2166,12271,-0.0495219,0.11978,-0.991564,0
3556,1906,25,221,1805,38,125,7676,2042,9718,-0.0557549,0.126288,-0.990425,0
4024,2184,27,246,2124,65,216,8886,2335,11221,-0.0591112,0.151515,-0.986686,0
3982,2094,27,252,2027,42,140,8564,1941,10505,-0.0495522,0.112573,-0.992407,0
3957,2122,29,250,2007,42,141,8548,2306,10854,-0.053746,0.117017,-0.991675,0
4125,2156,33,270,2135,43,142,8904,2247,11151,-0.0537948,0.146832,-0.987697,0
4047,2256,28,252,2079,39,129,8830,2047,10877,-0.0591257,0.132895,-0.989365,0
5497,2321,34,358,2660,71,192,11133,2008,13141,-0.0658653,0.140735,-0.987854,0
3563,1940,24,227,1883,52,128,7817,2318,10135,-0.0645463,0.145793,-0.987207,0
4212,2146,28,254,2074,39,141,8894,2837,11731,-0.0501862,0.130812,-0.990136,0
4023,2492,30,299,2243,60,151,9298,2705,12003,-0.0545348,0.132218,-0.989719,0
3953,2182,30,257,2106,38,145,8711,2536,11247,-0.0509844,0.120325,-0.991424,0
3899,2141,27,252,2126,46,148,8639,2059,10698,-0.0449941,0.115753,-0.992258,0
4000,2133,28,255,2147,40,148,8751,2089,10840,-0.0476016,0.123379,-0.991218,0
3988,2191,28,256,2171,38,148,8820,2330,11150,-0.0504547,0.12294,-0.991131,0
3915,2217,29,266,2150,40,146,8763,2589,11352,-0.0579361,0.141453,-0.988248,0
3965,2191,26,256,2080,44,143,8705,2038,10743,-0.0533768,0.12483,-0.990742,0
4123,2238,29,259,2106,45,147,8947,2201,11148,-0.0538624,0.124322,-0.990779,0
4039,2177,27,255,2159,35,146,8838,2097,10935,-0.054661,0.12827,-0.990232,0
3965,2226,28,261,2138,40,146,8804,2080,10884,-0.0503444,0.129076,-0.990356,0
4063,2236,52,270,2235,42,151,9049,2114,11163,-0.04625,0.12375,-0.991235,0
4046,2170,29,256,2053,44,142,8740,2478,11218,-0.0568269,0.132791,-0.989514,0
4026,2274,28,259,2140,37,147,8911,2247,11158,-0.0504358,0.122788,-0.991151,0
3994,2166,28,258,2159,46,151,8802,2156,10958,-0.0498483,0.130167,-0.990238,0
4021,2146,27,257,2103,41,149,8744,2620,11364,-0.0538522,0.12688,-0.990455,0
3953,2142,29,300,2827,49,182,9482,2147,11629,-0.0568143,0.13827,-0.988764,0
4102,2187,28,258,2171,36,151,8933,2039,10972,-0.0508609,0.122011,-0.991225,0
4190,2195,29,259,2144,41,160,9018,2086,11104,-0.057281,0.131578,-0.98965,0
4571,2390,29,259,2243,45,149,9686,2158,11844,-0.0545143,0.128774,-0.990175,0
4828,2159,27,257,2138,38,144,9591,1987,11578,-0.0517569,0.121255,-0.991271,0
4095,2465,39,366,2277,34,151,9427,2051,11478,-0.0652323,0.136603,-0.988476,0
3967,2161,28,253,2082,34,142,8667,2692,11359,-0.0528277,0.119802,-0.991391,0
4262,2210,28,256,2094,55,143,9048,2572,11620,-0.0452818,0.112182,-0.992655,0
3939,2144,29,253,2077,32,142,8616,2245,10861,-0.0500031,0.118369,-0.99171,0
4167,2127,28,258,2092,39,144,8855,2560,11415,-0.041725,0.108034,-0.993271,0
3979,2565,29,306,2229,38,149,9295,2329,11624,-0.0561517,0.133031,-0.98952,0
3994,2164,28,254,2101,46,142,8729,2264,10993,-0.0468145,0.116803,-0.992051,0
3988,2273,29,257,2090,38,141,8816,2557,11373,-0.051212,0.120325,-0.991413,0
3957,2145,26,276,2082,37,143,8666,2362,11028,-0.050461,0.125828,-0.990768,0
3983,2348,38,261,2137,37,142,8946,2338,11284,-0.049464,0.120035,-0.991537,1
4449,2341,35,282,2076,39,143,9365,2470,11835,-0.0550009,0.125103,-0.990618,1
3933,2207,29,256,2157,38,147,8767,2134,10901,-0.0590558,0.136264,-0.988911,1
4581,2362,28,261,2292,41,167,9732,2336,12068,-0.0632245,0.142572,-0.987763,1
3939,2186,29,256,2082,34,157,8683,2243,10926,-0.0547719,0.127169,-0.990368,1
4253,2190,28,256,2155,36,147,9065,2357,11422,-0.0565849,0.134082,-0.989354,1
3993,2216,28,258,2182,43,150,8870,2315,11185,-0.0494617,0.121153,-0.991401,1
4139,2287,27,257,2228,50,150,9138,2193,11331,-0.0619534,0.136462,-0.988706,1
4130,2173,29,258,2220,42,177,9029,2332,11361,-0.0456092,0.119501,-0.991786,1
4132,2294,34,266,2098,51,158,9033,2387,11420,-0.0494172,0.116834,-0.991922,1
4130,2361,40,272,2136,41,148,9128,2316,11444,-0.0635722,0.136596,-0.988585,1
4928,2308,32,257,2237,46,173,9981,1944,11925,-0.0523464,0.127289,-0.990483,1
4151,2206,28,259,2105,40,148,8937,2020,10957,-0.050065,0.126359,-0.99072,1
4526,2230,29,300,2155,39,147,9426,2319,11745,-0.0555678,0.141397,-0.988392,1
3952,2209,27,253,2116,38,145,8740,2118,10858,-0.0541429,0.128946,-0.990172,1
4231,2393,27,268,2096,45,145,9205,1917,11122,-0.0486374,0.120807,-0.991484,1
4307,2431,29,341,2442,39,150,9739,2238,11977,-0.0483535,0.124316,-0.991064,1
3896,2144,29,255,2077,42,143,8586,2293,10879,-0.0595174,0.142991,-0.987933,1
3967,2354,27,232,1882,37,129,8628,1700,10328,-0.0490781,0.124197,-0.991043,1
4417,2387,28,251,2354,41,155,9633,1930,11563,-0.0531521,0.130254,-0.990055,1
4744,2452,39,289,2355,42,165,10086,2347,12433,-0.0632687,0.139707,-0.98817,1
4449,2463,54,288,2369,37,147,9807,2348,12155,-0.0418905,0.114067,-0.99259,1
3993,2163,32,253,2078,35,169,8723,1890,10613,-0.0492649,0.129108,-0.990406,1
4601,2495,32,288,2420,42,179,10057,2333,12390,-0.0441993,0.121563,-0.991599,1
4438,2200,29,279,2094,42,146,9228,1923,11151,-0.0642044,0.141545,-0.987847,1
4705,2329,30,269,2112,35,147,9627,1903,11530,-0.050543,0.126047,-0.990736,1
4006,2243,29,258,2126,46,186,8894,2017,10911,-0.0452893,0.120421,-0.99169,1
3936,2247,29,254,2065,38,155,8724,1895,10619,-0.0493896,0.123551,-0.991108,1
4824,2249,28,255,2077,38,152,9623,2147,11770,-0.0604196,0.137095,-0.988713,1
3945,2101,28,258,2074,34,146,8586,1924,10510,-0.0488069,0.12172,-0.991364,1
4004,2323,31,258,2058,36,142,8852,1900,10752,-0.0480355,0.125952,-0.990873,1
4093,2148,31,266,2383,52,151,9124,2114,11238,-0.0527459,0.138955,-0.988893,1
4028,2173,27,256,2130,35,147,8796,2080,10876,-0.0554977,0.138552,-0.988799,1
4634,2166,29,255,2039,37,140,9300,2249,11549,-0.0548059,0.135677,-0.989236,1
4019,2158,30,254,2061,51,168,8741,2224,10965,-0.0419253,0.121529,-0.991702,1
4290,2117,27,281,2078,36,147,8976,2015,10991,-0.0459857,0.123423,-0.991288,1
3963,2163,29,255,2149,53,148,8760,2226,10986,-0.0595135,0.135094,-0.989044,1
4063,2101,29,255,2052,40,142,8682,2351,11033,-0.0580237,0.137672,-0.988777,1
3964,2196,28,253,2143,39,145,8768,1967,10735,-0.0444182,0.121967,-0.99154,1
3968,2116,29,261,2107,39,144,8664,2177,10841,-0.0636244,0.151655,-0.986384,1
4483,2450,31,284,2354,41,161,9804,2619,12423,-0.0616688,0.15272,-0.986344,1
4438,2467,32,285,2400,45,166,9833,2862,12695,-0.0476511,0.124502,-0.991075,1
4563,2408,31,289,2286,36,161,9774,2158,11932,-0.0479844,0.120255,-0.991583,1
3951,1583,20,173,1417,27,98,7269,1557,8826,-0.0520737,0.132529,-0.98981,1
3977,2202,28,253,2037,39,139,8675,2093,10768,-0.0551875,0.132922,-0.989589,1
3980,2116,27,253,2007,34,142,8559,1893,10452,-0.0578689,0.131631,-0.989608,1
4132,2094,29,252,2156,35,148,8846,1997,10843,-0.0550127,0.13396,-0.989459,1
3981,2176,28,267,2042,39,146,8679,2272,10951,-0.0400791,0.114334,-0.992634,1
3978,2129,29,252,2039,46,151,8624,2297,10921,-0.0440854,0.120009,-0.991794,1
3985,2088,27,253,2068,37,144,8602,2026,10628,-0.0446795,0.123454,-0.991344,1
4752,2121,29,290,2068,40,148,9448,2153,11601,-0.0576874,0.128479,-0.990033,1
3887,2088,27,251,2099,38,144,8534,2145,10679,-0.0585391,0.142779,-0.988022,1
4854,2107,29,253,2071,39,144,9497,2716,12213,-0.0535532,0.139698,-0.988745,1
3886,2117,27,255,2090,40,144,8559,2240,10799,-0.0606625,0.147555,-0.987192,1
3917,2116,31,262,2152,39,155,8672,2290,10962,-0.0579353,0.14309,-0.988013,1
3997,2143,26,252,2142,35,145,8740,2713,11453,-0.0645203,0.148542,-0.986799,1
3914,2194,30,257,2086,39,158,8678,2075,10753,-0.0609735,0.144036,-0.987692,1
4526,2328,28,255,2261,40,145,9583,1989,11572,-0.0616918,0.146882,-0.987229,1
4492,2394,36,288,2228,37,143,9618,2235,11853,-0.0621546,0.142801,-0.987798,1
3974,2135,27,308,1540,27,100,8111,1785,9896,-0.0552911,0.14367,-0.98808,1
3098,1484,20,177,1412,26,97,6314,1698,8012,-0.0503876,0.130318,-0.990191,1
3922,2116,27,251,2127,44,149,8636,2342,10978,-0.0533408,0.138676,-0.988901,1
4606,2213,28,255,2044,39,140,9325,2192,11517,-0.0480651,0.128314,-0.990568,1
4826,2128,28,255,2046,34,140,9457,2268,11725,-0.0545219,0.136955,-0.989076,1
4055,2153,26,253,2073,42,141,8743,2336,11079,-0.0546161,0.136968,-0.989069,1
4057,2255,27,252,2136,39,147,8913,2327,11240,-0.040439,0.115956,-0.992431,1
4105,2229,29,255,2482,53,212,9365,2253,11618,-0.0553373,0.129696,-0.990009,1
4097,2231,27,271,2044,39,145,8854,2320,11174,-0.0525771,0.1223,-0.9911,1
4934,2669,29,253,2028,33,140,10086,1928,12014,-0.0604959,0.133791,-0.989161,1
3928,2122,28,249,2080,36,143,8586,2122,10708,-0.049474,0.125672,-0.990838,1
4642,2350,29,258,2081,40,147,9547,1917,11464,-0.0526857,0.12976,-0.990145,1
3901,2175,27,252,2182,41,149,8727,1954,10681,-0.0568577,0.148301,-0.987307,1
4941,2163,29,255,2087,41,146,9662,2285,11947,-0.0421162,0.12443,-0.991334,1
5034,2196,35,258,2231,45,153,9952,2317,12269,-0.0573238,0.154118,-0.986389,1
4288,2236,27,259,2189,44,152,9195,4813,14008,-0.0752914,0.187243,-0.979424,1
4628,2722,32,309,2616,52,181,10540,3850,14390,-0.07036,0.178686,-0.981387,1
4417,2359,30,285,2323,45,163,9622,3617,13239,-0.0766731,0.192195,-0.978357,1
4121,2425,32,329,2379,76,168,9530,3057,12587,-0.0660566,0.178893,-0.981649,1
4273,2519,31,298,2258,54,116,9549,2513,12062,-0.0613982,0.176623,-0.982362,1
2688,1678,19,195,1619,38,111,6348,2859,9207,-0.0697494,0.195766,-0.978167,1
4832,3061,51,390,3004,89,204,11631,4799,16430,-0.0698036,0.201839,-0.976928,1
4293,2925,31,333,2920,82,211,10795,2717,13512,-0.0762302,0.187724,-0.979259,1
4492,3135,31,373,3068,76,207,11382,1724,13106,-0.0675443,0.202712,-0.976906,1
4565,3330,32,387,3293,68,224,11899,2594,14493,-0.0600418,0.206451,-0.976613,1
4839,3462,30,414,3418,57,239,12459,2072,14531,-0.0352907,0.196092,-0.97995,1
4744,3736,35,421,3573,66,238,12813,2007,14820,-0.0423824,0.189059,-0.981051,1
4569,3880,40,601,3778,71,246,13185,2154,15339,-0.0303916,0.185185,-0.982234,1
3147,2477,22,294,2440,47,169,8596,2175,10771,-0.0312979,0.175825,-0.983924,1
6964,5441,42,686,4605,91,318,18147,3895,22042,-0.0389767,0.190183,-0.980975,1
4551,3750,33,434,3668,57,270,12763,2285,15048,-0.0352439,0.170539,-0.98472,1
2408,2039,20,302,1917,39,132,6857,2412,9269,-0.0577391,0.14211,-0.988165,1
5137,3858,34,446,3849,98,254,13676,6981,20657,-0.042505,0.161081,-0.986026,1
3187,2618,23,318,2572,77,173,8968,3489,12457,-0.0379907,0.151163,-0.987779,1
3845,3138,28,360,3145,58,235,10809,4678,15487,-0.0259632,0.184766,-0.98244,1
3877,3254,26,362,3471,108,213,11311,2115,13426,-0.0474392,0.166033,-0.984978,1
4911,3984,34,453,3902,81,255,13620,2891,16511,-0.0553437,0.152626,-0.986733,1
3946,2695,22,318,2574,74,159,9788,7339,17127,-0.0133834,0.181759,-0.983252,1
2408,1573,16,180,1532,30,102,5841,6740,12581,-0.006305,0.165552,-0.986181,1
2706,1592,16,182,1577,58,104,6235,9249,15484,-0.0343521,0.180881,-0.982905,1
4363,2375,29,285,2380,58,162,9652,10427,20079,0.0108789,0.168275,-0.98568,1
2264,1139,18,133,1114,30,75,4773,3640,8413,-0.0197955,0.146803,-0.988968,1
4259,1930,28,226,1937,76,133,8589,4817,13406,-0.0214712,0.192393,-0.981083,1
4276,1792,28,218,1749,56,123,8242,5280,13522,-0.020046,0.168102,-0.985566,1
3051,1211,19,149,1213,39,87,5769,4557,10326,-0.0235445,0.135566,-0.990489,1
4049,1590,27,194,1538,45,109,7552,5107,12659,-0.038477,0.159288,-0.986482,1
4034,1462,31,177,1396,37,98,7235,5259,12494,-0.0332245,0.137184,-0.989989,1
4149,1413,32,191,1293,50,96,7224,4035,11259,-0.030468,0.138591,-0.989881,1
3922,1239,24,157,1212,42,88,6684,6872,13556,-0.0208926,0.107915,-0.993941,1
4660,1304,28,180,1282,37,96,7587,7731,15318,-0.0347166,0.192844,-0.980615,1
2513,584,12,66,503,17,38,3733,2117,5850,0.0397934,0.16867,-0.984869,1
4557,1100,26,150,726,27,57,6643,4310,10953,0.0487959,0.172036,-0.983881,1
2327,540,14,74,513,20,40,3528,2369,5897,0.00442179,0.139185,-0.990257,1
4318,981,33,170,1183,33,78,6796,5310,12106,0.0427644,0.201269,-0.978602,1
4391,877,27,122,818,33,66,6334,4711,11045,0.0270905,0.222006,-0.974669,1
4418,815,28,115,782,33,65,6256,4044,10300,0.0214116,0.215016,-0.976376,1
4696,770,27,112,732,38,64,6439,6293,12732,-0.00795703,0.218134,-0.975886,1
4774,694,25,104,673,38,57,6365,4543,10908,0.0261314,0.21436,-0.976405,1
4849,672,26,102,623,37,53,6362,6257,12619,0.0333953,0.225776,-0.973606,1
4851,637,30,120,569,34,53,6294,3864,10158,0.0491972,0.224354,-0.973265,1
4607,520,26,81,438,30,53,5755,3776,9531,0.0453946,0.183936,-0.98189,1
4187,443,23,71,394,30,38,5186,2867,8053,0.0595332,0.206951,-0.976538,1
4645,475,27,79,430,40,41,5737,3192,8929,0.0511183,0.189596,-0.980531,1
5712,486,27,80,401,40,39,6785,4189,10974,0.0695926,0.190893,-0.979141,1
4398,449,46,75,414,38,42,5462,2323,7785,0.0419846,0.182444,-0.98232,1
4397,370,28,92,322,43,37,5289,1649,6938,0.0425149,0.206807,-0.977458,1
4376,381,40,68,332,28,33,5258,1800,7058,0.0682234,0.218706,-0.973403,1
4208,394,29,76,375,30,46,5158,1778,6936,0.0357262,0.215213,-0.975914,1
3984,434,29,75,405,29,42,4998,1456,6454,0.0484618,0.226474,-0.972811,1
2890,421,19,65,377,24,42,3838,1032,4870,0.0582399,0.241056,-0.968762,1
4548,648,26,102,598,38,52,6012,2329,8341,0.0874424,0.193897,-0.977117,1
3895,769,25,110,687,39,60,5585,3613,9198,0.0723014,0.204601,-0.976172,1
4075,871,31,124,762,43,65,5971,1985,7956,0.101711,0.213935,-0.971539,1
4006,960,28,135,897,36,73,6135,2893,9028,0.0547113,0.207324,-0.976741,1
3927,1160,28,158,1118,36,88,6515,2347,8862,0.0737847,0.240185,-0.967919,1
4098,1374,28,185,1356,35,106,7182,1619,8801,-0.0608691,0.221228,-0.973321,1
4277,1724,30,217,1662,33,121,8064,1472,9536,-0.0186442,0.142682,-0.989593,1
4541,2172,29,259,2155,44,148,9348,1431,10779,-0.0653307,0.227032,-0.971694,1
4583,2593,27,316,2556,45,179,10299,1369,11668,-0.0542385,0.222842,-0.973345,1
4956,3319,50,417,3253,45,279,12319,1375,13694,-0.039188,0.184165,-0.982114,1
5269,4156,29,457,4027,36,203,14177,986,15163,-0.0378673,0.207217,-0.977562,1
5357,4474,26,508,4080,34,205,14684,887,15571,-0.0253912,0.172782,-0.984632,1
2872,2914,15,346,2873,30,179,9229,687,9916,-0.0399758,0.151279,-0.987682,1
6233,6615,31,692,4367,52,267,18257,950,19207,-0.0436859,0.165766,-0.985197,1
3303,3503,16,415,3496,32,220,10985,816,11801,-0.030453,0.129556,-0.991105,1
4511,4266,19,495,4300,60,278,13929,1087,15016,-0.0157275,0.118953,-0.992775,1
6298,7305,41,1112,5156,52,305,20269,816,21085,-0.0136656,0.216546,-0.976177,1
3410,3715,14,415,3292,45,189,11080,605,11685,-0.040116,0.193132,-0.980352,1
2994,3358,18,528,3540,23,207,10668,680,11348,-0.0248513,0.225048,-0.974031,1
5624,6027,32,716,6172,41,286,18898,913,19811,-0.0319246,0.225969,-0.973611,1
3948,3870,20,446,3820,38,248,12390,904,13294,-0.0398753,0.223231,-0.97395,1
2971,2584,13,306,2605,23,168,8670,686,9356,-0.05603,0.15842,-0.985781,1
4361,3605,21,430,3413,43,237,12110,1071,13181,-0.0474464,0.197086,-0.979237,1
4410,3406,22,340,2958,48,194,11378,1057,12435,-0.0612298,0.205599,-0.976719,1
3965,2669,21,290,2599,38,169,9751,1094,10845,-0.0414328,0.180161,-0.982764,1
3993,2377,22,263,2179,44,147,9025,1116,10141,-0.0287286,0.186998,-0.98194,1
4888,3059,40,489,2647,48,174,11345,1340,12685,-0.0365292,0.167133,-0.985258,1
4638,2496,27,286,2355,41,189,10032,1086,11118,-0.0356359,0.152655,-0.987637,1
5376,2567,31,328,2538,59,172,11071,2062,13133,-0.0561603,0.187487,-0.980661,1
5003,2346,47,256,2162,32,114,9960,1554,11514,-0.0424941,0.157691,-0.986574,1
2458,1217,16,143,1145,22,78,5079,1143,6222,-0.0585379,0.146131,-0.987532,1
4514,2156,29,259,2078,42,146,9224,2202,11426,-0.0507939,0.18809,-0.980837,1
4340,1993,30,243,1921,39,160,8726,2131,10857,-0.0578871,0.149949,-0.986998,1
4434,2152,30,243,1929,38,139,8965,1840,10805,-0.0568808,0.164503,-0.984735,1
4242,1836,29,232,2207,52,150,8748,2024,10772,-0.0563411,0.159913,-0.985522,1
4526,1749,27,276,1676,39,155,8448,1873,10321,0.0590421,0.224165,-0.972761,1
3634,1488,25,215,1428,41,107,6938,1861,8799,0.0500668,0.22285,-0.973566,1
4887,1652,35,254,1780,35,120,8763,2012,10775,-0.0685843,0.19678,-0.978046,1
4185,1615,31,253,2059,43,120,8306,2189,10495,-0.0677181,0.267761,-0.961103,1
3843,1584,25,198,1475,55,110,7290,1988,9278,-0.0616313,0.22934,-0.971393,1
3867,1608,28,258,1533,38,115,7447,2249,9696,-0.0644416,0.259035,-0.963716,1
3736,1342,24,179,1286,45,98,6710,1961,8671,-0.0645119,0.223238,-0.972627,1
4456,1472,26,192,1379,35,122,7682,2463,10145,-0.0722461,0.217097,-0.973473,1
3832,1240,26,166,1179,48,93,6584,3045,9629,-0.0746215,0.292501,-0.953349,1
3709,1196,24,160,1145,60,88,6382,3171,9553,-0.0891444,0.250889,-0.963903,1
3809,1231,25,163,1190,45,93,6556,4662,11218,-0.0448363,0.261566,-0.964144,1
3672,1274,26,165,1250,43,95,6525,6355,12880,-0.0465685,0.291785,-0.95535,1
3739,1338,26,176,1278,45,115,6717,3151,9868,-0.0782468,0.295936,-0.951997,1
3738,1413,31,241,1562,67,148,7200,4947,12147,-0.0966922,0.300924,-0.948734,1
4203,1452,26,211,1375,49,107,7423,4472,11895,-0.0909876,0.283702,-0.954586,1
4816,1507,28,198,1459,55,109,8172,3621,11793,-0.045229,0.308409,-0.950178,1
4101,1603,25,201,1547,50,112,7639,4086,11725,-0.0818169,0.29774,-0.951134,1
3842,1641,25,208,1598,60,145,7519,5244,12763,-0.0853716,0.311532,-0.946393,1
3954,1836,27,266,1881,44,132,8140,3848,11988,-0.0820053,0.256829,-0.962972,1
4538,2127,26,262,2170,40,149,9312,4644,13956,-0.0786971,0.303429,-0.949599,1
4531,2087,27,252,2027,45,143,9112,4116,13228,-0.0760834,0.230473,-0.9701,1
4087,2163,26,263,2182,74,152,8947,6523,15470,-0.327548,-0.336244,-0.882979,1
4366,2404,34,282,2367,48,162,9663,7609,17272,-0.0789001,0.30512,-0.94904,1
2851,2070,22,218,1774,49,118,7102,4739,11841,-0.083966,0.283448,-0.955305,1
4238,2766,28,326,2798,69,189,10414,4795,15209,-0.0733895,0.326864,-0.942218,1
4492,3284,38,367,3204,42,210,11637,7234,18871,-0.0701546,0.299258,-0.95159,1
4460,3609,31,410,3606,69,238,12423,2703,15126,-0.0560773,0.316207,-0.947032,1
4880,4286,33,498,4070,80,265,14112,2140,16252,-0.0461832,0.336459,-0.940565,1
3207,3028,22,355,2862,64,191,9729,1530,11259,-0.0632879,0.32034,-0.945186,1
4537,3887,29,443,4007,71,257,13231,1997,15228,-0.0421959,0.305691,-0.951195,1
5001,4492,33,571,4310,77,200,14684,2062,16746,-0.0385604,0.300658,-0.952952,1
2591,2326,19,312,2333,58,154,7793,1309,9102,-0.0330774,0.277497,-0.960157,1
5121,5271,36,538,4727,120,305,16118,2736,18854,-0.0857366,0.374703,-0.923172,1
3124,2546,17,275,2194,41,126,8323,1350,9673,-0.0731425,0.309791,-0.947987,1
1732,1465,12,161,1435,33,92,4930,1595,6525,-0.0555622,0.282107,-0.957773,1
3680,3025,27,335,3023,87,229,10406,4123,14529,-0.0587339,0.281666,-0.957713,1
4514,3081,33,337,2753,86,183,10987,3678,14665,-0.0372066,0.267012,-0.962975,1
4604,2427,31,286,2373,90,163,9974,3853,13827,-0.0182132,0.282077,-0.959219,1
5253,2033,29,245,2033,54,139,9786,4652,14438,-0.00713309,0.282618,-0.959206,1
4359,1676,36,209,1604,61,113,8058,5705,13763,0.0010806,0.269663,-0.962954,1
4343,1401,44,182,1302,66,130,7468,5641,13109,0.00146035,0.324676,-0.945824,1
4277,980,24,112,829,46,64,6332,3382,9714,-0.0126878,0.310037,-0.95064,1
1859,465,12,62,437,16,33,2884,2523,5407,-0.0139978,0.272925,-0.961934,1
2702,833,18,116,693,33,54,4449,4464,8913,-0.0198883,0.279378,-0.959975,1
4404,1264,27,195,1174,45,92,7201,4481,11682,-0.0326043,0.298188,-0.95395,1
4392,1185,31,208,1230,42,93,7181,3218,10399,-0.0322549,0.316307,-0.948108,1
4824,1168,28,158,1067,33,82,7360,2709,10069,-0.0315148,0.29976,-0.953494,1
4565,1083,29,150,1023,34,80,6964,3063,10027,-0.0290417,0.271362,-0.962039,1
4838,970,29,137,927,47,79,7027,2440,9467,-0.0234885,0.268745,-0.962925,1
1978,360,12,53,335,26,28,2792,1150,3942,-0.016653,0.202688,-0.979102,1
4589,789,26,142,1000,58,92,6696,2186,8882,-0.0478005,0.327715,-0.943567,1
4686,769,28,113,473,30,40,6139,1767,7906,-0.0266328,0.269815,-0.962544,1
3159,500,19,74,440,35,37,4264,2491,6755,-0.0296251,0.231839,-0.972303,1
4598,679,35,115,609,52,76,6164,2892,9056,0.0490187,0.290337,-0.955668,1
4242,595,26,93,576,47,52,5631,3298,8929,0.0551393,0.290806,-0.955192,1
2897,309,18,50,266,25,25,3590,1353,4943,0.0714971,0.297593,-0.952012,1
4693,523,27,83,497,42,47,5912,3350,9262,-0.0942842,0.248023,-0.964155,1
4044,473,27,76,418,36,39,5113,2571,7684,-0.0814037,0.245848,-0.965884,1
4018,434,26,80,372,38,41,5009,3440,8449,-0.102154,0.224559,-0.969091,1
4004,379,26,77,331,31,35,4883,2732,7615,-0.0539065,0.221995,-0.973557,1
4012,364,27,66,313,31,33,4846,2710,7556,-0.118161,0.236953,-0.964309,1
3949,349,28,62,291,32,32,4743,2692,7435,-0.133799,0.289146,-0.947888,1
4124,394,27,71,337,28,34,5015,4430,9445,-0.21149,0.275043,-0.937883,1
3183,401,19,59,320,18,29,4029,2381,6410,-0.142099,0.252152,-0.957198,1
1993,351,14,52,309,15,26,2760,1615,4375,-0.0488573,0.195932,-0.9794,1
4068,864,30,124,824,35,66,6011,2559,8570,-0.0512391,0.20556,-0.977302,1
4225,1055,27,140,1006,32,76,6561,1733,8294,-0.0605985,0.206553,-0.976557,1
4087,1392,29,173,1363,31,100,7175,1927,9102,-0.13517,0.235583,-0.962408,1
4207,1936,28,214,1719,39,119,8262,1645,9907,-0.0436098,0.183108,-0.982125,1
4296,2052,26,240,1975,40,137,8766,1541,10307,-0.0556517,0.209576,-0.976208,1
4311,2304,29,272,2246,36,150,9348,1449,10797,-0.0518405,0.177654,-0.982727,1
4405,2516,27,296,2446,40,167,9897,1462,11359,-0.0604967,0.176455,-0.982448,1
4538,2563,27,335,2505,45,182,10195,1477,11672,-0.060047,0.165791,-0.984331,1
4542,2718,28,322,2653,35,182,10480,1378,11858,-0.0605729,0.158252,-0.985539,1
4571,2687,27,332,2685,35,216,10553,1444,11997,-0.0737638,0.169436,-0.982777,1
4648,2897,28,340,2781,34,191,10919,1409,12328,-0.0627598,0.17606,-0.982376,1
4653,3057,28,345,2978,40,196,11297,1415,12712,-0.0728065,0.172573,-0.982302,1
4723,3157,33,389,3005,44,206,11557,1372,12929,-0.0720178,0.201524,-0.976832,1
4883,3721,29,392,3432,47,221,12725,1363,14088,-0.0697635,0.220646,-0.972856,1
5012,3687,29,417,3650,51,238,13084,1345,14429,-0.064939,0.255708,-0.964571,1
3576,2930,24,359,2866,34,187,9976,950,10926,-0.071567,0.207709,-0.975569,1
5430,4824,30,540,4650,30,210,15714,1032,16746,-0.0637968,0.230452,-0.97099,1
3883,3495,21,427,3507,33,232,11598,948,12546,-0.0710835,0.217387,-0.973494,1
6051,5389,30,624,5673,38,250,18055,946,19001,-0.0716289,0.221424,-0.972543,1
4158,5645,27,611,3948,44,225,14658,718,15376,-0.0502041,0.205957,-0.977273,1
3066,2911,14,335,2936,22,194,9478,738,10216,-0.032617,0.196161,-0.980029,1
6513,6265,30,733,6193,28,277,20039,1238,21277,-0.0529627,0.202465,-0.977856,1
4535,4481,20,506,3967,30,219,13758,746,14504,-0.0556244,0.251106,-0.96636,1
3810,4038,19,440,3965,55,249,12576,857,13433,-0.0569299,0.255321,-0.965179,1
6343,6642,27,743,5174,36,288,19253,1094,20347,-0.0411491,0.252942,-0.966606,1
3351,3407,16,357,3344,29,211,10715,782,11497,-0.0367872,0.253532,-0.966627,1
6176,5728,30,628,5245,52,247,18106,978,19084,-0.0498794,0.264786,-0.963016,1
4113,3563,19,414,3502,25,176,11812,731,12543,-0.0479795,0.221766,-0.973919,1
6115,4988,29,598,5697,73,316,17816,1416,19232,-0.0445883,0.21296,-0.976043,1
6091,5027,30,572,3527,34,211,15492,977,16469,-0.0442433,0.189332,-0.980916,1
3116,2450,15,292,2427,35,155,8490,753,9243,-0.039971,0.184892,-0.981946,1
3745,2975,18,350,2901,27,187,10203,957,11160,-0.039105,0.160951,-0.986188,1
6310,4687,29,565,4450,43,290,16374,1394,17768,-0.0412649,0.162738,-0.985806,1
5911,4452,28,514,3265,39,257,14466,1023,15489,-0.0395589,0.149873,-0.987914,1
5917,4552,30,534,3864,35,207,15139,945,16084,-0.0354918,0.146825,-0.988525,1
3057,2390,15,274,2395,23,156,8310,746,9056,-0.0365003,0.153791,-0.987429,1
5907,4592,27,527,4532,59,299,15943,1382,17325,-0.0424072,0.158026,-0.986524,1
5963,4758,32,578,3593,38,228,15190,984,16174,-0.0343718,0.151722,-0.987825,1
3079,2550,15,279,2641,26,161,8751,810,9561,-0.0345585,0.148727,-0.988274,1
5924,4813,28,529,4735,51,304,16384,1364,17748,-0.0365853,0.150443,-0.987942,1
4066,3285,26,370,3294,31,211,11283,978,12261,-0.044804,0.160499,-0.986019,1
5289,4349,25,479,4258,41,273,14714,1277,15991,-0.0404881,0.166655,-0.985184,1
3736,3078,17,347,3015,29,194,10416,898,11314,-0.0423749,0.170283,-0.984484,1
4765,3984,25,452,3968,37,271,13502,1140,14642,-0.0408241,0.166555,-0.985187,1
5800,4674,28,531,4618,46,303,16000,1426,17426,-0.0380407,0.155379,-0.987122,1
4842,3033,15,279,2373,23,156,10721,767,11488,-0.0417316,0.160357,-0.986176,1
2329,1648,9,189,1616,15,106,5912,515,6427,-0.0410659,0.162038,-0.98593,1
1966,1548,9,183,1496,15,99,5316,471,5787,-0.0378926,0.153288,-0.987455,1
5890,5032,39,550,4625,67,324,16527,1380,17907,-0.0419298,0.152205,-0.987459,1
5979,3929,20,363,3124,38,160,13613,784,14397,-0.0481335,0.167452,-0.984705,1
3058,2423,14,277,2440,22,164,8398,748,9146,-0.0389455,0.154721,-0.98719,1
5842,4550,27,519,4558,50,299,15845,1440,17285,-0.0391285,0.153238,-0.987415,1
5921,4635,30,532,3661,32,208,15019,970,15989,-0.0371441,0.144741,-0.988772,1
3084,2492,15,280,2473,33,164,8541,747,9288,-0.0435049,0.158953,-0.986327,1
5870,4656,27,528,4650,46,302,16079,1383,17462,-0.0387688,0.156471,-0.986921,1
4203,3184,19,365,3256,30,209,11266,1035,12301,-0.0376099,0.167177,-0.985209,1
6405,4852,29,592,4570,46,229,16723,977,17700,-0.0401675,0.158127,-0.986602,1
4088,3303,18,371,2857,34,160,10831,750,11581,-0.0408718,0.166445,-0.985203,1
6342,4995,31,546,3934,34,210,16092,986,17078,-0.0377502,0.159809,-0.986426,1
3130,2466,15,281,2538,27,161,8618,727,9345,-0.0364335,0.145504,-0.988687,1
5997,4663,31,546,4723,46,304,16310,1442,17752,-0.0385691,0.160968,-0.986206,1
4068,3268,20,370,3189,32,211,11158,969,12127,-0.0387994,0.162928,-0.985875,1
5989,4761,29,532,3966,34,210,15521,961,16482,-0.0385402,0.162954,-0.985881,1
4125,3597,22,391,3366,48,227,11776,1029,12805,-0.0401838,0.155131,-0.987076,1
3814,3037,18,343,2980,38,194,10424,1002,11426,-0.0444727,0.169206,-0.984577,1
6273,4764,29,533,4688,53,264,16604,951,17555,-0.0431336,0.167996,-0.984844,1
5509,4624,31,595,3519,35,210,14523,946,15469,-0.048299,0.163437,-0.985371,1
3100,2515,16,286,2453,28,160,8558,741,9299,-0.0431136,0.155507,-0.986894,1
6369,4725,28,543,4653,49,307,16674,1113,17787,-0.0365371,0.167514,-0.985193,1
4147,3333,21,370,3649,48,233,11801,1024,12825,-0.0379127,0.156698,-0.986919,1
5965,4511,41,339,2917,27,192,13992,900,14892,-0.0344984,0.172155,-0.984465,1
2922,2329,14,269,2315,29,153,8031,715,8746,-0.0386416,0.155608,-0.987063,1
5395,4373,30,684,4782,54,271,15589,1438,17027,-0.0381318,0.16538,-0.985493,1
3878,3243,20,349,3146,35,195,10866,890,11756,-0.0413204,0.167245,-0.985049,1
6072,5181,27,539,4899,48,287,17053,972,18025,-0.0459762,0.176693,-0.983192,1
4117,3187,15,280,2519,25,159,10302,749,11051,-0.0450204,0.171016,-0.984239,1
3059,2574,18,265,2454,27,152,8549,698,9247,-0.0370205,0.165831,-0.985459,1
5854,4722,28,533,4208,45,207,15597,955,16552,-0.045222,0.158195,-0.986372,1
4080,3343,22,372,3227,33,209,11286,964,12250,-0.0458656,0.172601,-0.983923,1
4051,3407,19,427,3271,34,210,11419,993,12412,-0.0389167,0.156557,-0.986902,1
5261,4315,26,487,4244,41,278,14652,1260,15912,-0.0428878,0.152613,-0.987355,1
5287,4363,25,500,4297,49,274,14795,1235,16030,-0.0469332,0.173075,-0.98379,1
3777,3049,18,345,3009,30,194,10422,913,11335,-0.0441354,0.157904,-0.986468,1
5984,4993,37,694,4426,48,212,16394,972,17366,-0.0491655,0.169966,-0.984223,1
6094,4868,31,617,4774,47,307,16738,1380,18118,-0.0355239,0.169509,-0.984888,1
3069,2516,15,365,2509,33,135,8642,639,9281,-0.0503358,0.163983,-0.985178,2
1805,1438,9,161,1419,21,91,4944,445,5389,-0.0409494,0.160246,-0.986228,2
3611,3040,18,407,2995,34,226,10331,895,11226,-0.0393391,0.160477,-0.986256,2
5895,4827,50,553,4598,31,210,16164,952,17116,-0.0388551,0.152879,-0.987481,2
5848,4759,28,534,4345,32,210,15756,984,16740,-0.0432661,0.164846,-0.98537,2
3194,2496,13,228,1981,19,127,8058,591,8649,-0.0474824,0.173473,-0.983694,2
6058,4379,21,415,3220,41,210,14344,816,15160,-0.0389707,0.151658,-0.987665,2
2512,2036,12,227,2012,20,130,6949,595,7544,-0.0411388,0.167796,-0.984963,2
5971,4822,27,534,4691,55,247,16347,1008,17355,-0.039137,0.154365,-0.987238,2
4151,3324,23,378,2520,25,160,10581,757,11338,-0.0405127,0.168141,-0.98493,2
2354,1675,23,189,1688,18,117,6064,476,6540,-0.0436176,0.163442,-0.985588,2
2683,2114,13,239,2110,23,138,7320,635,7955,-0.0403773,0.158479,-0.986537,2
5733,4451,25,490,4430,55,276,15460,1010,16470,-0.0440237,0.162485,-0.985729,2
3730,3099,18,344,3036,30,218,10475,919,11394,-0.0404964,0.162473,-0.985882,2
7150,4314,27,505,3941,39,198,16174,896,17070,-0.046196,0.164917,-0.985225,2
2912,2385,14,264,2316,24,147,8062,706,8768,-0.0394483,0.165468,-0.985426,2
5545,4206,25,477,4334,62,273,14922,1235,16157,-0.0378761,0.15722,-0.986837,2
5667,4452,26,395,3017,27,192,13776,895,14671,-0.0481251,0.160212,-0.985909,2
2909,2393,14,293,2428,23,152,8212,725,8937,-0.0402066,0.166676,-0.985192,2
5915,4738,29,531,4545,43,272,16073,1353,17426,-0.0406728,0.160791,-0.98615,2
5253,4625,27,489,3611,37,194,14236,881,15117,-0.0453473,0.159828,-0.986103,2
3525,2901,17,331,2859,28,183,9844,846,10690,-0.0397375,0.153151,-0.987403,2
5923,4484,26,495,4503,59,306,15796,1468,17264,-0.0412499,0.160324,-0.986202,2
4073,3312,19,365,2644,23,159,10595,799,11394,-0.0406092,0.161047,-0.986111,2
4379,3729,23,419,3476,52,227,12305,1043,13348,-0.0399044,0.164548,-0.985561,2
5886,4827,29,542,4352,31,209,15876,995,16871,-0.0402322,0.153566,-0.987319,2
4080,3302,20,365,3241,33,214,11255,982,12237,-0.0387189,0.1642,-0.985667,2
5382,4333,25,481,4203,43,271,14738,1186,15924,-0.0430303,0.16957,-0.984578,2
3885,3079,22,356,3086,28,194,10650,901,11551,-0.040274,0.15433,-0.987198,2
3493,2887,18,356,2809,25,184,9772,846,10618,-0.043904,0.169381,-0.984572,2
5887,4941,29,599,4470,43,274,16243,1153,17396,-0.0345192,0.172115,-0.984472,2
3858,3119,19,341,3118,28,203,10686,907,11593,-0.0488018,0.168534,-0.984487,2
5025,3904,23,460,3777,40,245,13474,1174,14648,-0.040502,0.167327,-0.985069,2
5003,4526,25,443,3360,33,180,13570,848,14418,-0.0386429,0.159549,-0.986433,2
3507,2769,17,312,2762,31,183,9581,852,10433,-0.0397489,0.155679,-0.987008,2
5966,4550,25,492,4216,56,271,15576,1236,16812,-0.0360967,0.151467,-0.987803,2
3780,3071,17,338,3039,44,197,10486,920,11406,-0.0443331,0.163205,-0.985596,2
4795,3943,23,434,3914,56,245,13410,1181,14591,-0.0411966,0.158419,-0.986512,2
5392,4384,24,476,4404,65,289,15034,1054,16088,-0.0416508,0.167256,-0.985034,2
5759,4590,34,549,4239,39,215,15425,925,16350,-0.041672,0.160839,-0.986101,2
3847,3087,29,357,2418,22,149,9909,686,10595,-0.042082,0.163795,-0.985597,2
2377,1948,12,214,1877,20,131,6579,596,7175,-0.0467576,0.166495,-0.984933,2
5475,4339,26,466,4139,55,264,14764,1246,16010,-0.0533896,0.171237,-0.983783,2
6688,4122,27,482,3083,39,188,14629,899,15528,-0.0530928,0.190969,-0.980159,2
2848,2238,14,244,2247,22,142,7755,730,8485,-0.0478528,0.175743,-0.983273,2
5885,5090,27,494,4268,51,287,16102,1414,17516,-0.0520931,0.192698,-0.979875,2
4006,3064,20,339,2987,34,188,10638,996,11634,-0.0495666,0.181094,-0.982216,2
5322,3595,26,411,3567,59,237,13217,1152,14369,-0.0457034,0.171363,-0.984147,2
3636,2545,18,320,2813,51,192,9575,955,10530,-0.042914,0.169359,-0.98462,2
5525,3683,37,422,3637,52,241,13597,1340,14937,-0.0409842,0.16989,-0.98461,2
3821,2547,19,286,2534,38,179,9424,1055,10479,-0.0422444,0.183653,-0.982083,2
6181,3469,29,409,3414,65,227,13794,1462,15256,-0.0405165,0.19271,-0.980419,2
5522,3429,29,365,2281,34,153,11813,970,12783,-0.0446992,0.171296,-0.984205,2
4546,2929,26,343,3093,53,182,11172,1167,12339,-0.044717,0.179995,-0.982651,2
5419,3300,30,379,3335,55,218,12736,1469,14205,-0.0456501,0.169431,-0.984484,2
5600,3353,31,366,2835,38,146,12369,984,13353,-0.0423686,0.161565,-0.985952,2
2835,1627,16,184,1608,30,107,6407,776,7183,-0.0410276,0.14908,-0.987974,2
5416,3159,29,345,2994,56,199,12198,1415,13613,-0.0459936,0.159751,-0.986085,2
5408,2791,20,234,1943,62,132,10590,987,11577,-0.0421577,0.172394,-0.984125,2
2890,1500,15,174,1474,25,100,6178,762,6940,-0.0450224,0.171162,-0.984214,2
5295,2799,29,321,2654,41,183,11322,1386,12708,-0.0613697,0.178301,-0.982061,2
5203,2704,31,311,2571,49,176,11045,1473,12518,-0.0728928,0.191082,-0.978864,2
5108,2508,30,335,2535,41,171,10728,1024,11752,-0.0775012,0.179333,-0.980731,2
3678,1623,21,199,1697,32,115,7365,969,8334,-0.0735348,0.193133,-0.978413,2
4941,2205,30,272,2290,46,158,9942,1502,11444,-0.0711914,0.188987,-0.979396,2
4758,2107,29,262,2020,46,148,9370,1487,10857,-0.077318,0.224691,-0.971358,2
4977,1972,30,249,1888,49,137,9302,1502,10804,-0.077035,0.234136,-0.969147,2
4895,1998,31,237,1846,43,136,9186,1698,10884,-0.0849032,0.248973,-0.964782,2
4489,1941,51,232,1779,43,131,8666,2741,11407,-0.081908,0.231828,-0.969302,2
4459,1719,28,257,1629,42,152,8286,1943,10229,-0.0724653,0.270572,-0.959969,2
5051,1639,27,211,1639,39,139,8745,1681,10426,-0.0661469,0.265626,-0.961804,2
3985,1599,25,227,1636,45,119,7636,1817,9453,0.0344609,0.348687,-0.936606,2
4047,1493,25,197,1453,41,107,7363,1990,9353,0.0347195,0.323238,-0.94568,2
3803,1503,27,194,1421,38,107,7093,1930,9023,0.0180727,0.334938,-0.942067,2
3800,1471,25,194,1422,39,105,7056,1834,8890,0.0211949,0.335971,-0.941634,2
3780,1465,26,193,1398,40,105,7007,1634,8641,-0.106479,0.303581,-0.946837,2
3743,1468,27,188,1466,36,109,7037,1684,8721,-0.101862,0.294356,-0.950252,2
3815,1445,26,193,1421,32,108,7040,1857,8897,-0.0968897,0.281823,-0.954562,2
3708,1510,25,186,1379,32,104,6944,1732,8676,-0.098132,0.297279,-0.949735,2
3698,1434,25,199,1404,36,105,6901,1718,8619,-0.0883476,0.311945,-0.945984,2
3731,1511,38,265,1693,38,112,7388,1521,8909,-0.0827747,0.320064,-0.943773,2
4253,1538,26,191,1456,32,111,7607,1483,9090,-0.0771671,0.338749,-0.937707,2
3991,1619,26,207,1621,37,119,7620,1436,9056,-0.0685427,0.377352,-0.92353,2
3904,1790,27,219,1717,35,148,7840,1375,9215,-0.0703998,0.376809,-0.923612,2
3948,1876,27,270,1808,38,131,8098,1579,9677,-0.0683068,0.376419,-0.923928,2
4216,2100,38,238,1898,38,137,8665,1398,10063,-0.0621085,0.390204,-0.918631,2
4347,1896,28,232,1796,38,128,8465,1571,10036,-0.0574546,0.378855,-0.923671,2
4209,1963,26,231,1803,39,129,8400,1710,10110,-0.0535722,0.383374,-0.922038,2
4583,2020,27,241,1984,42,141,9038,1615,10653,-0.0532844,0.383371,-0.922056,2
4172,2238,28,263,2084,41,147,8973,1961,10934,-0.054359,0.36066,-0.931112,2
4967,2793,32,332,2799,50,171,11144,2025,13169,-0.00908275,0.113582,-0.993487,2
4341,2828,29,337,2706,62,187,10490,1433,11923,-0.00257723,0.115271,-0.993331,2
5031,3559,31,406,3471,88,245,12831,1665,14496,0.00884147,0.121279,-0.992579,2
5088,3629,38,413,3392,71,235,12866,1582,14448,0.00170341,0.138125,-0.990414,2
4575,3640,32,459,3702,126,252,12786,1559,14345,-0.0216836,0.185562,-0.982393,2
4707,3938,33,452,4215,60,326,13731,1561,15292,-0.0351187,0.388032,-0.920977,2
3422,2758,22,340,2691,26,183,9442,982,10424,-0.041309,0.353281,-0.934605,2
5136,3984,35,480,3944,42,315,13936,1410,15346,-0.0527875,0.373437,-0.926153,2
4953,4179,33,519,4111,43,282,14120,1511,15631,-0.0481311,0.355604,-0.933397,2
3444,2890,24,357,2877,29,195,9816,970,10786,-0.0317868,0.342373,-0.939026,2
3469,3092,26,351,3001,29,199,10167,971,11138,-0.0397571,0.341592,-0.939007,2
5929,4963,36,598,5034,73,303,16936,1318,18254,-0.0265814,0.376718,-0.925947,2
3565,3251,23,386,3235,27,208,10695,979,11674,-0.033312,0.34275,-0.938836,2
4099,3549,27,403,3554,45,228,11905,1163,13068,-0.018368,0.353961,-0.93508,2
3828,3212,26,383,3109,40,204,10802,1123,11925,-0.0236477,0.326541,-0.944887,2
4524,3356,31,397,3418,39,220,11985,1366,13351,-0.0174388,0.355251,-0.934608,2
4743,3267,33,393,3247,58,216,11957,1735,13692,-0.0423126,0.341074,-0.939083,2
4712,2764,34,321,2646,50,180,10707,2070,12777,-0.0423207,0.327086,-0.944047,2
3914,2110,28,250,1975,94,137,8508,2315,10823,-0.0644506,0.344217,-0.936675,2
4165,1778,28,206,1601,45,113,7936,2595,10531,-0.0525591,0.349126,-0.935601,2
5683,1487,34,194,1511,46,112,9067,2941,12008,-0.034323,0.360236,-0.932229,2
4612,1151,34,155,1062,39,87,7140,3173,10313,-0.0303942,0.377812,-0.925383,2
4296,802,28,117,782,40,65,6130,2729,8859,0.000410755,0.380275,-0.924873,2
4420,892,34,152,836,35,60,6429,2896,9325,0.0111555,0.12854,-0.991642,2
4209,575,27,92,523,31,47,5504,3000,8504,-0.0013322,0.383173,-0.923676,2
4381,528,28,88,474,32,46,5577,3399,8976,0.0364341,0.40323,-0.914373,2
4369,479,27,79,429,31,41,5455,3612,9067,0.0392237,0.462577,-0.885711,2
4074,310,20,58,277,21,27,4787,1946,6733,0.0384941,0.39276,-0.918835,2
3126,311,17,52,257,20,25,3808,1529,5337,0.0284179,0.379011,-0.924956,2
4851,472,27,80,424,34,45,5933,2099,8032,0.0539643,0.374806,-0.925531,2
4725,409,27,73,376,31,39,5680,2797,8477,0.0996812,0.409766,-0.906728,2
4535,346,27,64,293,29,32,5326,2259,7585,0.0764476,0.39696,-0.914647,2
4231,354,26,98,351,36,48,5144,2009,7153,0.0687771,0.380215,-0.922337,2
5214,464,28,77,359,40,36,6218,2495,8713,0.0729752,0.356196,-0.931557,2
4122,415,28,106,377,43,41,5132,2699,7831,0.077869,0.385491,-0.91942,2
4686,412,26,73,358,30,36,5621,2074,7695,0.0691746,0.367641,-0.927391,2
4495,350,28,67,291,37,32,5300,2324,7624,0.0853121,0.345587,-0.934501,2
4597,382,37,69,312,37,34,5468,2675,8143,0.0606227,0.390236,-0.918717,2
4896,374,32,74,306,38,34,5754,2604,8358,0.0363397,0.379792,-0.924358,2
2934,293,20,69,232,25,25,3598,1411,5009,0.0790532,0.323359,-0.942969,2
2143,245,15,41,212,18,20,2694,898,3592,0.0637493,0.319931,-0.945293,2
4041,595,28,116,530,44,50,5404,1851,7255,0.0397629,0.328591,-0.943635,2
4278,834,27,113,728,32,59,6071,1619,7690,0.056979,0.312739,-0.948129,2
4198,1027,28,139,930,37,77,6436,1465,7901,0.0542905,0.335243,-0.940566,2
4913,1396,33,185,1235,37,89,7888,1725,9613,-0.0444111,0.351468,-0.935146,2
4711,1569,29,197,1545,58,131,8240,1583,9823,-0.0423792,0.389653,-0.919986,2
4669,1951,28,244,1896,39,134,8961,1436,10397,0.00682776,0.387694,-0.921763,2
4485,2573,28,282,2301,43,168,9880,1403,11283,-0.057163,0.394821,-0.916978,2
5670,3193,36,393,3081,56,208,12637,1222,13859,-0.0801675,0.388871,-0.917798,2
3734,2830,19,318,2767,29,181,9878,941,10819,-0.0721402,0.3712,-0.925746,2
6701,5019,29,572,4935,41,241,17538,1017,18555,-0.0854003,0.361456,-0.92847,2
4441,3812,27,441,3517,27,192,12457,744,13201,-0.0703795,0.342772,-0.936779,2
5564,4985,24,560,4916,56,315,16420,1133,17553,-0.0883704,0.364229,-0.927108,2
4018,4275,17,441,3821,37,243,12852,855,13707,-0.0838294,0.334935,-0.938505,2
6681,5288,21,581,3792,27,221,16611,766,17377,-0.0665978,0.326259,-0.942932,2
2759,2888,13,314,2846,21,217,9058,608,9666,-0.053446,0.309518,-0.94939,2
4914,5087,23,560,5078,51,306,16019,973,16992,-0.0561691,0.332599,-0.941394,2
3500,3495,15,402,3504,31,216,11163,776,11939,-0.0562063,0.340241,-0.938657,2
6121,5821,27,637,4904,35,243,17788,980,18768,-0.0583956,0.349171,-0.935238,2
3084,2670,15,293,2633,30,167,8892,740,9632,-0.058526,0.318218,-0.946209,2
5892,4336,27,481,4243,55,282,15316,1431,16747,-0.0595063,0.349314,-0.935114,2
3746,2364,20,278,2305,38,178,8929,994,9923,-0.0508391,0.323413,-0.944891,2
5422,2705,34,329,2726,45,185,11446,1402,12848,-0.0852567,0.377628,-0.922024,2
5009,2166,29,264,2194,49,155,9866,1453,11319,-0.0893946,0.371651,-0.924059,2
4461,1728,25,208,1600,38,117,8177,1289,9466,-0.0751784,0.370524,-0.925776,2
5493,1942,44,225,1757,44,127,9632,1621,11253,-0.0811821,0.39123,-0.916705,2
5073,1831,30,217,1628,55,120,8954,1805,10759,-0.0900624,0.417531,-0.904188,2
4936,1687,29,211,1176,28,83,8150,1066,9216,-0.0922095,0.40378,-0.910197,2
2596,768,13,86,666,18,49,4196,862,5058,-0.0807336,0.354202,-0.931678,2
4659,1557,28,197,1526,40,114,8121,1743,9864,-0.0828186,0.347138,-0.93415,2
4517,1567,29,198,1487,42,109,7949,2588,10537,-0.077271,0.359905,-0.929784,2
3043,936,14,100,748,26,56,4923,1672,6595,-0.0817472,0.358553,-0.929923,2
1849,592,12,75,571,23,43,3165,1899,5064,0.0144605,0.347644,-0.937515,2
4491,1230,27,169,1194,35,92,7238,3173,10411,0.0305482,0.374032,-0.926913,2
4539,1164,34,239,1570,56,130,7732,2791,10523,0.00398195,0.381451,-0.924381,2
4301,1075,28,140,1055,40,84,6723,2106,8829,-0.0823069,0.335,-0.938616,2
4021,1164,31,148,1027,46,78,6515,3210,9725,-0.10125,0.420135,-0.901796,2
4203,1090,25,146,1070,37,82,6653,3369,10022,-0.111879,0.439496,-0.89125,2
3889,1159,25,166,1089,32,84,6444,2882,9326,-0.0878111,0.343592,-0.935005,2
3907,1205,25,157,1169,36,89,6588,2557,9145,-0.108559,0.378571,-0.919184,2
3813,1181,25,155,1223,53,92,6542,4149,10691,-0.121496,0.448752,-0.885359,2
3906,1196,27,160,1212,46,116,6663,3406,10069,-0.114609,0.457611,-0.881735,2
3830,1318,27,171,1286,34,98,6764,3443,10207,-0.0912704,0.438158,-0.894253,2
4442,1442,27,184,1391,34,104,7624,4136,11760,-0.0928858,0.448491,-0.888948,2
3942,1615,27,198,1851,54,167,7854,2960,10814,-0.0999536,0.433153,-0.895761,2
2123,1026,14,121,942,23,74,4323,1241,5564,-0.0918238,0.41529,-0.905043,2
4102,2040,28,251,2094,33,172,8720,2421,11141,-0.0351877,0.125598,-0.991457,2
4277,2352,29,323,2247,38,161,9427,2862,12289,-0.0936082,0.469224,-0.878104,2
4280,2535,27,297,2480,36,169,9824,2591,12415,-0.0960719,0.469714,-0.877576,2
2279,1449,22,140,1168,14,78,5150,1044,6194,-0.0896214,0.439062,-0.893975,2
4039,3230,29,368,3198,38,210,11112,1921,13033,-0.0228969,0.112239,-0.993417,2
5017,3411,30,398,3394,41,231,12522,2090,14612,-0.0555694,0.149154,-0.987251,2
4740,3440,28,404,3335,50,232,12229,3584,15813,-0.0679273,0.42001,-0.904974,2
4798,3515,32,432,3460,43,242,12522,2572,15094,-0.061549,0.428887,-0.901259,2
4877,3551,32,427,3479,49,240,12655,1553,14208,-0.0879914,0.376135,-0.922377,2
5442,3969,33,490,3814,42,298,14088,1468,15556,-0.0761449,0.412315,-0.907853,2
5150,3936,34,513,2823,27,185,12668,966,13634,-0.0875798,0.395782,-0.914159,2
2695,2158,17,261,2181,23,145,7480,733,8213,-0.101118,0.386227,-0.916844,2
5201,4210,33,545,4203,46,336,14574,1455,16029,-0.0833035,0.422327,-0.902608,2
5430,4103,23,349,2686,37,180,12808,963,13771,-0.0614785,0.424786,-0.903204,2
2654,1889,19,214,1883,26,124,6809,757,7566,-0.0636471,0.400753,-0.913972,2
4569,3131,34,354,2923,36,203,11250,1488,12738,-0.0529704,0.414804,-0.908368,2
4394,2531,30,378,2112,41,121,9607,1330,10937,-0.0525711,0.401976,-0.91414,2
2121,1132,15,138,1084,34,77,4601,1122,5723,-0.0234881,0.375425,-0.926555,2
4094,2379,30,223,1692,33,123,8574,1486,10060,0.0384798,0.131267,-0.9906,2
3832,1519,27,188,1420,34,108,7128,1670,8798,0.031053,0.11272,-0.993141,2
4511,1102,28,151,1092,31,85,7000,2229,9229,0.0171193,0.108344,-0.993966,2
4182,919,28,125,811,30,71,6166,3609,9775,-0.00999062,0.361129,-0.932463,2
3974,611,24,111,583,26,51,5380,1865,7245,-0.000285942,0.108289,-0.994119,2
3872,551,25,92,503,26,44,5113,2602,7715,-0.0329218,0.398742,-0.916472,2
4215,630,28,93,538,28,50,5582,2874,8456,-0.0372961,0.395631,-0.917652,2
4271,543,26,98,501,29,49,5517,2374,7891,-0.0103486,0.373618,-0.927525,2
4834,665,28,82,466,32,45,6152,2648,8800,-0.00221235,0.377501,-0.926007,2
4485,486,26,82,428,28,41,5576,2257,7833,-0.0045728,0.392479,-0.91975,2
4241,465,27,77,428,31,41,5310,2145,7455,-0.011225,0.373298,-0.927644,2
4268,501,32,81,419,29,40,5370,2249,7619,-0.0102273,0.381061,-0.924494,2
4347,491,27,78,417,29,39,5428,2529,7957,0.0131836,0.37578,-0.926615,2
4532,504,27,82,453,31,43,5672,2816,8488,-0.0286622,0.465774,-0.88444,2
4582,523,27,82,487,31,47,5779,3497,9276,-0.0136415,0.445457,-0.8952,2
3177,300,19,51,264,20,25,3856,1875,5731,0.0381579,0.361407,-0.931627,2
2888,291,18,47,236,18,23,3521,1344,4865,0.0448737,0.366353,-0.929393,2
4556,575,27,80,417,32,39,5726,2837,8563,0.048485,0.378226,-0.924443,2
4500,501,27,82,438,32,42,5622,2190,7812,0.0496776,0.399467,-0.915401,2
4558,537,27,86,479,50,44,5781,1994,7775,0.053184,0.399133,-0.915349,2
4819,792,46,135,726,53,73,6644,2874,9518,0.0504676,0.420397,-0.905936,2
2986,397,20,62,358,21,32,3876,1497,5373,0.0591406,0.388863,-0.919396,2
4416,578,29,92,623,48,55,5841,1768,7609,0.038844,0.419932,-0.906724,2
5153,673,35,131,643,40,57,6732,1718,8450,0.0712219,0.434294,-0.897952,2
4143,631,33,131,608,40,57,5643,1569,7212,0.0559329,0.413334,-0.90886,2
4546,800,30,116,724,35,60,6311,1623,7934,0.0841177,0.416702,-0.905143,2
4200,1097,30,146,1016,33,81,6603,1587,8190,-0.0901019,0.382838,-0.919411,2
4538,1566,27,196,1470,31,107,7935,1635,9570,-0.0175928,0.431541,-0.901922,2
4746,2357,31,285,2279,37,184,9919,1432,11351,-0.0163814,0.467583,-0.883797,2
5249,3220,29,369,2908,33,148,11956,985,12941,-0.0508337,0.450005,-0.891578,2
3132,2130,16,247,2221,28,141,7915,737,8652,-0.0704018,0.43742,-0.896498,2
6075,4646,28,549,4614,50,309,16271,1467,17738,-0.0837983,0.443699,-0.892249,2
6325,4274,36,402,3276,29,176,14518,749,15267,-0.0830032,0.432713,-0.897703,2
6639,5356,45,419,3671,58,238,16426,873,17299,-0.0672079,0.398522,-0.914693,2
3306,2898,16,321,2841,29,183,9594,732,10326,-0.0820231,0.367046,-0.92658,2
5304,4405,23,476,4272,51,290,14821,1183,16004,-0.0662334,0.388479,-0.919074,2
3545,2705,17,318,2817,61,258,9721,912,10633,-0.0322784,0.356555,-0.933716,2
3369,2162,16,243,2096,33,141,8060,889,8949,-0.0387786,0.340516,-0.939439,2
4703,2100,20,252,2189,34,169,9467,1091,10558,-0.0544965,0.347633,-0.936046,2
3747,1686,25,224,1625,34,117,7458,1083,8541,-0.0645558,0.334857,-0.940055,2
4946,1916,30,245,1781,47,133,9098,1399,10497,-0.0636734,0.347053,-0.935682,2
4921,1661,30,221,1610,39,123,8605,1646,10251,-0.0527439,0.377207,-0.924626,2
4895,1622,30,212,1598,45,121,8523,1486,10009,-0.0719828,0.380624,-0.921924,2
4973,1650,31,213,1513,39,113,8532,1619,10151,-0.0864124,0.393321,-0.915332,2
4843,1553,31,202,1542,87,117,8375,1593,9968,-0.0934932,0.404852,-0.90959,2
4890,1613,31,233,1515,41,111,8434,1891,10325,-0.0983159,0.405748,-0.908682,2
4553,1510,26,192,1471,36,110,7898,1819,9717,-0.0962063,0.388564,-0.916386,2
4474,1472,29,196,1528,44,112,7855,1564,9419,-0.0856314,0.390264,-0.916713,2
4700,1439,27,212,1371,35,107,7891,1674,9565,-0.0755358,0.408822,-0.909483,2
4042,1393,29,181,1436,44,109,7234,1537,8771,-0.075408,0.377292,-0.923019,2
4181,1386,25,179,1304,39,101,7215,1432,8647,-0.0657812,0.442095,-0.894553,2
3831,1275,25,170,1254,47,125,6727,1391,8118,-0.0662106,0.423171,-0.903627,2
3818,1327,24,175,1242,36,95,6717,1393,8110,-0.0685434,0.420278,-0.904803,2
3812,1402,24,180,1338,33,100,6889,1420,8309,-0.0753414,0.423366,-0.902821,2
3903,1545,26,194,1451,33,105,7257,1368,8625,-0.0940689,0.502093,-0.859682,2
4365,1559,27,200,1531,34,140,7856,1613,9469,-0.0883804,0.465083,-0.880844,2
4051,1660,27,237,1596,58,141,7770,1424,9194,-0.0927931,0.391628,-0.915433,2
3929,1911,27,201,1582,40,115,7805,1653,9458,-0.0909485,0.379508,-0.920708,2
4240,1617,26,196,1454,57,112,7702,1729,9431,-0.0140694,0.115389,-0.993221,2
4263,1576,27,196,1497,54,134,7747,1484,9231,-0.00809646,0.121641,-0.992541,2
4327,1788,27,227,1662,53,123,8207,1432,9639,-0.00695427,0.135069,-0.990812,2
4209,2084,26,246,2022,42,180,8809,1753,10562,-0.00240423,0.14396,-0.989581,2
4560,2287,34,308,2321,33,163,9706,1385,11091,0.00233905,0.166612,-0.98602,2
4614,2700,27,320,2607,37,183,10488,1476,11964,-0.0246556,0.216972,-0.975867,2
4545,2651,28,343,2592,46,172,10377,1068,11445,-0.0215978,0.227703,-0.973491,2
4711,2686,26,347,2595,50,187,10602,1421,12023,-0.0293286,0.2575,-0.965833,2
4751,2604,28,351,2531,68,184,10517,1398,11915,-0.0249005,0.26462,-0.964031,2
4835,2436,29,301,2281,42,199,10123,1413,11536,-0.00589124,0.218075,-0.975914,2
4885,2385,31,299,2311,54,169,10134,1400,11534,0.00243377,0.191972,-0.981397,2
4892,2365,28,297,2316,55,170,10123,1490,11613,0.00854368,0.206868,-0.978332,2
5235,2457,34,341,2396,80,170,10713,1514,12227,0.00763384,0.202537,-0.979245,2
5186,2340,31,275,2247,45,189,10313,1594,11907,0.00457078,0.21396,-0.976832,2
4663,1740,29,228,1798,109,130,8697,1409,10106,-0.00359831,0.219906,-0.975514,2
3763,1032,19,139,963,35,73,6024,997,7021,-0.000101769,0.171596,-0.985167,2
4395,1373,27,183,1420,49,105,7552,2734,10286,-0.00863674,0.193908,-0.980982,2
4467,1269,26,169,1245,55,103,7334,6889,14223,-0.0622503,0.629085,-0.77484,2
2757,680,18,94,625,24,54,4252,3413,7665,-0.0176638,0.655114,-0.755323,2
3998,755,27,116,817,48,69,5830,-1000,-1000,-1,-1,-1,2
1446,227,10,35,198,11,18,1945,-1000,-1000,-1,-1,-1,2
4390,572,43,117,623,33,53,5831,20551,26382,0.0157944,0.173581,-0.984693,2
2002,223,12,37,191,13,18,2496,1201,3697,0.0113685,0.144258,-0.989475,2
1237,152,9,24,133,9,13,1577,622,2199,0.0181252,0.114621,-0.993244,2
3367,367,22,63,327,21,32,4199,1765,5964,0.00837987,0.115992,-0.993215,2
4162,527,27,82,452,38,51,5339,3068,8407,-0.0109401,0.119962,-0.992718,2
4273,517,26,81,433,35,40,5405,6163,11568,-0.0397234,0.366241,-0.929672,2
4488,453,28,78,375,32,38,5492,3856,9348,-0.035724,0.352033,-0.935306,2
5216,512,29,81,376,30,39,6283,3599,9882,-0.0297932,0.372063,-0.92773,2
4656,417,28,75,359,30,36,5601,3606,9207,-0.0516868,0.396771,-0.916462,2
5240,453,35,105,438,31,45,6347,2729,9076,-0.0500483,0.47903,-0.876371,2
4617,391,17,50,253,20,26,5374,1563,6937,-0.0421668,0.436648,-0.898644,2
2839,253,15,41,200,14,19,3381,1346,4727,-0.0231227,0.374778,-0.926826,2
2799,265,16,48,234,17,23,3402,1042,4444,-0.013725,0.360248,-0.932756,2
4264,573,26,84,457,47,46,5497,1944,7441,-0.0110807,0.387306,-0.921885,2
4700,476,34,104,477,39,52,5882,1904,7786,-0.000828657,0.379995,-0.924988,2
4284,435,26,76,413,33,44,5311,1588,6899,0.00638607,0.371524,-0.928401,2
4508,433,28,78,371,36,37,5491,1568,7059,-0.0477587,0.322689,-0.945299,2
4135,537,28,105,418,40,44,5307,1393,6700,-0.0440858,0.30988,-0.949753,2
4411,667,28,101,595,34,54,5890,1421,7311,-0.0468432,0.315197,-0.947869,2
4483,1017,37,147,864,35,74,6657,1417,8074,-0.0494433,0.331064,-0.942312,2
4293,1282,34,171,1235,34,97,7146,1423,8569,-0.0685405,0.359027,-0.930807,2
4947,1762,31,240,1710,32,126,8848,1486,10334,-0.0551668,0.3513,-0.934636,2
4761,2414,69,329,2389,41,162,10165,1360,11525,-0.0318076,0.397389,-0.917099,2
5165,3094,29,368,3025,65,219,11965,1487,13452,-0.0361986,0.412031,-0.910451,2
5702,3849,31,446,3788,114,251,14181,1445,15626,-0.0642523,0.433318,-0.898948,2
5984,4363,30,488,3259,40,194,14358,1008,15366,-0.0776636,0.436339,-0.896425,2
3301,2425,17,281,2449,29,159,8661,756,9417,-0.075461,0.393135,-0.916379,2
5454,4049,24,467,3994,55,271,14314,1080,15394,-0.0667719,0.381812,-0.921825,2
3861,3083,19,384,3039,45,197,10628,855,11483,-0.0238201,0.36137,-0.932118,2
6348,4945,29,544,4175,53,227,16321,1118,17439,-0.0175241,0.332354,-0.942992,2
3147,2461,16,257,2192,36,145,8254,777,9031,-0.0314104,0.33032,-0.943347,2
4797,3102,23,358,2960,39,192,11471,1174,12645,-0.0446817,0.327529,-0.943784,2
5764,2948,29,341,2849,46,241,12218,1409,13627,-0.0517993,0.325091,-0.944263,2
3723,1713,21,200,1641,34,116,7448,985,8433,-0.0705324,0.3055,-0.949576,2
4991,2283,29,268,1833,39,152,9595,1418,11013,-0.0741907,0.296726,-0.952077,2
5442,1877,29,233,1811,40,128,9560,1306,10866,-0.0816552,0.310706,-0.946992,2
4754,1719,28,215,1602,37,117,8472,1531,10003,-0.0649393,0.313379,-0.947405,2
4969,1754,30,235,1508,39,114,8649,1947,10596,-0.0431994,0.305008,-0.95137,2
4301,1541,28,192,1485,37,107,7691,2060,9751,-0.0531131,0.336781,-0.940084,2
4215,1409,27,177,1390,40,102,7360,1305,8665,-0.0555138,0.363085,-0.930101,2
4318,1725,26,170,1226,42,93,7600,1653,9253,-0.0607583,0.385154,-0.92085,2
4107,1352,27,176,1350,44,104,7160,1497,8657,-0.0972716,0.470283,-0.877139,2
3975,1149,19,117,860,28,66,6214,967,7181,-0.079722,0.399514,-0.913254,2
2027,664,13,86,648,21,49,3508,725,4233,-0.0688428,0.381572,-0.921772,2
3820,1188,25,165,1186,58,123,6565,1438,8003,-0.0840309,0.385367,-0.918929,2
3863,1195,25,159,1175,43,91,6551,1495,8046,-0.0848292,0.37896,-0.921517,2
3792,1278,24,168,1244,34,98,6638,1454,8092,-0.0735151,0.418739,-0.905126,2
3932,1292,27,178,1261,34,100,6824,1368,8192,-0.0783418,0.40031,-0.913025,2
3913,1392,26,184,1358,32,103,7008,1442,8450,-0.0813416,0.39847,-0.913568,2
3951,1540,25,196,1503,33,111,7359,1443,8802,-0.0843091,0.381551,-0.920495,2
3891,1648,26,204,1519,31,112,7431,1571,9002,-0.0826307,0.380101,-0.921247,2
3912,1642,26,207,1672,34,126,7619,1590,9209,-0.0572354,0.173091,-0.983241,2
4135,1711,26,218,1697,35,123,7945,1398,9343,-0.0351245,0.175283,-0.983891,2
4125,1946,31,270,1935,34,140,8481,1464,9945,-0.037044,0.190947,-0.980901,2
4219,2172,26,259,2045,36,151,8908,1577,10485,-0.0266061,0.184949,-0.982388,2
4273,2743,27,315,2472,42,168,10040,1693,11733,-0.0274736,0.234747,-0.971668,2
4487,2428,30,297,2366,46,166,9820,1633,11453,-0.00438609,0.238849,-0.971047,2
4671,1995,28,297,1984,63,175,9213,1468,10681,-0.00240656,0.261556,-0.965185,2
5360,2409,31,261,1959,62,145,10227,1534,11761,-0.00287724,0.287162,-0.957878,2
4966,2260,29,258,2109,83,149,9854,1566,11420,-0.00683844,0.281153,-0.959639,2
4822,1906,35,248,1776,33,129,8949,1428,10377,-0.00682801,0.237506,-0.971362,2
4600,1831,29,224,1658,42,120,8504,2026,10530,-0.0244942,0.202104,-0.979058,2
4295,1546,27,195,1415,45,108,7631,11474,19105,-0.0516011,0.588299,-0.806996,2
1848,461,11,70,428,21,36,2875,4014,6889,-0.0482212,0.624966,-0.779162,2
4292,869,29,120,715,40,62,6127,3864,9991,-0.0183575,0.16471,-0.986171,2
4323,538,26,87,480,31,45,5530,1605,7135,-0.00793978,0.141363,-0.989926,2
4680,376,27,70,323,35,34,5545,2236,7781,-0.00832996,0.146434,-0.989185,2
4461,339,26,65,290,36,31,5248,1568,6816,-0.0520534,0.324719,-0.944377,2
4435,339,25,62,288,39,31,5219,1587,6806,-0.0476093,0.3391,-0.939545,2
4623,315,25,60,262,32,30,5347,1758,7105,-0.0392222,0.290319,-0.956126,2
4874,312,33,59,245,35,28,5586,1825,7411,-0.0556242,0.372041,-0.926548,2
5320,274,25,56,221,37,26,5959,1845,7804,-0.0401979,0.360207,-0.932006,2
5132,243,26,51,196,37,25,5710,2394,8104,-0.0283673,0.365809,-0.930257,2
4463,233,26,47,179,31,44,5023,1670,6693,-0.0120082,0.304977,-0.952284,2
4315,204,26,45,153,30,22,4795,1998,6793,-0.0310429,0.333338,-0.942296,2
4176,215,26,47,149,32,21,4666,1932,6598,-0.0585003,0.352323,-0.934048,2
4353,185,26,44,130,28,20,4786,1935,6721,-0.081841,0.419037,-0.904273,2
4273,174,27,42,121,29,18,4684,2252,6936,-0.0657842,0.389232,-0.918788,2
4491,172,28,46,118,33,18,4906,1798,6704,-0.0837235,0.382375,-0.920206,2
4241,168,35,41,112,30,18,4645,1557,6202,-0.0428297,0.256243,-0.965663,2
4090,192,28,44,137,29,20,4540,1795,6335,-0.0823414,0.361353,-0.928786,2
4684,257,31,57,230,34,33,5326,2200,7526,-0.100924,0.399237,-0.911276,2
4095,311,28,60,253,28,28,4803,1894,6697,-0.0342071,0.239947,-0.970183,2
4077,403,26,81,348,43,35,5013,1619,6632,0.0212207,0.124448,-0.991999,2
4133,648,28,102,619,35,72,5637,1440,7077,-0.0495549,0.362756,-0.930566,2
4362,1130,31,155,1109,34,111,6932,1402,8334,-0.0337897,0.336194,-0.941186,2
4533,1961,29,239,1848,44,130,8784,1403,10187,-0.0649804,0.411824,-0.908944,2
5140,2957,29,377,2920,38,201,11662,1387,13049,-0.0628222,0.427298,-0.901926,2
3856,2643,20,298,2701,46,173,9737,1053,10790,-0.0490623,0.347683,-0.936328,2
5336,3718,25,435,3756,50,252,13572,1269,14841,-0.0582393,0.362555,-0.930141,2
3932,3058,20,365,2956,42,205,10578,882,11460,-0.0534236,0.329004,-0.942816,2
6553,5566,45,573,3922,53,223,16935,967,17902,-0.0315013,0.30069,-0.953201,2
3275,2571,15,296,2514,43,167,8881,732,9613,-0.032552,0.291708,-0.955954,2
6998,4836,28,570,3703,55,220,16410,1007,17417,-0.0375552,0.257145,-0.965643,2
3111,2175,14,241,2178,46,137,7902,864,8766,-0.038463,0.205301,-0.977943,2
5635,3445,28,396,3447,70,228,13249,1607,14856,-0.0418242,0.206848,-0.977479,2
5248,2746,28,326,2666,73,209,11296,1543,12839,-0.0390622,0.202312,-0.978542,2
5060,2284,31,307,2218,54,157,10111,1625,11736,-0.0387228,0.209183,-0.97711,2
4969,1979,30,268,1988,56,142,9432,1434,10866,-0.0404005,0.22628,-0.973224,2
4382,1842,31,249,1798,62,129,8493,1460,9953,-0.0368187,0.255323,-0.966154,2
4670,1808,30,223,1745,74,126,8676,1538,10214,-0.0404733,0.275404,-0.960476,2
4465,1519,28,192,1430,37,107,7778,1435,9213,-0.0372909,0.298926,-0.953547,2
4127,1360,43,228,1425,38,104,7325,1514,8839,-0.020088,0.391861,-0.919805,2
3974,1335,25,169,1230,47,96,6876,1424,8300,-0.0258303,0.39948,-0.916378,2
3845,1174,23,157,1148,31,63,6441,968,7409,-0.0363476,0.304004,-0.951977,2
3648,1180,25,156,1136,35,89,6269,1508,7777,-0.0366627,0.289022,-0.95662,2
3686,1128,23,175,1084,45,87,6228,1594,7822,-0.0262178,0.305401,-0.951863,2
3752,1190,24,158,1133,50,88,6395,1524,7919,-0.0287024,0.317077,-0.947965,2
3712,1353,25,181,1253,43,94,6661,1547,8208,-0.0291042,0.32548,-0.945101,2
3851,1502,26,187,1444,39,106,7155,1547,8702,-0.0300598,0.343223,-0.938773,2
3901,1650,24,206,1548,51,115,7495,1459,8954,-0.0376703,0.369713,-0.928382,2
3930,1795,27,219,1710,38,124,7843,1459,9302,-0.0519568,0.371041,-0.927162,2
4101,1917,27,240,1922,40,137,8384,1468,9852,-0.0564203,0.370779,-0.927006,2
4236,2120,28,254,2157,43,150,8988,1379,10367,-0.0545252,0.335637,-0.940412,2
4202,2264,27,279,2252,52,160,9236,1467,10703,-0.0491743,0.323529,-0.94494,2
4211,2529,28,334,2842,54,175,10173,1526,11699,-0.0470625,0.307357,-0.95043,2
4296,2577,29,308,2486,41,215,9952,1462,11414,-0.0419354,0.296419,-0.954137,2
4803,2733,30,326,2827,50,190,10959,1675,12634,-0.0397278,0.298664,-0.953531,2
4472,3061,32,365,2865,59,222,11076,1441,12517,-0.0383245,0.290747,-0.956032,2
4514,2998,33,353,2939,60,205,11102,1537,12639,-0.0348664,0.25943,-0.965132,2
4522,3055,32,357,3106,46,213,11331,1493,12824,-0.0402232,0.249404,-0.967564,2
4607,3053,30,365,3014,52,209,11330,1454,12784,-0.0251524,0.247789,-0.968488,2
4579,3082,30,375,3173,62,212,11513,1387,12900,-0.023078,0.223914,-0.974336,2
4473,3190,32,365,3009,60,206,11335,1474,12809,-0.0288858,0.219957,-0.975082,2
4477,3162,35,467,3083,45,210,11479,1421,12900,-0.0345759,0.228312,-0.972974,2
4446,3112,31,361,2988,52,227,11217,1651,12868,-0.0320126,0.220836,-0.974786,2
4670,3223,31,365,3193,47,209,11738,1419,13157,-0.0264307,0.228282,-0.973236,2
4688,3094,32,362,3091,96,231,11594,1011,12605,-0.0219431,0.235651,-0.97159,2
2788,1667,17,192,1581,22,89,6356,643,6999,-0.025149,0.222492,-0.97461,2
2136,1461,15,171,1462,25,98,5368,670,6038,-0.0339684,0.211472,-0.976794,2
4570,3189,32,376,3297,53,210,11727,1407,13134,-0.0334939,0.231436,-0.972273,2
4594,3269,32,365,3117,58,210,11645,1465,13110,-0.0375632,0.225745,-0.973462,2
4689,3218,33,415,3302,73,312,12042,1083,13125,-0.0315071,0.210984,-0.976982,2
3472,2793,27,328,2911,43,190,9764,1265,11029,-0.0334473,0.220306,-0.974858,2
4539,3171,32,369,3041,55,211,11418,1455,12873,-0.0354822,0.219694,-0.974924,2
4642,3187,32,371,3214,55,212,11713,1445,13158,-0.0402728,0.223717,-0.973822,2
3111,1890,15,194,1619,31,113,6973,753,7726,-0.0371599,0.230935,-0.972259,2
1928,1324,13,155,1281,20,87,4808,609,5417,-0.0376475,0.227989,-0.972936,2
4631,3232,30,365,3111,57,212,11638,1403,13041,-0.0333314,0.213568,-0.976359,2
4727,3238,33,373,3078,60,238,11747,1472,13219,-0.0299678,0.213347,-0.976517,2
4513,3207,32,369,3198,61,217,11597,1451,13048,-0.0304811,0.198217,-0.979684,2
4577,3195,33,370,3053,67,212,11507,1385,12892,-0.0337996,0.210381,-0.977035,2
4663,3224,31,371,3256,130,330,12005,1207,13212,-0.0347652,0.211068,-0.976853,2
3162,2166,22,252,2197,72,151,8022,969,8991,-0.0335286,0.234698,-0.97149,2
4801,3245,31,371,3278,74,213,12013,1417,13430,-0.0327927,0.22147,-0.974616,2
4564,3532,41,573,3362,46,225,12343,1450,13793,-0.0349824,0.232975,-0.971854,2
4595,2804,29,328,2684,40,186,10666,1301,11967,-0.0322313,0.2124,-0.976651,2
4167,2958,30,336,2811,49,191,10542,1312,11854,-0.0353154,0.220074,-0.974844,2
4347,2873,28,358,2899,42,190,10737,1303,12040,-0.0359147,0.210546,-0.976924,2
4528,3159,33,369,3122,81,210,11502,1487,12989,-0.0355229,0.210989,-0.976843,2
4553,3050,30,363,3054,64,212,11326,1462,12788,-0.0358924,0.207504,-0.977575,2
4571,3309,33,367,2994,73,205,11552,1462,13014,-0.0351855,0.216732,-0.975597,2
4739,3354,41,490,3342,51,212,12229,1411,13640,-0.0324085,0.209184,-0.977339,2
4715,3058,33,365,2942,55,203,11371,1387,12758,-0.0379341,0.219437,-0.974889,2
4599,3119,51,371,3104,52,210,11506,1393,12899,-0.0368139,0.20558,-0.977948,2
4595,3132,41,381,3061,54,209,11473,1412,12885,-0.031716,0.189291,-0.981409,2
4779,3040,41,361,3013,46,206,11486,1400,12886,-0.0313939,0.196011,-0.980099,2
4651,3157,41,365,3034,67,209,11524,1368,12892,-0.0113268,0.130433,-0.991393,2
4575,3054,32,362,3000,49,205,11277,1380,12657,-0.037058,0.202527,-0.978575,2
4701,3023,32,367,3153,56,221,11553,1394,12947,-0.0120039,0.130979,-0.991313,2
4681,3092,32,363,3333,84,222,11807,1502,13309,-0.0324896,0.208108,-0.977566,2
4538,3072,38,377,3011,49,206,11291,1428,12719,-0.0300014,0.19601,-0.980143,2
4390,2819,30,439,2919,45,189,10831,1304,12135,-0.013004,0.1314,-0.991245,2
4159,3191,37,419,2691,47,187,10731,1254,11985,-0.0342413,0.202145,-0.978757,2
4120,2868,29,338,2760,42,189,10346,1329,11675,-0.0292435,0.194774,-0.980412,2
4588,3079,33,362,3415,55,232,11764,1497,13261,-0.0343569,0.201299,-0.978927,2
4541,3068,34,418,3541,47,212,11861,1402,13263,-0.0317634,0.203562,-0.978547,2
4686,3100,31,364,2662,36,140,11019,969,11988,-0.0323917,0.19154,-0.98095,2
2374,1599,18,190,1571,29,108,5889,723,6612,-0.0397209,0.211029,-0.976672,2
4735,3085,32,385,3011,61,207,11516,1445,12961,-0.0298968,0.196864,-0.979975,2
4589,3074,34,381,3035,61,209,11383,1452,12835,-0.0357401,0.201004,-0.978938,2
4649,3109,33,361,2957,55,202,11366,1365,12731,-0.0323741,0.20501,-0.978224,2
4537,3121,33,365,3022,59,206,11343,1361,12704,-0.038391,0.205214,-0.977964,2
4569,3046,52,365,3030,55,206,11323,1423,12746,-0.0142526,0.132163,-0.991125,2
4912,3120,33,363,3024,53,240,11745,1470,13215,-0.0381764,0.206266,-0.977751,2
5459,3211,34,368,2965,60,235,12332,1430,13762,-0.0361538,0.201045,-0.978915,2
4646,3106,33,366,3009,59,214,11433,1414,12847,-0.0291973,0.191073,-0.981142,2
4594,3043,35,359,2951,56,230,11268,1385,12653,-0.0314571,0.196998,-0.979899,2
4629,3142,34,367,3004,44,228,11448,1447,12895,-0.033771,0.197944,-0.979632,2
4618,3090,35,398,3038,49,218,11446,1383,12829,-0.0301588,0.198669,-0.979603,2
4668,3032,36,382,3198,50,218,11584,1404,12988,-0.0325153,0.204488,-0.978329,2
4673,3075,31,378,3000,49,210,11416,1384,12800,-0.0321426,0.202197,-0.978817,2
4531,3163,33,372,3021,55,211,11386,1371,12757,-0.015731,0.13766,-0.990355,2
4681,3013,36,363,3269,106,316,11784,1604,13388,-0.0151698,0.137592,-0.990373,2
4675,2983,33,369,2901,49,200,11210,1396,12606,-0.0176345,0.143594,-0.98948,2
4621,3247,43,563,3368,61,216,12119,1390,13509,-0.0337291,0.212208,-0.976643,2
4690,3014,31,361,2962,67,202,11327,1369,12696,-0.0332372,0.209707,-0.977199,2
4697,3100,37,395,3058,56,207,11550,1210,12760,-0.0147978,0.138438,-0.990261,2
4200,2773,28,324,3053,50,189,10617,1252,11869,-0.0329574,0.208855,-0.977391,2
4588,3034,31,373,2985,53,206,11270,1397,12667,-0.0290457,0.188057,-0.981728,3
4611,3724,41,481,3155,64,209,12285,1395,13680,-0.0146931,0.135198,-0.99071,3
4906,3209,32,363,3042,58,222,11832,1428,13260,-0.0177127,0.139548,-0.990057,3
4568,3144,32,370,3216,60,210,11600,1370,12970,-0.028007,0.206673,-0.978009,3
3157,2121,23,249,2175,31,146,7902,967,8869,-0.0443514,0.198943,-0.979007,3
4663,3071,32,364,3032,61,213,11436,1369,12805,-0.0311544,0.220399,-0.974912,3
4540,3347,36,374,3157,83,210,11747,1410,13157,-0.0537319,0.222052,-0.973553,3
5065,2970,31,363,2929,51,204,11613,1431,13044,-0.0511317,0.236723,-0.970231,3
4851,3235,35,369,3110,59,210,11869,1472,13341,-0.0276229,0.203768,-0.978629,3
4729,3001,31,365,3003,48,233,11410,1447,12857,-0.0392647,0.228753,-0.972692,3
4879,3193,34,368,3159,46,210,11889,1469,13358,-0.0301695,0.216882,-0.975731,3
4902,3084,36,423,3190,108,318,12061,1512,13573,-0.0308542,0.210249,-0.977161,3
4652,3100,34,362,2980,65,204,11397,1412,12809,-0.0300174,0.196497,-0.980045,3
4751,3384,33,365,3125,65,209,11932,1436,13368,-0.0412889,0.222602,-0.974035,3
4201,2709,29,341,2644,47,186,10157,1288,11445,-0.032252,0.222778,-0.974335,3
4757,3003,31,363,2955,50,216,11375,1427,12802,-0.0322048,0.20552,-0.978123,3
4713,3151,33,371,2958,59,206,11491,1444,12935,-0.0464009,0.213831,-0.975768,3
5354,3249,31,363,2917,79,212,12205,1374,13579,-0.0288808,0.222062,-0.974605,3
4711,3012,38,363,2618,44,144,10930,968,11898,-0.0328751,0.187169,-0.981777,3
4229,2705,31,322,2609,59,182,10137,1325,11462,-0.00656956,0.208307,-0.978042,3
4826,3055,34,403,2998,83,206,11605,1396,13001,-0.0402568,0.22528,-0.973462,3
3697,2342,22,255,2138,32,144,8630,1002,9632,-0.0361319,0.237441,-0.97073,3
4497,2837,28,332,2716,58,189,10657,1319,11976,-0.0369254,0.213363,-0.976275,3
4281,2876,31,369,2671,48,186,10462,1279,11741,-0.0419131,0.229724,-0.972353,3
3881,2506,33,309,2387,39,168,9323,1213,10536,-0.00968031,0.220015,-0.975449,3
4808,3000,32,365,2915,54,205,11379,1474,12853,-0.00399012,0.121902,-0.992534,3
5086,2920,38,383,2817,46,199,11489,1516,13005,-0.00927418,0.125054,-0.992107,3
3350,1911,22,236,1920,34,134,7607,976,8583,-0.00874683,0.133283,-0.99104,3
4256,2603,27,304,2393,44,166,9793,1311,11104,-0.00792568,0.103138,-0.994635,3
4861,2846,33,343,2782,58,232,11155,1441,12596,-0.0317176,0.217906,-0.975454,3
4961,2898,32,346,2857,55,198,11347,1396,12743,-0.0246125,0.198598,-0.979772,3
5175,2896,33,352,2825,59,198,11538,1471,13009,-0.0143028,0.205871,-0.978475,3
4779,2928,39,348,2822,54,238,11208,961,12169,-0.0197519,0.205507,-0.978456,3
4982,3763,36,437,2866,49,197,12330,1467,13797,-0.00876677,0.122996,-0.992369,3
3321,2025,22,243,2062,51,178,7902,1215,9117,-0.00219336,0.107946,-0.994154,3
4858,2972,33,358,2879,55,228,11383,1441,12824,-0.0117376,0.127642,-0.991751,3
5294,3276,33,359,2838,56,200,12056,1389,13445,-0.00315718,0.121013,-0.992646,3
4774,2936,31,352,2856,49,200,11198,1480,12678,-0.00271143,0.120119,-0.992756,3
5470,2896,34,354,2855,53,201,11863,1504,13367,0.0031043,0.112399,-0.993658,3
3280,1961,21,239,1935,32,143,7611,980,8591,-0.00120722,0.216764,-0.976223,3
4845,2895,32,354,2873,52,202,11253,1495,12748,0.00086387,0.115063,-0.993358,3
5720,2859,32,388,2826,45,200,12070,1404,13474,-0.00026805,0.115369,-0.993323,3
4905,3020,33,359,3123,107,268,11815,1434,13249,-0.0109034,0.124784,-0.992124,3
3443,2009,36,245,1974,33,138,7878,1023,8901,-0.0137311,0.194578,-0.980791,3
5170,3385,33,362,2890,58,200,12098,1440,13538,-0.00655555,0.121635,-0.992553,3
4873,2962,33,359,2475,48,137,10887,1033,11920,-0.0353428,0.22676,-0.97331,3
4088,2433,27,292,2370,42,164,9416,1207,10623,-0.0106556,0.219084,-0.975648,3
4126,2435,26,294,2431,72,219,9603,1266,10869,-0.000718293,0.111275,-0.993789,3
4128,2398,26,300,2326,40,162,9380,1203,10583,-0.00537292,0.0929456,-0.995657,3
4782,3390,42,476,2929,56,202,11877,1414,13291,-0.00701151,0.114421,-0.993408,3
5130,2990,32,352,2843,76,200,11623,1181,12804,-0.00445159,0.110568,-0.993859,3
3378,2383,29,299,2150,40,140,8419,1006,9425,-0.00629259,0.0967792,-0.995286,3
4947,2913,41,446,2850,51,200,11448,1498,12946,-0.0044917,0.114193,-0.993449,3
4833,2879,33,351,2764,62,193,11115,1345,12460,-0.0107176,0.119871,-0.992732,3
3371,2098,23,249,2337,41,141,8260,1194,9454,-0.00743057,0.113547,-0.993505,3
4885,2939,32,356,2904,45,201,11362,1543,12905,-0.0118324,0.0883579,-0.996018,3
3372,2036,23,243,2432,53,141,8300,978,9278,-0.00644117,0.117199,-0.993088,3
4927,3503,44,409,2998,56,238,12175,1456,13631,-0.00528552,0.133914,-0.990979,3
5006,3016,33,366,2302,31,142,10896,996,11892,-0.0145844,0.141124,-0.989884,3
5173,3197,36,380,3137,58,212,12193,1464,13657,-0.0429169,0.242703,-0.969151,3
4951,3241,32,396,3182,65,215,12082,1329,13411,-0.0383775,0.249846,-0.967525,3
5147,3000,32,352,2920,60,196,11707,1444,13151,-0.04066,0.241125,-0.969642,3
4588,3375,39,461,2980,52,199,11694,1307,13001,-0.0394499,0.228862,-0.972659,3
4466,2803,31,355,2749,43,187,10634,1258,11892,-0.0255507,0.228595,-0.973186,3
3946,2468,35,362,2279,53,158,9301,1246,10547,-0.0279368,0.231873,-0.972345,3
4886,2666,32,307,2580,76,224,10771,1545,12316,-0.0317913,0.244968,-0.96901,3
4564,2441,35,276,2277,57,156,9806,1399,11205,-0.0215007,0.238951,-0.970794,3
4267,1882,30,245,1829,47,129,8429,1446,9875,-0.0340989,0.269762,-0.962323,3
4429,1430,29,212,1402,36,104,7642,1520,9162,-0.0387065,0.356727,-0.933406,3
4764,1575,30,162,1144,36,89,7800,1425,9225,-0.0385453,0.318865,-0.947016,3
2735,575,16,72,513,21,40,3972,782,4754,-0.024257,0.204936,-0.978475,3
2605,503,17,71,459,23,40,3718,914,4632,0.00112041,0.194648,-0.980873,3
5095,980,36,163,845,41,65,7225,1581,8806,0.02298,0.247793,-0.968541,3
4931,800,30,116,696,45,59,6677,1530,8207,0.023025,0.248933,-0.968247,3
5040,748,27,109,671,38,57,6690,1680,8370,0.00655839,0.273199,-0.961935,3
4371,699,25,95,571,54,49,5864,1615,7479,-0.00755909,0.269805,-0.962885,3
4798,675,26,103,620,44,54,6320,1603,7923,-0.0182428,0.259785,-0.965494,3
4611,663,26,108,614,39,71,6132,1403,7535,-0.0225257,0.227241,-0.973578,3
4675,698,28,126,627,36,58,6248,1394,7642,-0.0336348,0.248354,-0.968085,3
4503,664,27,104,639,46,58,6041,1397,7438,-0.0242022,0.236629,-0.971299,3
4322,734,27,104,583,46,52,5868,1396,7264,-0.0178268,0.224097,-0.974404,3
4233,607,29,96,537,53,51,5606,1435,7041,-0.0200459,0.237275,-0.971236,3
4305,558,28,89,488,49,46,5563,1575,7138,-0.0470477,0.252331,-0.966497,3
4242,777,35,128,564,52,54,5852,1565,7417,-0.0860101,0.314719,-0.94528,3
4033,554,26,92,503,35,47,5290,1397,6687,-0.0697319,0.277052,-0.958321,3
4126,638,28,99,589,36,51,5567,1361,6928,-0.0565487,0.240799,-0.968927,3
4370,1037,29,140,961,33,88,6658,1379,8037,-0.0692883,0.293143,-0.953555,3
4439,1941,29,233,1885,45,130,8702,1393,10095,-0.0570157,0.295168,-0.953743,3
4808,2749,29,348,2673,50,214,10871,1406,12277,-0.0324168,0.260782,-0.964853,3
5634,3423,29,396,3152,36,154,12824,949,13773,-0.0341805,0.272186,-0.961637,3
3604,2706,20,304,2655,35,175,9499,946,10445,-0.0344138,0.268484,-0.962669,3
5799,4447,34,504,4383,50,287,15504,1391,16895,-0.00276228,0.227824,-0.973699,3
5043,4297,32,472,4115,53,268,14280,1271,15551,0.0228741,0.183832,-0.982692,3
5291,4133,27,463,3996,60,190,14160,882,15042,0.0050061,0.176734,-0.984246,3
3768,2967,20,381,2817,29,190,10172,885,11057,-0.00221459,0.169443,-0.985537,3
4992,3811,51,604,4040,49,243,13790,1206,14996,-0.0152573,0.183969,-0.982814,3
5195,3353,19,306,2639,39,174,11725,809,12534,-0.0235689,0.186531,-0.982166,3
6373,4577,30,540,4256,52,207,16035,984,17019,-0.04536,0.170819,-0.984258,3
3535,2480,17,282,2479,50,185,9028,823,9851,-0.0440755,0.146466,-0.988233,3
6279,4823,27,647,4667,81,309,16833,1245,18078,-0.0399739,0.149613,-0.987936,3
6067,4498,19,349,3105,42,200,14280,1096,15376,-0.0287454,0.131454,-0.990905,3
3740,2758,18,303,2700,32,176,9727,948,10675,-0.0280573,0.126383,-0.991585,3
6023,3901,29,469,3890,57,257,14626,1448,16074,-0.0279982,0.104693,-0.994111,3
5720,3720,29,417,3275,35,167,13363,995,14358,-0.0201393,0.111455,-0.993565,3
2832,1779,15,200,1753,27,114,6720,738,7458,-0.0218114,0.0794077,-0.996603,3
5288,3019,29,351,2950,46,195,11878,1443,13321,-0.0229691,0.12257,-0.992194,3
5167,2663,30,334,2603,62,180,11039,1413,12452,-0.0246079,0.117351,-0.992786,3
4957,2337,29,319,2237,75,195,10149,1541,11690,-0.0347061,0.134529,-0.990302,3
4774,1958,28,243,2034,48,141,9226,1453,10679,-0.0232776,0.126006,-0.991757,3
3092,1098,18,158,1119,57,98,5640,1026,6666,-0.0207268,0.164861,-0.986099,3
4273,1509,26,188,1373,43,101,7513,1554,9067,-0.0210935,0.182376,-0.983003,3
4071,1254,25,170,1254,45,100,6919,1421,8340,-0.0202515,0.18348,-0.982815,3
3971,1279,25,165,1145,45,87,6717,1521,8238,-0.0231472,0.221623,-0.974858,3
3839,1153,25,156,1076,37,83,6369,1564,7933,-0.0260549,0.230051,-0.97283,3
3796,1121,23,199,1038,45,82,6304,1697,8001,-0.0263271,0.23323,-0.972065,3
3728,1140,24,158,1065,37,85,6237,1677,7914,-0.0217023,0.243648,-0.969621,3
3735,1126,22,165,1083,44,84,6259,1741,8000,-0.0272741,0.222603,-0.974528,3
3726,1234,61,167,1193,46,90,6517,1690,8207,-0.0439263,0.253943,-0.966221,3
3850,1438,25,180,1365,40,102,7000,1713,8713,-0.0553557,0.276493,-0.95942,3
3922,1582,33,195,1514,42,107,7395,1670,9065,-0.0625244,0.316683,-0.946468,3
3894,1732,24,214,1715,41,123,7743,1661,9404,-0.057632,0.333873,-0.940855,3
4088,2221,28,264,2204,42,176,9023,1611,10634,-0.0336693,0.346132,-0.937582,3
4357,2729,30,325,2665,65,208,10379,1632,12011,-0.00545169,0.34619,-0.938149,3
4697,3004,34,349,2994,63,202,11343,1539,12882,0.0019798,0.331929,-0.943302,3
4816,3204,43,438,3012,61,208,11782,1594,13376,0.00765158,0.318331,-0.947949,3
4969,3206,36,381,3301,65,217,12175,1199,13374,-0.00118237,0.313796,-0.949489,3
3443,2212,24,288,2202,34,147,8350,1118,9468,-0.019217,0.281652,-0.959324,3
4291,2619,32,306,2524,59,172,10003,1293,11296,-0.0258571,0.279742,-0.959727,3
4494,2415,29,305,2316,56,163,9778,1476,11254,-0.0102115,0.28397,-0.958779,3
4302,2026,30,238,1877,57,132,8662,1419,10081,0.00190499,0.263534,-0.964649,3
4340,1557,29,199,1576,48,116,7865,1398,9263,0.00359957,0.265838,-0.964011,3
4295,1439,35,177,1222,38,93,7299,1414,8713,-0.0179856,0.26434,-0.964262,3
4346,1003,28,140,982,42,77,6618,1507,8125,-0.0464435,0.245546,-0.968272,3
4451,638,34,119,571,40,54,5907,1593,7500,-0.0534377,0.236101,-0.970258,3
4630,621,27,95,577,40,52,6042,1829,7871,-0.0427052,0.23207,-0.971761,3
4812,728,38,109,667,39,59,6452,2271,8723,-0.0246037,0.223477,-0.974398,3
4656,739,27,108,655,35,56,6276,1638,7914,0.00150554,0.208461,-0.97803,3
4768,710,29,108,665,46,56,6382,1418,7800,0.00738813,0.209406,-0.977801,3
4510,769,31,115,714,44,60,6243,1446,7689,0.0023965,0.233655,-0.972317,3
4478,790,26,133,759,36,64,6286,1383,7669,-0.00492757,0.236386,-0.971647,3
4241,843,27,131,822,38,69,6171,1464,7635,-0.017966,0.230653,-0.97287,3
4231,809,31,138,763,35,66,6073,1490,7563,-0.0387208,0.23652,-0.970855,3
4667,843,31,145,845,40,71,6642,1562,8204,-0.0561307,0.236077,-0.970112,3
4197,862,31,122,801,36,66,6115,1633,7748,-0.0531963,0.228907,-0.971994,3
5025,1096,28,137,924,52,72,7334,1529,8863,-0.046864,0.22802,-0.972528,3
5202,1596,32,186,1460,63,107,8646,1717,10363,-0.0308372,0.217034,-0.975677,3
4490,1621,40,200,1518,35,109,8013,1493,9506,-0.0362749,0.243344,-0.969261,3
5483,2016,25,244,2000,39,142,9949,1447,11396,-0.0446663,0.239553,-0.969855,3
4902,2704,26,307,2647,48,174,10808,1393,12201,-0.0506249,0.250084,-0.9669,3
5433,3604,30,405,3439,33,164,13108,998,14106,-0.034597,0.205777,-0.977987,3
4007,3048,21,339,3130,48,208,10801,999,11800,-0.0220563,0.167176,-0.985681,3
6304,4913,29,572,4807,46,230,16901,996,17897,-0.0303179,0.210411,-0.977143,3
4482,3682,21,401,3547,36,229,12398,1039,13437,-0.0170864,0.196139,-0.980427,3
5208,4213,24,464,4246,78,300,14533,1189,15722,0.00405572,0.210052,-0.977682,3
3508,3049,19,281,2476,35,160,9528,845,10373,0.00689966,0.173393,-0.984829,3
6324,3113,29,358,3106,52,207,13189,1439,14628,0.00182649,0.190257,-0.981732,3
5151,2501,26,292,2463,51,167,10651,1450,12101,0.00402224,0.161746,-0.986824,3
5090,2176,27,259,2132,41,150,9875,1490,11365,-0.00892587,0.144839,-0.989415,3
4790,2008,29,240,1917,41,182,9207,1416,10623,-0.0224666,0.134904,-0.990604,3
5333,2027,34,251,2034,54,128,9861,1386,11247,-0.0351323,0.152102,-0.98774,3
4525,1590,28,200,1591,40,115,8089,1425,9514,-0.0379018,0.14838,-0.988204,3
4366,1502,27,194,1442,39,107,7677,1811,9488,-0.0441693,0.146579,-0.988213,3
4237,1400,27,206,1361,46,104,7381,1404,8785,-0.0503421,0.17062,-0.98405,3
4300,1373,26,173,1311,45,99,7327,1390,8717,-0.0374928,0.198354,-0.979413,3
3985,1385,25,175,1335,39,101,7045,1469,8514,-0.0319015,0.241078,-0.969981,3
3799,1295,24,167,1224,40,93,6642,1661,8303,-0.0399365,0.232907,-0.971679,3
3907,1262,33,170,1224,75,105,6776,1814,8590,-0.0616147,0.253377,-0.965403,3
4495,1544,30,203,1572,56,147,8047,2072,10119,-0.0751444,0.255422,-0.963905,3
4112,1416,26,185,1385,44,105,7273,1742,9015,-0.0999712,0.282443,-0.954061,3
3906,1557,25,195,1795,56,149,7683,1877,9560,-0.110993,0.284809,-0.952137,3
3955,1884,25,226,1742,48,126,8006,1595,9601,-0.10746,0.289983,-0.95098,3
4737,2445,27,261,2139,49,150,9808,1571,11379,-0.0960332,0.304998,-0.947499,3
5501,3285,35,352,2875,49,195,12292,1800,14092,-0.0620176,0.332991,-0.940888,3
5282,3335,34,360,3334,71,204,12620,1758,14378,-0.0333903,0.415386,-0.909032,3
5073,2482,23,272,2370,36,168,10424,872,11296,-0.0214094,0.317045,-0.948169,3
2648,1892,26,301,1791,38,121,6817,808,7625,-0.0062055,0.276289,-0.961055,3
3006,2074,21,232,1999,29,132,7493,967,8460,-0.00582201,0.256474,-0.966534,3
4285,2363,38,296,2051,41,144,9218,1408,10626,-0.022449,0.264119,-0.964229,3
4691,1893,40,192,1387,46,104,8353,1563,9916,-0.0518357,0.446422,-0.89332,3
3212,610,19,85,572,36,46,4580,1000,5580,-0.0360035,0.336849,-0.94087,3
5263,736,28,109,684,34,61,6915,1384,8299,-0.0358012,0.2943,-0.955042,3
3168,448,20,69,425,22,39,4191,1121,5312,-0.0360779,0.247795,-0.96814,3
5466,724,31,115,717,50,67,7170,2070,9240,-0.0349712,0.263684,-0.963975,3
5941,752,30,119,769,66,74,7751,1949,9700,-0.0164452,0.261877,-0.964961,3
4723,579,33,121,573,43,70,6142,1261,7403,-0.0091446,0.2299,-0.973171,3
4144,465,24,76,407,39,38,5193,1485,6678,-0.0060871,0.25456,-0.967038,3
4796,535,27,79,416,36,43,5932,1428,7360,-0.0075664,0.237516,-0.971354,3
4353,385,29,69,301,45,33,5215,1592,6807,-0.00200905,0.191175,-0.981554,3
4336,294,28,58,204,40,25,4985,1418,6403,0.00698968,0.171062,-0.985235,3
4678,231,30,53,169,35,23,5219,1580,6799,0.00263624,0.210066,-0.977684,3
4583,242,29,54,180,41,23,5152,1713,6865,0.0186242,0.210984,-0.977312,3
4064,311,28,83,255,28,30,4799,1569,6368,0.0218555,0.221829,-0.974841,3
4622,667,33,124,513,35,53,6047,1669,7716,0.0172762,0.200433,-0.979555,3
4873,968,31,135,869,37,93,7006,1995,9001,0.0138679,0.17756,-0.984012,3
4917,1166,27,158,1091,34,85,7478,1433,8911,-0.0230554,0.214032,-0.976554,3
4497,1572,30,204,1526,38,114,7981,1696,9677,-0.0171984,0.197009,-0.980251,3
2625,969,12,118,932,23,66,4745,751,5496,-0.0169889,0.167399,-0.985743,3
1930,1055,15,172,986,29,64,4251,593,4844,-0.0162191,0.152452,-0.988178,3
5140,2792,29,365,2839,68,193,11426,1419,12845,-0.00592642,0.162773,-0.986646,3
5411,3669,28,420,2563,35,166,12292,954,13246,0.00637665,0.179057,-0.983818,3
3049,2322,15,262,2369,26,153,8196,765,8961,0.00150586,0.138925,-0.990302,3
6023,4953,30,633,4890,61,318,16908,1041,17949,0.0113604,0.16034,-0.986996,3
4299,3545,19,401,3479,51,228,12022,1085,13107,0.0310416,0.139248,-0.989771,3
5071,4074,22,458,3997,47,275,13944,1291,15235,0.0118373,0.148753,-0.988803,3
6075,4644,30,589,3782,45,210,15375,1253,16628,-0.0518411,0.199296,-0.978567,3
2480,1546,10,173,1393,15,83,5700,630,6330,-0.0233883,0.117179,-0.992836,3
1623,864,9,101,804,13,56,3470,477,3947,0.00233183,0.0733032,-0.997307,3
2313,1226,13,185,943,19,68,4767,768,5535,0.00752643,0.0663702,-0.997767,3
4942,2074,31,236,1886,51,137,9357,1492,10849,-0.0111259,0.107593,-0.994133,3
4842,1737,35,217,1642,58,120,8651,1410,10061,-0.015275,0.0978973,-0.995079,3
4792,1541,27,200,1505,50,111,8226,1373,9599,-0.0325732,0.284847,-0.958019,3
3980,1016,30,164,1091,54,94,6429,1007,7436,-0.0240361,0.197559,-0.979996,3
4663,1327,27,199,1320,44,102,7682,1448,9130,-0.033064,0.188242,-0.981566,3
2986,820,17,109,796,27,62,4817,1031,5848,-0.0363019,0.22442,-0.973817,3
3783,837,25,116,785,34,64,5644,1377,7021,-0.039066,0.240812,-0.969785,3
4511,1080,24,121,776,67,68,6647,1624,8271,-0.0401358,0.256947,-0.965592,3
3680,1015,24,135,963,71,76,5964,1632,7596,-0.0412708,0.29296,-0.955234,3
3691,1270,26,166,1258,44,122,6577,1630,8207,-0.0309869,0.288604,-0.956947,3
4352,1689,25,184,1547,41,141,7979,1538,9517,-0.0162624,0.447198,-0.894287,3
4390,1922,31,237,1882,44,134,8640,1688,10328,-0.00519518,0.420843,-0.907118,3
5190,2585,30,279,1896,40,107,10127,1008,11135,-0.00484948,0.3199,-0.947439,3
4584,2830,30,320,2848,62,210,10884,1590,12474,0.0048032,0.426494,-0.904478,3
4558,2762,22,252,2195,58,174,10021,1110,11131,0.0101992,0.341653,-0.939771,3
2501,1780,18,208,1748,25,117,6397,885,7282,0.0234518,0.274571,-0.961281,3
4020,3314,30,396,2832,54,192,10838,1120,11958,0.0202542,0.230816,-0.972787,3
4472,3421,30,356,2948,45,195,11467,1147,12614,0.0228155,0.208319,-0.977795,3
4218,3077,28,357,3026,46,199,10951,1183,12134,0.0197433,0.182795,-0.982953,3
5393,3819,35,436,3739,54,287,13763,1437,15200,0.00981185,0.164801,-0.986278,3
5944,3689,25,311,2653,37,174,12833,960,13793,0.0141173,0.145572,-0.989247,3
3283,2513,22,284,2563,37,163,8865,949,9814,0.0218778,0.132378,-0.990958,3
5280,3924,34,448,3859,53,253,13851,1515,15366,0.0202085,0.120569,-0.992499,3
5119,4233,37,457,3185,34,186,13251,1084,14335,0.0216431,0.118295,-0.992742,3
6014,4792,39,539,6009,80,346,17819,1729,19548,0.0273878,0.103729,-0.994228,3
3400,2328,15,246,1827,22,118,7956,744,8700,0.0361,0.0939142,-0.994926,3
1759,1365,10,150,1333,26,85,4728,489,5217,0.0436352,0.0965461,-0.994372,3
2002,1687,13,187,1631,18,106,5644,620,6264,0.0474965,0.0923128,-0.994597,3
6059,4764,40,564,3517,40,208,15192,1122,16314,0.0485109,0.0913784,-0.994634,3
2946,2415,19,270,2329,26,151,8156,888,9044,0.0395144,0.098014,-0.9944,3
5889,4357,33,488,4318,48,279,15412,1514,16926,0.0400811,0.0947981,-0.994689,3
5136,4322,34,485,3866,50,193,14086,1083,15169,0.0388223,0.0992051,-0.994309,3
3600,2981,25,364,2950,43,192,10155,1072,11227,0.0408803,0.0999137,-0.994156,3
4741,4172,46,463,3843,46,278,13589,1499,15088,0.041677,0.104745,-0.993625,3
3373,2804,21,324,2690,42,176,9430,1005,10435,0.039386,0.109943,-0.993157,3
5786,4267,35,482,3954,37,191,14752,1146,15898,0.0387933,0.107938,-0.9934,3
3516,2883,23,330,2862,49,187,9850,1034,10884,0.0368991,0.106235,-0.993656,3
5227,4246,32,480,4304,51,278,14618,1173,15791,0.0443575,0.104491,-0.993536,3
5475,3948,30,466,3905,62,276,14162,1418,15580,0.0400749,0.103632,-0.993808,3
3297,2736,20,305,2685,43,173,9259,980,10239,0.0378355,0.102046,-0.99406,3
5958,4354,33,488,4311,77,272,15493,1078,16571,0.0425113,0.103192,-0.993753,3
3594,2957,23,333,2940,35,191,10073,1082,11155,0.0426222,0.10191,-0.99388,3
5295,4428,35,488,4294,51,278,14869,1646,16515,0.0409067,0.10219,-0.993923,3
3614,2969,23,339,3057,36,242,10280,1131,11411,0.0395474,0.106234,-0.993554,3
5215,4350,33,506,4258,48,289,14699,1640,16339,0.0399026,0.110048,-0.993125,3
5386,4330,36,482,4216,74,272,14796,1561,16357,0.0495756,0.110489,-0.99264,3
3567,3158,45,413,2927,41,195,10346,1096,11442,0.0518873,0.11596,-0.991898,3
4747,3849,29,435,3765,54,246,13125,1289,14414,0.0508284,0.117381,-0.991785,3
5271,4477,35,486,4214,57,273,14813,1143,15956,0.0410085,0.115715,-0.992436,3
3512,2899,23,326,2859,46,184,9849,1079,10928,0.035692,0.108198,-0.993489,3
6097,4243,35,482,4123,64,270,15314,1281,16595,0.0423141,0.103479,-0.993731,3
4615,4121,31,436,3747,44,248,13242,1386,14628,0.041837,0.105639,-0.993524,3
5138,3890,31,429,3798,47,248,13581,1069,14650,0.0409658,0.103221,-0.993814,3
5396,4191,34,474,3470,37,188,13790,961,14751,0.0459375,0.10499,-0.993412,3
2714,2246,19,250,2181,35,151,7596,802,8398,0.0326268,0.103977,-0.994044,3
5214,4446,34,487,4247,63,274,14765,1532,16297,0.0373736,0.109524,-0.993281,3
5150,4225,33,548,4165,53,275,14449,1554,16003,0.0474166,0.118446,-0.991828,3
5113,2956,23,348,2565,34,144,11183,859,12042,0.0436668,0.122357,-0.991525,3
2227,1511,12,171,1488,20,98,5527,529,6056,0.0439128,0.109401,-0.993027,3
2307,1923,15,214,1899,27,122,6507,659,7166,0.0455288,0.109378,-0.992957,3
5572,4268,32,481,4274,52,275,14954,1507,16461,0.0385521,0.0995579,-0.994285,3
5298,4224,38,475,3128,53,186,13402,1049,14451,0.0364898,0.103589,-0.993951,3
2734,2188,17,245,2195,31,145,7555,811,8366,0.0362014,0.106012,-0.993706,3
5217,4264,37,513,4163,77,279,14550,1611,16161,0.0362898,0.111179,-0.993137,3
5235,3973,24,347,2907,33,187,12706,1078,13784,0.0367361,0.110456,-0.993202,3
2735,2246,27,267,2511,30,147,7963,791,8754,0.0395432,0.105469,-0.993636,3
5152,4363,34,475,4175,65,274,14538,1531,16069,0.0356069,0.11057,-0.99323,3
5235,4211,34,472,3527,48,188,13715,1050,14765,0.0328826,0.113381,-0.993007,3
2743,2229,23,251,2201,26,145,7618,821,8439,0.0287267,0.116306,-0.992798,3
5172,4332,36,488,4159,81,273,14541,1521,16062,0.0375333,0.113444,-0.992835,3
5437,4466,36,480,3359,42,186,14006,1016,15022,0.0337652,0.118019,-0.992437,3
2735,2283,19,253,2175,34,140,7639,826,8465,0.041042,0.10926,-0.993165,3
5108,4171,35,467,4069,69,266,14185,1580,15765,0.0379142,0.106643,-0.993574,3
5212,4241,34,473,3029,43,187,13219,1085,14304,0.0336538,0.107554,-0.99363,3
2796,2317,22,359,2624,31,144,8293,827,9120,0.0331224,0.110303,-0.993346,3
5747,4265,35,542,4808,76,273,15746,1507,17253,0.0410169,0.102576,-0.993879,3
3633,3126,25,333,2990,42,188,10337,1104,11441,0.0389201,0.10717,-0.993479,3
3418,2713,25,310,2764,40,173,9443,1145,10588,0.0367603,0.108611,-0.993404,3
5337,4258,34,490,4174,60,271,14624,1488,16112,0.0371472,0.105992,-0.993673,3
6219,4147,35,546,4063,63,273,15346,1278,16624,0.0423162,0.1035,-0.993729,3
3573,2919,24,324,2972,44,189,10045,1128,11173,0.0377678,0.108222,-0.993409,3
5395,3758,30,427,3727,51,240,13628,1441,15069,0.0354216,0.108745,-0.993438,3
4584,3779,32,428,3790,69,244,12926,999,13925,0.0364024,0.107202,-0.993571,3
5173,4183,38,573,4168,58,271,14464,1595,16059,0.0386461,0.105405,-0.993678,3
3555,3252,26,332,2843,43,185,10236,1094,11330,0.033151,0.108473,-0.993547,3
4683,3946,36,453,3756,43,246,13163,1405,14568,0.0322102,0.107866,-0.993643,3
5346,3758,30,425,3678,59,240,13536,1187,14723,0.0381867,0.105494,-0.993686,3
5128,4316,36,484,3809,42,186,14001,1097,15098,0.0366087,0.105418,-0.993754,3
2751,2494,20,253,2248,32,142,7940,861,8801,0.0343056,0.10869,-0.993484,3
6043,4209,38,481,4170,47,267,15255,1068,16323,0.0365363,0.105096,-0.993791,3
3653,2986,24,327,2927,46,187,10150,1139,11289,0.0318559,0.105606,-0.993898,3
5276,4264,36,489,4148,64,280,14557,1246,15803,0.0327796,0.112739,-0.993084,3
3586,2854,23,324,2848,69,188,9892,1053,10945,0.0371543,0.104626,-0.993817,3
5220,4210,36,476,4174,58,268,14442,1567,16009,0.0303913,0.107742,-0.993714,3
3569,3001,35,334,2889,45,187,10060,1009,11069,0.0314443,0.106169,-0.993851,3
5490,4253,32,497,4115,55,268,14710,1486,16196,0.0396501,0.103637,-0.993825,3
5180,4213,33,464,4131,71,285,14377,1475,15852,0.0390011,0.101525,-0.994068,3
3557,2809,22,316,2781,42,178,9705,1040,10745,0.0299099,0.110677,-0.993406,3
5155,3946,34,445,3922,70,255,13827,1518,15345,0.0329639,0.110457,-0.993334,3
5228,4062,31,455,4003,38,179,13996,1110,15106,0.0322835,0.107059,-0.993729,3
3525,2822,24,312,2889,51,181,9804,1026,10830,0.0386367,0.104882,-0.993734,3
5225,4018,49,461,4120,54,262,14189,1513,15702,0.0358064,0.106705,-0.993646,3
5148,4115,40,649,4537,41,185,14715,1097,15812,0.029698,0.110027,-0.993485,3
