Downsample[ns],BuildFilTree[ns],SearchFil[ns],DeleteFil[ns],BuildTreeSub[ns],SearchSub[ns],DeleteSub[ns],PreProcTotal[ns],Plane[ns],Total[ns],nx,ny,nz,planeCount
6798,2429,85,319,2296,68,171,12166,3481,15647,0.700286,0.066401,-0.710767,0
6763,2278,28,267,1931,41,113,11421,3117,14538,0.672321,0.0469007,-0.738773,0
3278,1128,15,151,1126,28,84,5810,4042,9852,-0.0858152,0.0283604,-0.995907,0
5326,1856,29,312,1771,40,133,9467,6485,15952,-0.0129142,-0.0156757,-0.999794,0
6635,2209,37,270,1985,44,148,11328,7269,18597,-0.00840172,0.0104185,-0.99991,0
4043,1432,21,182,1364,30,103,7175,4117,11292,-0.0117041,0.0116654,-0.999863,0
3842,1374,20,178,1346,33,97,6890,4679,11569,-0.116162,0.0278631,-0.992839,0
5849,2052,29,264,2005,49,165,10413,3602,14015,0.696315,0.0657792,-0.714716,0
5319,1823,24,255,1779,38,134,9372,4101,13473,0.69068,0.0817474,-0.718525,0
5307,1827,43,238,1749,37,131,9332,6274,15606,-0.00607939,0.0113953,-0.999917,0
6755,2298,33,300,2296,56,172,11910,5030,16940,-0.00934365,0.013508,-0.999865,0
4036,1155,16,169,1112,25,84,6597,2721,9318,-0.105146,0.0239274,-0.994169,0
2153,645,10,83,629,14,46,3580,2223,5803,-0.0133942,0.0121893,-0.999836,0
6173,2072,28,268,2006,45,160,10752,3608,14360,0.692372,0.0737905,-0.717758,0
5330,1838,26,241,1838,41,136,9450,3502,12952,0.685866,0.0714968,-0.724206,0
6690,2337,31,323,2191,45,151,11768,6161,17929,-0.122209,0.0343022,-0.991912,0
3140,1095,14,141,1063,26,79,5558,2212,7770,0.700763,0.0594951,-0.710909,0
6616,2627,33,324,2259,50,168,12077,5752,17829,0.678758,0.0770364,-0.730311,0
4449,1673,22,202,1505,34,113,7998,5401,13399,-0.0240658,0.0868095,-0.995934,0
4029,1677,20,231,1466,32,107,7562,6772,14334,-0.0108641,0.0119751,-0.999869,0
6293,2240,27,262,2174,65,198,11259,4445,15704,-0.0100894,0.012962,-0.999865,0
3081,1157,18,177,1044,23,79,5579,3784,9363,-0.00916883,0.0126376,-0.999878,0
6741,2973,34,329,2314,52,171,12614,3509,16123,0.700009,0.0732444,-0.710368,0
3314,1249,16,150,1113,23,82,5947,4555,10502,-0.00984353,0.0957321,-0.995358,0
5503,1850,34,245,1817,45,138,9632,5837,15469,-0.0917198,0.0309674,-0.995303,0
3823,1285,19,168,1265,31,95,6686,4665,11351,-0.119519,0.0370628,-0.99214,0
6006,2043,28,264,1980,47,153,10521,3704,14225,0.698711,0.062114,-0.712703,0
4132,1399,20,185,1375,29,103,7243,5394,12637,-0.00669367,0.0119579,-0.999906,0
5964,2086,29,267,1971,45,147,10509,4542,15051,0.703132,0.0592759,-0.708585,0
5970,2008,29,260,1958,29,99,10353,2094,12447,0.689175,0.0596028,-0.72214,0
5324,1843,25,242,1843,45,139,9461,6176,15637,-0.0132937,0.0150549,-0.999798,0
3779,1299,18,202,1277,28,95,6698,4057,10755,0.695514,0.0687989,-0.715212,0
6305,2186,30,271,2031,53,152,11028,7503,18531,-0.109231,0.0280124,-0.993622,0
4168,1411,20,181,1371,36,101,7288,4147,11435,-0.0109519,0.0124044,-0.999863,0
6305,2034,29,268,2004,44,156,10840,7091,17931,-0.105311,0.0238937,-0.994152,0
3132,1094,15,139,1037,26,77,5520,2798,8318,0.688524,0.0544443,-0.723167,0
6043,2045,28,267,1980,45,176,10584,3612,14196,0.696105,0.0617742,-0.715278,0
5887,2104,45,267,1601,30,102,10036,4484,14520,-0.0091421,0.0951438,-0.995422,0
3100,1092,15,140,1042,30,78,5497,4610,10107,-0.00901317,0.09564,-0.995375,0
5892,2056,28,265,2038,48,152,10479,6469,16948,-0.0142774,0.0146935,-0.99979,0
6035,2061,47,270,1975,51,149,10588,3630,14218,0.688269,0.069864,-0.722083,0
4106,1404,20,181,1382,34,103,7230,4567,11797,-0.0181704,0.0472454,-0.998718,0
6595,2074,29,270,1963,46,146,11123,6775,17898,-0.122177,0.0262558,-0.992161,0
4100,1446,20,180,1366,32,102,7246,5762,13008,-0.120344,0.0286654,-0.992319,0
3769,1313,23,179,1304,29,94,6711,3940,10651,-0.0347777,0.0884828,-0.99547,0
5867,2025,28,263,1989,44,149,10365,6985,17350,-0.0130034,0.0126483,-0.999835,0
3212,1108,17,140,1043,27,77,5624,2152,7776,0.693591,0.0672742,-0.717221,0
5866,2021,29,261,1949,46,147,10319,7538,17857,-0.00576621,0.0100573,-0.999932,0
4098,1402,18,182,1340,31,101,7172,2655,9827,0.696838,0.0537399,-0.715213,0
5929,1995,34,265,1942,40,146,10351,3029,13380,0.702016,0.0549119,-0.710041,0
6046,2074,28,269,1976,30,105,10528,2707,13235,0.694835,0.0544658,-0.717104,0
3088,1090,15,140,1036,21,78,5468,4247,9715,-0.0153882,0.0951784,-0.995341,0
5926,2033,29,266,1933,43,145,10375,9333,19708,-0.110219,0.0277153,-0.993521,0
4187,1439,20,184,1390,32,103,7355,4403,11758,-0.104069,0.0186963,-0.994394,0
3795,1328,19,170,1322,29,97,6760,4365,11125,-0.0106602,0.0139652,-0.999846,0
6882,2042,28,317,2023,48,152,11492,5864,17356,-0.108703,0.0210053,-0.993852,0
4131,1471,20,181,1396,35,103,7337,4005,11342,-0.0134155,0.0409144,-0.999073,0
5422,1829,26,238,1744,39,131,9429,7662,17091,-0.00938726,0.0482042,-0.998794,0
3818,1340,18,168,1356,32,97,6829,5812,12641,-0.0132833,0.0120645,-0.999839,0
2926,997,14,131,999,22,86,5175,3275,8450,-0.00980383,0.0123751,-0.999875,0
5912,2096,37,267,2001,43,147,10503,6600,17103,-0.0884768,0.0275374,-0.995698,0
5878,2010,32,261,1770,30,101,10082,3258,13340,-0.117255,0.0280791,-0.992705,0
6230,2043,27,292,1937,43,148,10720,5511,16231,-0.107913,0.0210679,-0.993937,0
3083,1105,14,142,1064,24,78,5510,2238,7748,-0.00843155,0.0121633,-0.999891,0
5985,2073,27,268,2023,43,138,10557,8275,18832,-0.118887,0.0333762,-0.992347,0
4096,1435,20,211,1364,34,104,7264,4090,11354,-0.106841,0.0231812,-0.994006,0
4840,1678,25,241,1611,38,124,8557,5397,13954,-0.0152029,-0.0163334,-0.999751,0
5888,2029,29,261,1961,49,147,10364,3459,13823,0.699489,0.0650818,-0.711674,0
5703,1953,26,242,1776,38,134,9872,3157,13029,0.697809,0.0578008,-0.713948,0
5262,1812,23,235,1771,39,132,9274,5847,15121,-0.112967,0.0285781,-0.993187,0
2957,1120,15,133,990,24,73,5312,3859,9171,-0.0135038,0.0481993,-0.998746,0
5833,2167,36,386,2214,51,155,10842,7052,17894,-0.120074,0.0257961,-0.99243,0
3978,1332,18,171,1326,32,96,6953,4687,11640,-0.120632,0.0313561,-0.992202,0
4905,1713,23,220,1627,48,121,8657,3380,12037,0.700381,0.0585439,-0.711364,0
5854,2062,28,263,2001,47,149,10404,9133,19537,-0.10737,0.0288342,-0.993801,0
4028,1358,19,180,1395,29,102,7111,5650,12761,-0.0116643,0.0122988,-0.999857,0
5895,2057,29,263,1956,43,161,10404,7677,18081,-0.101596,0.02245,-0.994572,0
4106,1390,19,203,1336,31,101,7186,2862,10048,0.693489,0.0547794,-0.718382,0
5918,2056,27,264,1961,40,146,10412,3586,13998,0.70314,0.0640164,-0.708164,0
3803,1279,18,170,1249,26,94,6639,6124,12763,-0.126021,0.0202153,-0.991821,0
4934,1698,23,216,1625,39,124,8659,3953,12612,0.700289,0.0726436,-0.710154,0
5975,2075,29,269,1995,47,150,10540,6879,17419,-0.012643,-0.0171391,-0.999773,0
3124,1100,15,140,1049,26,79,5533,3582,9115,-0.0115785,0.0126237,-0.999853,0
6055,2044,28,265,1960,44,147,10543,5629,16172,-0.102638,0.024271,-0.994423,0
4070,1440,20,181,1371,31,103,7216,4440,11656,-0.122037,0.0211593,-0.9923,0
5881,2072,28,265,1988,47,150,10431,7613,18044,-0.123003,0.0242313,-0.992111,0
4011,1406,19,182,1373,37,102,7130,2501,9631,0.699943,0.0599147,-0.711681,0
5857,2013,28,261,1947,41,146,10293,6825,17118,-0.0102665,0.0122001,-0.999873,0
6078,2031,29,299,2017,46,152,10652,2991,13643,0.699527,0.0626252,-0.711857,0
4109,1411,21,185,1364,36,105,7231,5038,12269,-0.104926,0.0292157,-0.994051,0
5879,2098,29,266,1971,46,158,10447,6698,17145,-0.0821623,0.0594883,-0.994842,0
4070,1455,20,184,1361,31,101,7222,4781,12003,-0.102372,0.0275579,-0.994364,0
5372,1822,25,236,1747,62,133,9397,4029,13426,-0.0119457,0.0129909,-0.999844,0
5929,2035,29,263,1931,43,145,10375,6129,16504,-0.00863403,0.01172,-0.999894,0
4057,1426,19,184,1410,33,105,7234,2874,10108,0.700609,0.0582945,-0.71116,0
5848,2057,28,265,1984,46,151,10379,3668,14047,0.703712,0.0613815,-0.707828,0
5903,2049,28,269,1949,57,173,10428,3845,14273,0.703321,0.0650925,-0.707886,0
4140,1460,21,183,1353,29,101,7287,2451,9738,0.704016,0.0622344,-0.707452,0
5967,2114,28,266,2007,48,149,10579,6896,17475,-0.112595,0.0254698,-0.993315,0
4088,1397,18,182,1390,30,100,7205,2336,9541,0.703823,0.0630586,-0.707571,0
6021,2070,27,265,1964,42,148,10537,8364,18901,-0.115367,0.0348449,-0.992712,0
4073,1432,24,183,1412,31,102,7257,2858,10115,0.685578,0.0497424,-0.726298,0
5973,2071,52,265,1948,40,147,10496,3198,13694,0.698891,0.0541256,-0.713177,0
5897,2012,29,260,1934,45,145,10322,5489,15811,-0.00941589,0.0942571,-0.995504,0
3101,1062,16,140,1051,24,78,5472,2548,8020,0.681976,0.0670119,-0.728299,0
5888,2017,26,236,1983,41,161,10352,7223,17575,-0.119837,0.0335271,-0.992227,0
3768,1326,17,183,1311,30,110,6745,2311,9056,0.698657,0.0621209,-0.712755,0
6005,2004,28,264,1995,43,148,10487,4112,14599,0.699128,0.0744406,-0.711111,0
5901,2037,28,265,1881,37,164,10313,3242,13555,0.702204,0.0612084,-0.709341,0
4072,1417,19,182,1356,30,101,7177,2542,9719,0.696377,0.0677264,-0.714473,0
5916,2083,29,273,1976,44,148,10469,8541,19010,-0.105744,0.0306075,-0.993922,0
4484,1381,20,225,1398,31,104,7643,2883,10526,-0.107105,0.0241181,-0.993955,0
5840,2002,31,251,1762,41,133,10060,7222,17282,-0.00951651,0.0102246,-0.999902,0
3785,1296,17,169,1310,28,94,6699,2161,8860,0.704146,0.0576708,-0.70771,0
5866,2033,28,263,2005,56,190,10441,3148,13589,0.694463,0.0589418,-0.71711,0
4051,1381,18,232,1377,30,104,7193,3091,10284,0.694267,0.0767661,-0.715612,0
5906,2086,36,266,1931,40,146,10411,7809,18220,-0.0134341,0.0462036,-0.998842,0
4093,1754,26,210,1435,32,105,7655,3948,11603,-0.120055,0.0254247,-0.992442,0
4862,1657,23,212,1576,37,119,8486,6112,14598,-0.106595,0.0209957,-0.994081,0
5652,1631,24,214,1608,37,120,9286,5015,14301,-0.106987,0.0242267,-0.993966,0
5943,2018,28,263,1933,45,145,10375,4337,14712,0.682227,0.0808835,-0.726653,0
4161,1411,54,222,1397,39,107,7391,6626,14017,-0.0129646,0.0962004,-0.995278,0
4034,1388,19,213,1748,35,100,7537,5353,12890,-0.0109502,-0.0169186,-0.999797,0
4809,1648,22,214,1608,36,122,8459,6653,15112,-0.120318,0.0202171,-0.992529,0
5837,2046,28,260,2003,64,153,10391,7462,17853,-0.00804386,0.012303,-0.999892,0
3178,1083,14,139,1038,26,77,5555,4049,9604,-0.030403,0.0856903,-0.995858,0
5888,2036,28,262,1996,49,147,10406,8705,19111,-0.0963551,0.0267319,-0.994988,0
3082,1111,16,182,1348,25,80,5844,2070,7914,0.697704,0.060602,-0.713818,0
5881,2049,29,264,2041,46,154,10464,3796,14260,0.704241,0.0522045,-0.708039,0
6061,2027,28,263,2370,44,153,10946,4809,15755,0.704099,0.0650277,-0.707119,0
3182,996,12,113,950,24,87,5364,1531,6895,0.690944,0.0675632,-0.719744,0
2153,721,11,93,702,15,53,3748,2462,6210,-0.119025,0.032818,-0.992349,0
2537,808,12,107,821,25,65,4375,2595,6970,-0.119583,0.0296564,-0.992381,0
6108,2044,28,273,2662,48,152,11315,6493,17808,-0.00895588,0.0111097,-0.999898,0
4573,1376,21,228,1369,31,103,7701,4653,12354,-0.105102,0.028634,-0.994049,0
3227,1121,15,140,1042,25,77,5647,3951,9598,-0.11255,0.0191738,-0.993461,0
6034,2172,30,266,2002,44,148,10696,6810,17506,-0.0108808,0.0139829,-0.999843,0
3206,1344,16,142,1131,27,81,5947,4022,9969,-0.0078842,0.010261,-0.999916,0
5992,2113,29,267,1957,46,146,10550,6459,17009,-0.0109782,0.0130864,-0.999854,0
4260,1406,20,181,1317,31,100,7315,3297,10612,0.688561,0.037356,-0.724215,0
4368,1344,18,169,1292,28,96,7315,5603,12918,-0.00630465,0.0101291,-0.999929,0
3862,1317,18,169,1321,28,96,6811,2320,9131,0.697426,0.0561385,-0.714455,0
6099,2296,35,390,2390,50,175,11435,5599,17034,-0.110865,0.0296929,-0.993392,0
2572,877,12,112,794,24,56,4447,2219,6666,-0.00622714,0.00952875,-0.999935,0
1812,630,9,82,611,15,53,3212,2455,5667,-0.00948784,0.0114568,-0.999889,0
2215,748,11,98,725,18,54,3869,1822,5691,0.687362,0.0630806,-0.723571,0
6178,2068,34,275,2090,60,224,10929,3568,14497,0.701141,0.0709136,-0.709487,0
6002,2068,29,265,1984,58,106,10512,3083,13595,0.703748,0.0673488,-0.707251,0
3217,1094,15,138,1037,29,80,5610,2315,7925,0.690816,0.0579295,-0.720707,0
5973,2030,28,264,1952,46,150,10443,6360,16803,-0.113519,0.0323495,-0.993009,0
3469,1104,15,143,1071,24,80,5906,5659,11565,-0.0107601,-0.0177193,-0.999785,0
3841,1300,18,168,1283,33,97,6740,2181,8921,0.703877,0.0606899,-0.707725,0
6081,2098,27,276,2033,42,152,10709,2893,13602,0.698123,0.0621926,-0.713272,0
4120,1390,19,202,1452,43,140,7366,6233,13599,-0.0499572,0.0391299,-0.997985,0
5588,1843,25,240,1872,44,136,9748,3312,13060,0.702951,0.0622564,-0.708509,0
5399,1804,24,236,1739,37,131,9370,5419,14789,-0.00990414,0.0104888,-0.999896,0
5935,2013,27,261,1972,50,148,10406,8435,18841,-0.101153,0.030753,-0.994395,0
3301,1066,15,138,1064,19,63,5666,2609,8275,-0.120203,0.0193309,-0.992561,0
2020,618,8,80,617,14,46,3403,1107,4510,0.697657,0.0518666,-0.714552,0
2216,767,11,98,744,17,55,3908,3022,6930,-0.119271,0.0386755,-0.992108,0
5988,2077,28,272,1961,45,147,10518,3611,14129,0.703708,0.056728,-0.708221,0
5882,1979,29,280,1914,41,147,10272,6053,16325,-0.117163,0.032066,-0.992595,0
4131,1373,22,181,1365,30,108,7210,2205,9415,0.703541,0.0647959,-0.707694,0
5864,1988,28,260,1907,53,147,10247,8727,18974,-0.0127202,0.096891,-0.995214,0
4029,1418,20,183,1328,29,99,7106,2676,9782,0.701028,0.0633524,-0.710314,0
5856,2043,28,272,1948,42,163,10352,2859,13211,0.68619,0.0734688,-0.723702,0
3908,1089,15,141,1044,23,78,6298,1881,8179,0.697839,0.0750117,-0.712316,0
2372,812,11,105,788,18,59,4165,4015,8180,-0.0350042,0.0901635,-0.995312,0
5948,2008,28,278,1915,45,145,10367,3892,14259,0.680269,0.0827483,-0.728277,0
5788,2004,28,257,1911,41,145,10174,2886,13060,0.703657,0.0601686,-0.707988,0
4044,1454,19,203,1377,32,109,7238,2339,9577,0.696064,0.0708328,-0.714478,0
5824,2010,29,258,1954,43,146,10264,7127,17391,-0.0910503,0.0576834,-0.994174,0
4098,1375,19,188,1341,40,111,7172,2489,9661,0.684374,0.0587593,-0.72676,0
5915,1974,27,258,1910,45,144,10273,4038,14311,0.681148,0.0858982,-0.72709,0
5900,1982,27,258,1946,43,155,10311,2711,13022,0.685919,0.0567968,-0.725458,0
4052,1379,19,179,1345,32,99,7105,2555,9660,0.690942,0.0452881,-0.72149,0
5892,2002,31,279,1906,41,145,10296,3010,13306,0.702622,0.0671474,-0.708389,0
5900,1976,26,256,1893,46,142,10239,6820,17059,-0.0071024,-0.0225136,-0.999722,0
3085,1042,14,142,1003,23,76,5385,1847,7232,0.697552,0.0699437,-0.713112,0
5762,1942,51,263,1869,41,141,10069,6242,16311,-0.0127389,-0.0170341,-0.999774,0
5374,1791,25,228,1695,41,130,9284,2433,11717,0.700951,0.0689431,-0.70987,0
5825,2010,26,259,1944,46,152,10262,3679,13941,0.68482,0.0810497,-0.724191,0
3615,1063,16,138,1009,22,76,5939,3600,9539,-0.0098977,0.0188354,-0.999774,0
2104,699,10,91,674,21,50,3649,1081,4730,0.687603,0.0767086,-0.722023,0
6004,2202,33,325,2370,43,148,11125,7148,18273,-0.0142376,-0.0181399,-0.999734,0
5944,2031,27,305,1463,33,100,9903,3110,13013,0.687282,0.0702454,-0.722986,0
3091,1040,14,150,995,22,76,5388,4622,10010,-0.0162657,0.0485927,-0.998686,0
5882,2045,28,260,1996,57,147,10415,3159,13574,0.699163,0.0749303,-0.711025,0
4178,1339,19,177,1326,36,101,7176,2367,9543,0.702969,0.0660585,-0.708147,0
5901,1994,27,261,1894,41,169,10287,7107,17394,-0.0172428,-0.0120542,-0.999779,0
6020,1961,29,257,1912,45,146,10370,2709,13079,0.699689,0.0655474,-0.711435,0
5921,1354,24,178,1361,30,101,8969,2118,11087,0.695742,0.0738235,-0.714488,0
2460,841,11,109,732,15,52,4220,3200,7420,-0.0125421,-0.0189696,-0.999741,0
5826,1960,27,255,1858,67,172,10165,3367,13532,0.673568,0.0649328,-0.736268,0
6204,2411,28,261,1899,48,143,10994,5280,16274,-0.0087633,-0.0223289,-0.999712,0
3117,1030,15,133,1010,26,77,5408,1832,7240,0.68843,0.0765611,-0.721251,0
6286,2042,27,261,1983,48,148,10795,7143,17938,-0.0132542,0.0728166,-0.997257,0
5841,1956,29,255,1564,31,98,9774,4329,14103,-0.0229395,0.0840674,-0.996196,0
2641,839,12,111,815,19,61,4498,3505,8003,-0.0128899,0.0455981,-0.998877,0
5912,1988,29,264,1954,44,145,10336,4462,14798,0.701362,0.0466673,-0.711276,0
6228,2043,28,265,1955,47,148,10714,3313,14027,0.680876,0.0838693,-0.727581,0
4133,1393,19,180,1301,29,97,7152,2366,9518,0.700305,0.0712427,-0.710281,0
5476,1962,30,272,1725,38,152,9655,3945,13600,0.700246,0.0678828,-0.710667,0
4841,1604,24,211,1583,35,116,8414,2766,11180,0.701727,0.0677433,-0.709219,0
5829,2308,30,266,1961,43,146,10583,3420,14003,0.699692,0.0681134,-0.71119,0
5805,1984,34,260,2060,45,152,10340,6824,17164,-0.0141057,0.0436978,-0.998945,0
2636,887,15,138,859,21,64,4620,1185,5805,0.692223,0.0678753,-0.718485,0
5819,1969,28,290,1892,43,145,10186,4304,14490,0.700425,0.0659233,-0.710675,0
5819,2017,27,258,1984,43,149,10297,3865,14162,0.678091,0.0816741,-0.730427,0
4030,1335,20,175,1487,38,133,7218,2333,9551,0.698949,0.071426,-0.711596,0
5818,2050,30,265,1937,43,146,10289,3754,14043,0.697816,0.0752805,-0.71231,0
6099,1969,27,256,1881,42,141,10415,2687,13102,0.68849,0.0822209,-0.720571,0
3991,1362,24,183,1319,28,98,7005,6799,13804,-0.00846472,0.00687515,-0.999941,0
3738,1283,17,164,1280,32,93,6607,1817,8424,0.692362,0.070042,-0.718143,0
6515,2004,27,260,1936,40,146,10928,8366,19294,-0.00809179,-0.0212552,-0.999741,0
3990,1329,19,175,1352,30,98,6993,4827,11820,-0.0101882,0.0411239,-0.999102,0
5265,1788,25,231,1690,39,128,9166,2728,11894,0.698272,0.0476971,-0.714243,0
5798,1986,28,258,1894,43,145,10152,7347,17499,-0.0139439,0.0436897,-0.998948,0
3568,1037,13,133,1028,23,77,5879,1890,7769,0.670363,0.0444188,-0.740702,0
2485,835,13,109,811,18,61,4332,1300,5632,0.69233,0.0720008,-0.71798,0
5780,1989,26,256,1890,42,143,10126,3031,13157,0.701723,0.0679502,-0.709202,0
5812,1924,28,254,1902,42,145,10107,3397,13504,0.694472,0.0645059,-0.716623,0
6002,1975,28,257,2122,43,151,10578,8299,18877,-0.00750929,-0.0180656,-0.999809,0
4394,1389,37,191,1095,26,76,7208,3580,10788,-0.0121886,0.0435319,-0.998978,0
2068,695,11,90,681,16,51,3612,1531,5143,-0.0132095,-0.017349,-0.999762,0
1588,531,29,70,517,12,39,2786,1737,4523,-0.00705113,0.0382243,-0.999244,0
4477,1526,20,193,1522,41,132,7911,2289,10200,0.688568,0.0787481,-0.720884,0
5845,1977,29,256,1920,42,146,10215,3791,14006,0.669563,0.0699626,-0.739453,0
4106,1428,19,180,1355,28,103,7219,5204,12423,-0.0142071,0.0392319,-0.999129,0
4878,1625,23,208,1565,36,116,8451,3377,11828,0.686632,0.0842814,-0.722103,0
6325,1990,28,261,1950,43,149,10746,3197,13943,0.693632,0.069712,-0.716948,0
4007,1400,20,176,1295,31,98,7027,5434,12461,-0.0127599,-0.0179612,-0.999757,0
5305,1832,26,233,1761,42,134,9333,2559,11892,0.694819,0.059853,-0.716689,0
5836,2000,28,255,2220,50,149,10538,4140,14678,0.689976,0.0808301,-0.719306,0
5852,1991,27,259,1909,41,144,10223,6342,16565,-0.0152274,0.0486633,-0.998699,0
3970,1369,19,175,1509,36,102,7180,2856,10036,0.698723,0.0438828,-0.714045,0
5341,1753,24,227,1713,41,159,9258,2571,11829,0.70211,0.0643287,-0.709157,0
6047,1968,27,254,1939,46,148,10429,2779,13208,0.701422,0.0630714,-0.70995,0
5839,2182,36,308,1956,44,146,10511,7384,17895,-0.0139483,-0.0155811,-0.999781,0
3987,1351,29,179,1309,32,98,6985,2359,9344,0.702115,0.070769,-0.708539,0
5606,1738,26,226,1677,37,125,9435,6237,15672,-0.0116873,0.0398075,-0.999139,0
3702,1304,18,160,1186,27,89,6486,5147,11633,-0.0199177,-0.0116074,-0.999734,0
5920,1966,29,251,1837,45,139,10187,8191,18378,-0.00935303,0.00872891,-0.999918,0
5811,1930,29,249,1758,30,96,9903,2676,12579,0.673696,0.0800061,-0.734665,0
4748,1527,21,200,1479,33,112,8120,2521,10641,0.702676,0.0653045,-0.708507,0
5701,1309,18,172,1299,30,96,8625,3620,12245,-0.0129907,0.0436658,-0.998961,0
2545,817,12,109,790,19,59,4351,1457,5808,0.703625,0.0647352,-0.707617,0
5861,1903,27,248,1869,42,143,10093,7286,17379,-0.014482,-0.0167594,-0.999755,0
5992,1920,27,266,1899,44,141,10289,3381,13670,0.698222,0.0791244,-0.711495,0
3986,1358,19,176,1312,29,116,6996,2468,9464,0.680072,0.0671119,-0.730067,0
5797,1981,27,299,1956,40,147,10247,7276,17523,0.657185,0.0503694,-0.752045,0
4038,1336,19,174,1303,27,97,6994,5618,12612,0.673438,0.0553113,-0.737172,0
5134,1863,25,230,1795,37,131,9215,7331,16546,0.587227,0.0643495,-0.80686,0
3725,1233,17,160,1198,25,89,6447,4381,10828,-0.0141519,0.0696051,-0.997474,0
5908,2035,26,259,1898,46,142,10314,6548,16862,0.546817,0.0767952,-0.833723,0
4102,1335,20,177,1305,28,98,7065,3915,10980,-0.0113652,0.043817,-0.998975,0
5811,2024,27,258,1920,44,148,10232,5621,15853,-0.0179884,0.057744,-0.998169,0
3741,1249,17,163,1265,29,93,6557,3639,10196,0.628498,0.0669561,-0.774924,0
5984,1971,29,259,1905,43,145,10336,6163,16499,0.651051,0.108524,-0.751236,0
3745,1266,27,162,1272,27,91,6590,3343,9933,-0.0132205,0.0482581,-0.998747,0
5875,2030,26,255,1879,43,141,10249,7857,18106,0.696313,0.0584928,-0.715351,0
3731,1289,19,181,1226,28,91,6565,4001,10566,0.653838,0.0766331,-0.752745,0
5871,2026,24,270,1736,37,132,10096,4325,14421,0.648754,0.0779842,-0.756992,0
5921,1889,23,237,1839,37,127,10073,-1000,-1000,-1,-1,-1,0
2383,807,11,105,779,19,58,4162,1577,5739,-0.00376089,0.0387173,-0.999243,0
4097,1370,19,178,1344,31,99,7138,4327,11465,0.627364,0.0665121,-0.775881,0
6085,1986,27,259,1880,38,130,10405,5556,15961,-0.0129819,0.0476376,-0.99878,0
3900,1247,17,165,1255,27,102,6713,3330,10043,-0.0123353,0.0448658,-0.998917,0
5786,1994,28,261,1953,42,147,10211,5247,15458,0.638905,0.0948048,-0.763422,0
4077,1398,19,175,1333,27,99,7128,4438,11566,0.645123,0.113735,-0.755566,0
4145,1383,33,202,1314,30,100,7207,4107,11314,-0.0136969,0.0554196,-0.998369,0
3090,1063,15,135,1003,24,75,5405,3154,8559,-0.00256894,0.0400581,-0.999194,0
6066,1948,24,230,1741,40,132,10181,6371,16552,0.614169,0.0501038,-0.787582,0
5838,1989,44,280,1935,44,147,10277,5428,15705,-0.00914798,0.0466269,-0.99887,0
2947,998,12,104,770,18,57,4906,2343,7249,-0.0127374,0.0442008,-0.998941,0
2000,660,9,87,655,15,49,3475,2409,5884,0.649485,0.0995546,-0.75383,0
6192,1774,31,268,1784,40,156,10245,4390,14635,-0.00776021,0.0453438,-0.998942,0
5292,1773,24,228,1722,42,130,9211,4773,13984,-0.0109141,0.046383,-0.998864,0
3007,980,14,127,969,23,72,5192,2899,8091,0.631064,0.0786464,-0.771734,0
5254,2399,25,239,1758,40,133,9848,6201,16049,0.672053,0.0933893,-0.734591,0
3824,1258,17,186,1251,27,113,6676,4903,11579,0.670662,0.0956078,-0.735576,0
5524,1608,31,208,1555,36,116,9078,5073,14151,0.650672,0.112337,-0.751004,0
4769,1655,22,208,1623,34,119,8430,4297,12727,-0.00843761,0.0456192,-0.998923,0
3581,1180,16,154,1121,28,101,6181,3112,9293,-0.0106914,0.0491045,-0.998736,0
5339,2363,24,231,1730,39,131,9857,6131,15988,0.660319,0.112289,-0.742543,0
3785,1289,17,164,1252,28,92,6627,3395,10022,0.654857,0.0991868,-0.749216,0
3688,1269,30,164,1248,27,91,6517,2648,9165,0.661533,0.0850732,-0.745075,0
5448,1754,24,224,1691,38,128,9307,5610,14917,0.665516,0.0981932,-0.739897,0
5169,1825,24,228,1683,36,128,9093,4642,13735,0.653302,0.0751291,-0.753361,0
3718,1201,17,156,1205,25,89,6411,3075,9486,0.648358,0.1054,-0.754005,0
5704,1890,23,226,1623,35,125,9626,5599,15225,0.643329,0.096233,-0.759518,0
5109,1693,23,221,1635,37,124,8842,7082,15924,0.641288,0.0946901,-0.761435,0
4701,1575,22,204,1505,34,116,8157,4702,12859,0.66209,0.0517674,-0.747634,0
5736,1921,24,228,1662,42,128,9741,4405,14146,-0.0176852,0.00622309,-0.999824,0
3868,1495,19,211,1233,31,93,6950,1413,8363,-0.0199366,0.00314709,-0.999796,0
5497,1876,26,243,1846,51,137,9676,1357,11033,-0.0288107,0.0187072,-0.999409,0
5564,2024,25,289,1929,48,144,10023,1258,11281,-0.0401332,0.00505605,-0.999182,0
5585,2044,25,260,2377,64,210,10565,1299,11864,-0.0266635,-0.0124082,-0.999568,0
6219,2278,25,291,2246,54,153,11266,1364,12630,-0.0213967,-0.00185259,-0.999769,0
6821,2323,29,296,2302,60,153,11984,1430,13414,-0.0182612,0.0110656,-0.999772,0
5546,2139,27,273,2175,48,157,10365,1323,11688,-0.0267644,0.0168459,-0.9995,0
5540,2153,27,270,2151,50,158,10349,1284,11633,-0.0146713,0.0192952,-0.999706,0
5127,2017,28,343,2285,47,146,9993,1160,11153,-0.013286,0.0138705,-0.999816,0
6203,2553,32,309,2407,52,158,11714,1334,13048,-0.00185909,0.0070472,-0.999974,0
5977,2211,27,278,2159,58,164,10874,969,11843,-0.00642274,0.011221,-0.999916,0
5080,2006,24,250,1929,63,149,9501,1179,10680,-0.0109312,0.0565489,-0.99834,0
6238,2458,31,332,2340,59,172,11630,1398,13028,-0.0149436,0.0682817,-0.997554,0
4248,1597,19,201,1614,35,115,7829,958,8787,-0.00915538,0.0389847,-0.999198,0
6220,2342,29,351,2362,68,174,11546,1370,12916,0.00329574,0.0140082,-0.999896,0
6596,2379,28,313,2291,51,169,11827,1439,13266,0.00114465,-0.0113619,-0.999935,0
4309,1629,21,210,1593,44,117,7923,966,8889,-0.00295847,-0.0341538,-0.999412,0
6301,2511,30,311,2413,53,158,11777,1381,13158,0.000142002,-0.0242415,-0.999706,0
6337,2886,31,337,2091,39,146,11867,1012,12879,-0.00637169,-0.0161356,-0.99985,0
4374,1758,19,261,1738,35,123,8308,993,9301,-0.00550925,0.00603996,-0.999967,0
6326,2546,27,327,2478,51,179,11934,1404,13338,-0.00642421,0.0213964,-0.999751,0
6162,2582,27,319,2590,51,184,11915,1177,13092,-0.0161385,0.0250135,-0.999557,0
5622,2281,25,305,2287,48,164,10732,1237,11969,-0.021578,0.0177423,-0.99961,0
6324,2581,28,316,2514,76,182,12021,1398,13419,-0.0296221,0.024583,-0.999259,0
6294,2584,39,315,2559,58,199,12048,1400,13448,-0.0311144,0.0135128,-0.999425,0
6319,2558,21,216,1772,38,140,11064,978,12042,-0.027328,0.0128147,-0.999544,0
3306,1350,26,166,1318,29,93,6288,782,7070,-0.0167104,0.0137162,-0.999766,0
6045,2535,50,308,2366,54,172,11530,1395,12925,-0.020708,0.0107076,-0.999728,0
6572,2493,31,308,2438,53,176,12071,1235,13306,-0.0256096,0.0138092,-0.999577,0
4456,1677,21,208,1640,33,117,8152,959,9111,-0.0295416,0.00919065,-0.999521,0
6662,2522,36,305,2545,52,174,12296,1388,13684,-0.0314662,0.0109595,-0.999444,0
4268,1620,20,228,1621,35,117,7909,1044,8953,-0.0258519,0.0210323,-0.999445,0
6358,2439,29,341,2340,71,168,11746,1474,13220,-0.0248998,0.0264663,-0.99934,0
4223,1699,21,202,1614,39,113,7911,972,8883,-0.0204564,0.0304241,-0.999328,0
6339,2343,37,345,2252,70,164,11550,1409,12959,-0.0187004,0.0147596,-0.999716,0
5911,2305,29,286,2187,67,158,10943,1390,12333,-0.0220924,0.0112148,-0.999693,0
6053,2255,31,311,2613,53,163,11479,1618,13097,-0.0180227,0.0170012,-0.999693,0
4235,1539,21,192,1513,32,110,7642,997,8639,-0.022506,-0.00106954,-0.999746,0
6233,2104,29,270,2079,48,151,10914,1752,12666,-0.0242595,-0.00667149,-0.999684,0
5727,2113,30,268,2139,54,155,10486,1373,11859,-0.0202136,0.0136356,-0.999703,0
5105,1883,34,238,1919,46,138,9363,1391,10754,-0.0214406,0.0321232,-0.999254,0
5181,1879,26,235,1818,42,132,9313,1337,10650,-0.0190714,0.0312221,-0.999331,0
5718,2105,29,260,2197,86,153,10548,1488,12036,-0.0224664,0.0202029,-0.999543,0
6255,2051,29,261,2002,57,148,10803,1350,12153,-0.0170314,0.040782,-0.999023,0
3957,1374,20,195,1390,33,102,7071,1057,8128,-0.0267761,0.0358958,-0.998997,0
5763,2076,30,262,1948,56,146,10281,1719,12000,-0.0391823,0.0560314,-0.99766,0
5736,2342,30,262,1920,62,144,10496,1662,12158,-0.0231503,0.0680126,-0.997416,0
4156,1388,22,179,1325,32,98,7200,1195,8395,-0.0121503,0.0624045,-0.997977,0
5847,2030,37,258,1911,64,146,10293,1501,11794,-0.00229477,0.0810203,-0.99671,0
6056,1965,36,255,1934,60,146,10452,1661,12113,0.0256578,0.133802,-0.990676,0
4061,1125,16,127,951,26,70,6376,735,7111,0.0313708,0.104741,-0.994005,0
2478,809,21,102,775,28,57,4270,607,4877,-0.00153489,0.0593061,-0.998239,0
5830,1829,30,234,1726,61,127,9837,1447,11284,0.0303847,0.0993112,-0.994592,0
6123,1646,30,216,1661,64,124,9864,1435,11299,0.0141264,0.0857531,-0.996216,0
6054,1505,31,206,1743,125,125,9789,1401,11190,0.0357904,0.129773,-0.990898,0
5635,1359,30,243,1304,71,105,8747,1386,10133,0.0284215,0.118274,-0.992574,0
5629,1363,28,217,1227,58,126,8648,1443,10091,0.0262734,0.135419,-0.99044,0
5968,1220,39,185,1161,61,97,8731,1824,10555,0.018195,0.131949,-0.99109,0
4989,1107,25,152,1038,50,90,7451,1678,9129,-0.0110989,0.147586,-0.988987,0
5626,1185,28,167,1135,51,92,8284,2219,10503,-0.0203403,0.132755,-0.99094,0
5794,1155,27,165,1079,48,89,8357,2492,10849,-0.0240468,0.131465,-0.991029,0
5573,1123,48,158,1055,44,87,8088,3170,11258,-0.0175164,0.123175,-0.99223,0
5584,1158,34,165,1076,65,88,8170,3025,11195,-0.0202766,0.082004,-0.996426,0
5615,1151,27,176,1136,61,94,8260,4726,12986,-0.0159349,0.105837,-0.994256,0
3834,770,19,106,737,32,76,5574,3943,9517,0.0100011,0.0900881,-0.995884,0
5506,1018,26,147,951,40,80,7768,4475,12243,0.0145562,0.10761,-0.994087,0
5609,999,27,141,888,40,74,7778,4185,11963,-0.00758238,0.25127,-0.967888,0
5388,883,26,137,863,40,73,7410,2926,10336,0.0109821,0.164118,-0.98638,0
5214,917,26,133,816,38,70,7214,2637,9851,0.0379818,0.191464,-0.980764,0
4812,787,21,123,718,35,63,6559,2742,9301,0.0310683,0.189101,-0.981466,0
5416,866,25,148,799,38,72,7364,2374,9738,-0.000942362,0.326111,-0.945331,0
5493,938,26,134,796,35,70,7492,2851,10343,-0.0128649,0.121012,-0.992568,0
3756,644,18,93,522,25,39,5097,1066,6163,-0.0285248,0.20493,-0.978361,0
2377,409,14,64,381,22,32,3299,721,4020,-0.0304899,0.147225,-0.988633,0
5719,998,25,150,937,36,80,7945,1514,9459,0.0013638,0.154441,-0.988001,0
5610,1098,27,213,996,38,89,8071,1416,9487,0.00713417,0.2206,-0.975339,0
5589,1071,27,157,1018,43,90,7995,1464,9459,-0.00762191,0.226664,-0.973943,0
5631,1062,27,166,1112,39,92,8129,1388,9517,0.003482,0.194491,-0.980898,0
5756,1241,27,176,1168,42,97,8507,1375,9882,0.000252305,0.173176,-0.984891,0
5582,1390,28,203,1286,41,112,8642,1401,10043,-0.00148806,0.128587,-0.991698,0
5946,1516,27,210,1462,37,116,9314,1404,10718,0.0164995,0.157615,-0.987363,0
6031,1740,30,228,1673,39,129,9870,1399,11269,0.0386912,0.14282,-0.988992,0
5568,1633,23,214,1594,43,124,9199,1245,10444,0.0321888,0.130815,-0.990884,0
5053,1633,21,208,1690,53,122,8780,1119,9899,0.0196674,0.13442,-0.990729,0
6241,2217,35,291,2236,84,159,11263,1380,12643,0.00787102,0.175086,-0.984522,0
6025,1548,17,182,1483,57,106,9418,895,10313,0.0023879,0.143877,-0.989593,0
3305,1116,16,155,1134,36,81,5843,719,6562,-0.000252668,0.102784,-0.994704,0
5520,1958,23,247,1916,85,140,9889,1666,11555,0.023973,0.120223,-0.992457,0
6075,1909,25,229,1735,100,128,10201,1674,11875,0.0149719,0.147296,-0.988979,0
6041,1626,25,209,1583,59,118,9661,1327,10988,-0.00329237,0.122764,-0.99243,0
3894,1033,16,144,1018,46,80,6231,1130,7361,0.00178646,0.0695437,-0.997577,0
5763,1319,27,202,1201,53,106,8671,1625,10296,0.00390699,0.0921242,-0.99574,0
5619,1210,36,184,1090,58,91,8288,1612,9900,-0.0116824,0.0709254,-0.997413,0
5157,968,37,187,880,39,75,7343,1243,8586,-0.0195241,0.0433575,-0.998869,0
5538,1025,29,150,1269,65,129,8205,1560,9765,-0.0379625,0.0470938,-0.998169,0
5452,957,24,174,916,37,80,7640,1563,9203,-0.0558415,0.0532973,-0.997016,0
5051,999,24,140,924,40,80,7258,1708,8966,-0.141046,0.167864,-0.975668,0
5641,1130,26,172,1062,43,89,8163,2001,10164,-0.0708995,0.130819,-0.988868,0
5628,1136,25,165,1090,42,97,8183,2312,10495,-0.148845,0.21702,-0.964753,0
5565,1198,22,167,1165,42,98,8257,2462,10719,-0.0172343,0.221515,-0.975005,0
5604,1175,24,180,1172,41,99,8295,3620,11915,-0.00947876,0.268469,-0.963242,0
5515,1183,22,167,1133,39,95,8154,2083,10237,-0.00942074,0.225285,-0.974248,0
5699,1212,24,173,1174,49,96,8427,2559,10986,0.00242096,0.273779,-0.96179,0
5664,1229,24,175,1194,45,98,8429,3282,11711,0.00400326,0.295119,-0.955452,0
5109,1210,20,164,1128,40,110,7781,3265,11046,0.0296793,0.342244,-0.939143,0
5152,1255,22,169,1237,43,96,7974,2514,10488,0.0407479,0.314171,-0.948492,0
5929,1665,26,212,1510,49,127,9518,2091,11609,0.0468168,0.304631,-0.951319,0
5360,1504,24,199,1463,45,112,8707,2333,11040,0.0349274,0.267967,-0.962795,0
6020,1884,30,246,1850,41,123,10194,1355,11549,0.00413009,0.27448,-0.961584,0
4484,1410,19,188,1359,32,99,7591,980,8571,-0.00825176,0.26394,-0.964504,0
5818,1679,28,220,1899,56,187,9887,1858,11745,-0.00831714,0.261462,-0.965178,0
8902,2549,38,351,2482,78,138,14538,1363,15901,-0.0470169,0.276937,-0.959737,0
5762,1657,31,219,1474,51,112,9306,1597,10903,-0.0738567,0.354297,-0.932212,0
5148,1091,21,138,999,31,96,7524,1824,9348,-0.061717,0.289123,-0.9553,0
2271,661,14,86,597,24,47,3700,967,4667,-0.0178733,0.188063,-0.981994,0
2424,732,15,104,713,34,76,4098,3140,7238,-0.067732,0.23272,-0.970183,0
6113,1310,27,196,1295,46,107,9094,6814,15908,-0.0730425,0.268305,-0.960561,0
5149,1051,25,151,989,39,86,7490,10564,18054,-0.0692337,0.378134,-0.923158,0
2786,511,12,75,476,23,41,3924,4086,8010,-0.0501707,0.242146,-0.968942,0
1773,267,8,40,255,14,22,2379,3984,6363,-0.0744442,0.315828,-0.945892,0
1944,287,9,45,274,17,25,2601,2088,4689,-0.0769998,0.275432,-0.958232,0
5137,658,22,100,658,46,58,6679,7772,14451,-0.0867816,0.309883,-0.946806,0
4881,556,22,88,483,66,55,6151,6933,13084,-0.14441,0.408014,-0.901482,0
3376,346,14,57,309,27,30,4159,3141,7300,-0.17709,0.275205,-0.944934,0
5340,550,23,90,474,42,47,6566,2704,9270,-0.164578,0.258607,-0.951859,0
4774,443,21,76,405,41,41,5801,2216,8017,-0.134511,0.200711,-0.970372,0
5222,552,25,94,526,59,51,6529,2080,8609,-0.126779,0.225045,-0.966065,0
5357,701,25,111,602,57,75,6928,1788,8716,-0.105549,0.193771,-0.975352,0
6300,760,27,119,651,56,62,7975,1666,9641,-0.0679619,0.148588,-0.986561,0
5402,782,25,126,795,64,70,7264,1423,8687,-0.0732609,0.141623,-0.987206,0
5646,908,27,142,860,66,78,7727,1481,9208,-0.047692,0.157755,-0.986326,0
5727,1104,25,167,1033,67,91,8214,1664,9878,-0.0117498,0.130469,-0.991383,0
5157,1151,24,165,1098,51,118,7764,1239,9003,0.00347022,0.140162,-0.990123,0
5206,1283,23,181,1233,67,102,8095,1292,9387,-0.0200393,0.117914,-0.992822,0
5899,1542,27,217,1478,78,120,9361,1439,10800,-0.0316711,0.140666,-0.989551,0
5751,1680,32,268,1579,89,128,9527,1446,10973,-0.0467478,0.137329,-0.989422,0
5268,1551,24,207,1525,42,118,8735,1317,10052,-0.0600025,0.128517,-0.989891,0
5885,1884,28,248,1813,39,128,10025,1339,11364,-0.0492258,0.119685,-0.991591,0
5960,2137,27,268,1991,77,103,10563,1014,11577,-0.0396118,0.126186,-0.991215,0
4127,1634,18,196,1495,30,111,7611,976,8587,-0.0196486,0.105289,-0.994247,0
6049,2486,27,304,2245,47,156,11314,1387,12701,-0.013977,0.112675,-0.993534,0
5467,2050,25,262,2032,54,149,10039,1417,11456,-0.00263645,0.0821007,-0.996621,0
4946,1869,23,238,1792,76,161,9105,1234,10339,0.000461361,0.0738376,-0.99727,0
5457,1809,25,235,1738,63,132,9459,1357,10816,0.0167398,0.087643,-0.996011,0
5947,1689,28,226,1644,87,141,9762,1532,11294,0.0143891,0.0840057,-0.996361,0
5769,1423,30,194,1324,100,105,8945,1651,10596,-0.00189407,0.0682833,-0.997664,0
5851,1130,29,208,1485,98,125,8926,1578,10504,-0.0197208,0.0775467,-0.996793,0
5251,808,24,124,764,76,68,7115,1243,8358,-0.0335779,0.0645269,-0.997351,0
5542,982,34,151,782,82,67,7640,1467,9107,-0.0652364,0.0877434,-0.994005,0
5430,493,25,87,488,56,45,6624,1577,8201,-0.0652996,0.0695282,-0.995441,0
4830,424,24,74,373,46,38,5809,1832,7641,-0.143055,0.151445,-0.978059,0
5339,544,26,94,490,47,48,6588,2275,8863,-0.155771,0.149795,-0.976369,0
5573,650,25,107,600,40,57,7052,2566,9618,-0.0817138,0.219344,-0.97222,0
5543,679,41,110,667,41,64,7145,3425,10570,-0.173281,0.238649,-0.955521,0
5489,747,27,149,645,59,81,7197,3011,10208,-0.208345,0.194917,-0.958436,0
5559,704,20,115,670,47,63,7178,3352,10530,-0.200591,0.220014,-0.95465,0
5087,661,19,113,670,44,62,6656,3149,9805,-0.205366,0.23979,-0.948855,0
5032,720,19,126,707,69,65,6738,2802,9540,-0.0608105,0.175326,-0.982631,0
5162,765,19,148,824,72,72,7062,2447,9509,-0.0242964,0.242269,-0.969905,0
4973,945,20,140,903,73,78,7132,2201,9333,-0.0264312,0.225743,-0.973828,0
5241,1167,20,160,1074,51,95,7808,3053,10861,-0.0080606,0.343312,-0.939187,0
5159,1353,23,184,1308,35,119,8181,2975,11156,-0.011381,0.325547,-0.945457,0
5298,1645,26,214,1593,41,121,8938,2544,11482,-0.031819,0.396965,-0.917282,0
5931,2102,28,261,2015,58,147,10542,2826,13368,-0.0102801,0.330844,-0.943629,0
5851,2199,31,243,1850,54,138,10366,2384,12750,-0.0414336,0.316728,-0.947611,0
3949,1143,19,151,1145,28,102,6537,1815,8352,-0.0331736,0.264555,-0.9638,0
5615,1546,32,208,1565,62,123,9151,1644,10795,-0.0150156,0.280293,-0.959797,0
5775,1328,31,185,1238,53,125,8735,2904,11639,-0.00399865,0.2863,-0.958132,0
5503,1087,26,153,1018,44,108,7939,5016,12955,-0.0202531,0.299929,-0.953747,0
5056,891,24,131,846,40,72,7060,7484,14544,-0.0361876,0.193474,-0.980438,0
3637,530,16,81,513,31,45,4853,4835,9688,-0.0286212,0.216519,-0.975859,0
4696,539,20,86,488,37,65,5931,-1000,-1000,-1,-1,-1,0
3492,326,15,57,307,27,30,4254,9200,13454,-0.0188733,0.277387,-0.960573,0
5317,485,24,87,440,47,46,6446,8932,15378,-0.0286579,0.297595,-0.954262,0
5795,517,26,88,437,58,45,6966,9921,16887,-0.194159,0.342908,-0.919085,0
2719,244,12,42,220,23,23,3283,2027,5310,-0.166966,0.209156,-0.963523,0
5231,458,23,78,403,43,43,6279,6015,12294,-0.167316,0.296009,-0.940417,0
3553,361,16,60,329,26,33,4378,2314,6692,-0.099593,0.209435,-0.972738,0
2267,251,11,41,235,16,22,2843,1161,4004,-0.0932167,0.148897,-0.984449,0
5471,676,24,110,620,41,60,7002,2692,9694,-0.0926472,0.178248,-0.979614,0
5508,741,24,122,675,45,63,7178,2028,9206,-0.100853,0.177546,-0.978931,0
5592,767,25,125,713,48,67,7337,1669,9006,-0.073929,0.160925,-0.984194,0
5643,930,27,139,814,87,86,7726,1754,9480,-0.0287132,0.146061,-0.988859,0
5730,940,27,148,890,53,80,7868,1477,9345,-0.0302854,0.134755,-0.990416,0
5681,1149,34,242,1376,46,94,8622,1442,10064,-0.0151945,0.129339,-0.991484,0
5768,1153,25,169,1062,46,91,8314,1632,9946,-0.00734176,0.194634,-0.980849,0
6103,1270,27,184,1222,50,102,8958,1471,10429,0.00934934,0.181169,-0.983408,0
5777,1535,33,299,1842,69,128,9683,1401,11084,0.0122286,0.161838,-0.986741,0
5846,1564,26,223,1478,60,120,9317,1467,10784,0.0164638,0.157784,-0.987337,0
6194,1976,33,353,2244,100,136,11036,1405,12441,0.0262768,0.152646,-0.987931,0
5930,1901,25,243,1920,67,140,10226,1426,11652,0.0185113,0.135647,-0.990584,0
4093,1452,18,180,1375,44,102,7264,1003,8267,0.00616749,0.127309,-0.991844,0
4123,1508,18,190,1467,45,108,7459,991,8450,0.000407614,0.112224,-0.993683,0
6136,2224,26,285,2191,61,164,11087,1423,12510,0.00238707,0.104018,-0.994573,0
6446,2228,26,332,1724,40,135,10931,1074,12005,-0.000844787,0.0954593,-0.995433,0
5397,1972,22,250,1909,50,152,9752,1324,11076,-0.00356327,0.0867373,-0.996225,0
6738,2038,24,272,2044,90,156,11362,1611,12973,0.00811764,0.0887598,-0.99602,0
5874,1894,23,244,1825,57,143,10060,1696,11756,0.0136298,0.0666981,-0.99768,0
6578,1937,24,236,1687,55,132,10649,1623,12272,0.0140665,0.0708042,-0.997391,0
6362,1472,24,195,1324,68,109,9554,1789,11343,0.0169358,0.0614888,-0.997964,0
5585,1133,25,167,1102,61,95,8168,1603,9771,0.0123379,0.0768344,-0.996968,0
6027,1012,35,153,958,61,83,8329,1535,9864,-0.00921611,0.0348248,-0.999351,0
5507,851,28,157,762,85,70,7460,1377,8837,-0.0119633,0.0238575,-0.999644,0
5459,697,26,114,638,62,61,7057,1448,8505,-0.00575121,0.0273726,-0.999609,0
5533,630,25,104,564,66,55,6977,1506,8483,-0.00918782,0.073995,-0.997217,0
5350,559,25,93,544,64,53,6688,2045,8733,-0.0130323,0.0371558,-0.999224,0
5570,519,26,90,471,57,47,6780,2117,8897,-0.129456,0.0934714,-0.98717,0
5381,506,27,86,445,57,46,6548,1757,8305,-0.13525,0.092542,-0.98648,0
5575,543,25,94,506,56,51,6850,1829,8679,-0.13622,0.157864,-0.97802,0
5465,637,25,123,636,56,60,7002,2198,9200,-0.12721,0.173697,-0.976548,0
5448,672,22,108,615,51,58,6974,2930,9904,-0.142198,0.157939,-0.977157,0
5540,674,21,131,636,57,62,7121,3165,10286,-0.159071,0.156341,-0.97481,0
5497,809,22,161,658,57,63,7267,4160,11427,-0.156881,0.230626,-0.960312,0
5625,759,21,114,702,74,63,7358,4478,11836,-0.0208468,0.155357,-0.987638,0
5662,762,22,120,756,76,68,7466,3350,10816,-0.0469943,0.0922923,-0.994622,0
5948,930,22,141,981,81,80,8183,3096,11279,-0.000867489,0.249768,-0.968305,0
3879,651,15,98,629,54,55,5381,1915,7296,-0.00676633,0.214886,-0.976616,0
5640,1107,23,162,1169,112,125,8338,3289,11627,0.0190976,0.314264,-0.949144,0
5778,1300,25,215,1411,73,137,8939,3749,12688,-0.00569716,0.309178,-0.950987,0
3956,1066,17,141,1062,38,99,6379,2663,9042,0.00530472,0.298284,-0.954462,0
5895,1858,26,237,1794,89,133,10032,2704,12736,0.0280909,0.301178,-0.953154,0
5880,2096,26,255,2017,50,145,10469,2600,13069,0.02403,0.259909,-0.965334,0
5826,1957,43,245,1869,47,138,10125,2674,12799,0.0193943,0.270827,-0.962433,0
5798,1653,31,228,2269,93,127,10199,2766,12965,-0.0138509,0.277699,-0.960569,0
6080,1487,30,198,1440,82,112,9429,3989,13418,-0.00322064,0.29194,-0.956432,0
5577,1136,29,165,1087,50,90,8134,3454,11588,-0.0124229,0.227067,-0.9738,0
3879,707,17,106,695,57,60,5521,3109,8630,-0.0244041,0.21939,-0.975332,0
5508,974,25,140,888,48,77,7660,4127,11787,-0.018384,0.227659,-0.973567,0
6051,927,25,153,878,46,101,8181,6013,14194,-0.0265462,0.192338,-0.98097,0
2965,413,13,64,384,23,38,3900,2824,6724,-0.0302877,0.275179,-0.960916,0
5440,608,25,108,592,45,60,6878,7727,14605,-0.0569925,0.219214,-0.974011,0
3743,354,17,62,323,31,32,4562,7092,11654,-0.033046,0.317298,-0.94775,0
4935,442,21,75,431,54,51,6009,8127,14136,-0.03269,0.335632,-0.941426,0
3409,297,15,52,285,24,29,4111,6629,10740,-0.157181,0.2021,-0.96667,0
5772,470,25,81,423,41,43,6855,3242,10097,-0.138651,0.190136,-0.971918,0
5319,553,24,86,464,40,46,6532,2436,8968,-0.116067,0.190156,-0.974869,0
4841,559,22,86,460,33,69,6070,2096,8166,-0.113683,0.226968,-0.967244,0
4836,558,22,89,483,40,47,6075,2309,8384,-0.0934326,0.151623,-0.984013,0
5352,641,29,103,580,44,57,6806,3059,9865,-0.102612,0.157686,-0.982144,0
5451,667,24,107,641,46,61,6997,2425,9422,-0.0703456,0.152684,-0.985768,0
5558,702,25,115,665,46,63,7174,1957,9131,-0.0575625,0.15437,-0.986335,0
5488,735,26,120,682,48,65,7164,1899,9063,-0.0606481,0.110615,-0.992011,0
5529,775,24,123,758,51,70,7330,2176,9506,-0.0402366,0.104197,-0.993743,0
5555,833,24,132,828,59,75,7506,1614,9120,-0.00714316,0.153391,-0.98814,0
5542,862,25,148,811,58,74,7520,1551,9071,-0.0202941,0.141086,-0.989789,0
4419,637,17,98,602,47,54,5874,980,6854,-0.0333719,0.0909789,-0.995293,0
5574,976,24,144,919,53,100,7790,1613,9403,-0.0520683,0.0942606,-0.994185,0
5596,1005,24,174,961,51,87,7898,1558,9456,-0.0258075,0.0822597,-0.996277,0
5992,1161,26,163,1020,51,92,8505,1511,10016,-0.0226728,0.107136,-0.993986,0
5599,1105,25,168,1055,55,92,8099,1402,9501,-0.025841,0.105957,-0.994035,0
5714,1180,26,177,1111,60,128,8396,1414,9810,-0.000429433,0.138394,-0.990377,0
5607,1237,25,200,1204,58,107,8438,1372,9810,-0.00778188,0.125416,-0.992074,0
5769,1392,25,194,1362,57,114,8913,1432,10345,-0.00993962,0.121996,-0.992481,0
5766,1493,27,208,1452,56,117,9119,1452,10571,-0.00888214,0.119252,-0.992824,0
5968,1634,29,239,1606,97,126,9699,1348,11047,-0.0128231,0.118058,-0.992924,0
5350,1585,23,210,1567,50,140,8925,1346,10271,-0.0126647,0.135564,-0.990688,0
6103,2393,33,336,1973,58,148,11044,1581,12625,-0.00223674,0.0960796,-0.995371,0
6026,2097,24,267,1642,48,105,10209,1019,11228,0.00749567,0.0747963,-0.997171,0
5997,2038,27,257,1950,60,147,10476,1285,11761,-0.000108753,0.0738823,-0.997267,0
5528,1940,23,254,1936,68,143,9892,1262,11154,-0.0113955,0.0756174,-0.997072,0
6151,2135,26,276,2027,76,153,10844,1498,12342,-0.00503636,0.0811714,-0.996688,0
5870,2004,25,263,2299,64,165,10690,1329,12019,0.0142134,0.0642632,-0.997832,0
4035,1272,31,161,1249,90,101,6939,1060,7999,0.0143659,0.0554287,-0.99836,0
5921,1761,42,211,1520,54,117,9626,1568,11194,0.00164263,0.106493,-0.994312,0
5987,1252,26,178,1198,109,100,8850,1545,10395,0.0103854,0.0882352,-0.996046,0
5643,1063,31,160,1005,58,89,8049,1389,9438,0.0170024,0.0435279,-0.998908,0
5531,914,29,139,856,105,83,7657,1437,9094,0.00629905,0.0146837,-0.999873,0
5523,800,27,123,723,64,66,7326,1830,9156,0.00721639,-0.00547554,-0.999959,0
5725,638,36,109,602,71,61,7242,3155,10397,0.00324803,0.0558836,-0.998432,0
5726,577,27,99,513,73,50,7065,3661,10726,0.127615,0.210997,-0.96912,0
5468,565,26,96,524,68,52,6799,3261,10060,0.134095,0.23677,-0.962268,0
2713,267,12,42,222,23,22,3301,6741,10042,-0.0336845,-0.0246387,-0.999129,0
1534,166,8,28,148,14,14,1912,4925,6837,-0.214842,-0.0083515,-0.976613,0
2709,323,11,51,283,27,28,3432,4706,8138,-0.0910744,-0.104585,-0.990337,0
5391,649,22,105,595,54,58,6874,-1000,-1000,-1,-1,-1,0
2816,325,13,53,303,22,30,3562,1390,4952,-0.0177541,0.196447,-0.980354,0
6260,802,25,155,655,55,64,8016,4746,12762,-0.0531461,0.11498,-0.991945,0
5489,736,22,117,691,68,65,7188,-1000,-1000,-1,-1,-1,0
3866,575,22,90,578,29,49,5209,1885,7094,-0.0342407,0.171215,-0.984639,0
5749,988,25,145,908,91,81,7987,-1000,-1000,-1,-1,-1,0
5135,1044,23,149,945,50,82,7428,2427,9855,-0.0426405,0.185786,-0.981665,0
5238,1289,34,250,1662,93,101,8667,-1000,-1000,-1,-1,-1,0
5864,1607,27,217,1575,52,123,9465,2670,12135,0.0353712,0.320506,-0.946586,0
4003,1331,19,164,1283,46,94,6940,3645,10585,0.00538655,0.316667,-0.948521,0
5269,1858,24,234,1804,65,130,9384,3876,13260,0.0299696,0.317423,-0.947811,0
4845,1578,24,202,1548,49,115,8361,3483,11844,0.0167502,0.289626,-0.956994,0
6573,1763,29,237,1741,82,135,10560,2554,13114,0.0336113,0.30641,-0.951307,0
3973,1126,20,177,1105,53,84,6538,1566,8104,0.0213719,0.278915,-0.960078,0
5756,1319,28,197,1255,69,104,8728,-1000,-1000,-1,-1,-1,0
3850,794,17,126,773,32,63,5655,-1000,-1000,-1,-1,-1,0
5711,989,26,147,900,51,79,7903,-1000,-1000,-1,-1,-1,0
6557,891,27,135,752,45,69,8476,-1000,-1000,-1,-1,-1,0
3751,556,22,80,434,44,41,4928,-1000,-1000,-1,-1,-1,0
5397,652,27,108,581,59,57,6881,-1000,-1000,-1,-1,-1,0
3691,386,16,65,374,33,37,4602,-1000,-1000,-1,-1,-1,0
4392,411,20,77,399,40,41,5380,-1000,-1000,-1,-1,-1,0
5468,515,27,88,440,45,44,6627,-1000,-1000,-1,-1,-1,0
3627,316,17,54,298,40,31,4383,-1000,-1000,-1,-1,-1,0
4763,399,40,72,365,77,53,5769,-1000,-1000,-1,-1,-1,0
3350,302,15,50,277,38,29,4061,-1000,-1000,-1,-1,-1,0
5343,500,22,84,410,49,43,6451,10298,16749,-0.0560327,0.523727,-0.850041,0
3076,266,21,52,238,40,25,3718,4668,8386,-0.0297621,0.397124,-0.917282,0
2025,198,9,33,170,17,15,2467,-1000,-1000,-1,-1,-1,0
1977,226,9,37,203,21,19,2492,6122,8614,0.00108108,0.21957,-0.975596,0
5407,627,23,104,610,68,60,6899,14272,21171,-0.118907,0.22021,-0.968178,0
3513,439,16,75,403,39,38,4523,6476,10999,-0.0439139,0.29123,-0.955645,0
5720,701,32,137,653,60,63,7366,8815,16181,0.215131,0.232859,-0.948417,0
3887,526,17,83,531,38,46,5128,3916,9044,-0.19815,0.0609163,-0.978277,0
5497,900,26,125,748,60,70,7426,4121,11547,-0.168753,0.0952436,-0.981046,0
5421,835,23,129,775,59,70,7312,3885,11197,-0.111402,0.0851288,-0.990123,0
5612,875,23,135,802,56,73,7576,2055,9631,-0.124518,0.0754498,-0.989344,0
4941,826,22,124,804,54,72,6843,1968,8811,-0.137439,0.106338,-0.984785,0
4577,619,16,94,585,39,51,5981,1094,7075,-0.0831317,0.0927094,-0.992217,0
3380,676,15,94,592,36,51,4844,1130,5974,-0.0873869,0.0726637,-0.993521,0
5717,1190,26,172,1125,67,95,8392,1934,10326,0.140155,0.132162,-0.981269,0
5675,1264,26,179,1185,71,100,8500,1755,10255,0.00198765,0.148705,-0.98888,0
5942,1411,25,196,1301,60,109,9044,1602,10646,0.0142373,0.115377,-0.99322,0
5695,1424,26,217,1774,135,120,9391,1509,10900,0.0127924,0.139973,-0.990073,0
6193,1593,27,218,1532,56,122,9741,1422,11163,0.00529514,0.144343,-0.989514,0
5978,2095,28,242,1883,68,137,10431,1433,11864,0.0136597,0.126927,-0.991818,0
4112,1380,17,173,1332,41,100,7155,976,8131,0.0211926,0.11207,-0.993474,0
6071,2200,26,299,2096,64,157,10913,1429,12342,0.00345909,0.0949962,-0.995472,0
6147,2187,25,309,2120,134,161,11083,1431,12514,-0.0049965,0.107248,-0.99422,0
5423,1987,22,257,1913,107,144,9853,1294,11147,0.00245698,0.08077,-0.99673,0
6138,2179,27,310,1961,77,151,10843,1514,12357,-0.00101595,0.104874,-0.994485,0
5917,1806,18,160,1183,57,89,9230,1124,10354,0.0130464,0.0836388,-0.996411,0
5965,1605,30,224,1648,80,125,9677,1560,11237,0.0274571,0.0944671,-0.995149,0
5697,1354,27,186,1290,111,106,8771,1438,10209,0.0174139,0.104521,-0.99437,0
5674,1230,29,175,1198,57,98,8461,1393,9854,0.0227903,0.0874393,-0.995909,0
5778,1526,35,169,1040,83,114,8745,1609,10354,0.0243196,0.0703784,-0.997224,0
5643,913,26,135,881,55,77,7730,1628,9358,0.010153,0.0896053,-0.995926,0
5601,790,27,121,738,58,68,7403,1911,9314,-0.00487673,0.0994298,-0.995033,0
5473,656,28,109,632,60,59,7017,2374,9391,-0.0336587,0.0905192,-0.995326,0
5736,651,36,105,598,62,56,7244,2882,10126,-0.101547,0.101419,-0.989648,0
5688,707,25,114,703,87,67,7391,6216,13607,-0.0856116,0.137863,-0.986744,0
3789,556,17,81,498,44,44,5029,4304,9333,-0.113196,0.109783,-0.987489,0
5945,837,23,140,793,76,73,7887,8972,16859,-0.0448632,0.132642,-0.990148,0
5535,809,21,124,774,77,69,7409,3122,10531,-0.12251,-0.0320154,-0.991951,0
5619,820,23,127,773,76,91,7529,2952,10481,-0.0290819,0.139366,-0.989814,0
5185,611,16,92,578,42,69,6593,1813,8406,0.0955566,0.263648,-0.959875,0
2416,388,8,53,333,22,29,3249,807,4056,0.00950862,0.144293,-0.98949,0
2184,447,10,77,421,24,36,3199,859,4058,-0.0116062,0.121733,-0.992495,0
6144,1383,23,192,1290,54,106,9192,2260,11452,0.0202459,0.151652,-0.988226,0
5903,1556,24,211,1539,57,123,9413,1982,11395,0.153401,0.24893,-0.956296,0
5871,2013,23,245,1859,76,160,10247,2222,12469,0.191906,0.270475,-0.943406,0
6105,2150,26,301,2140,101,155,10978,2360,13338,0.250174,0.299954,-0.920565,0
3728,1271,23,153,1250,35,84,6544,1253,7797,0.25107,0.295681,-0.921703,0
2548,852,11,110,1092,27,61,4701,961,5662,0.181222,0.229549,-0.956277,0
2669,1057,12,128,1059,52,74,5051,688,5739,0.145006,0.206122,-0.967723,0
6084,2117,30,312,2404,98,237,11282,1685,12967,0.238362,0.347072,-0.907041,0
4627,1398,43,178,1057,65,76,7444,996,8440,0.187998,0.298829,-0.935606,0
2114,680,11,88,654,28,48,3623,534,4157,0.154586,0.221144,-0.962912,0
1912,626,10,80,593,42,44,3307,603,3910,0.113332,0.176368,-0.977778,0
5713,1440,29,198,1407,151,113,9051,6951,16002,0.118235,0.189248,-0.974785,0
4263,909,19,128,950,68,74,6411,4297,10708,0.100923,0.196755,-0.975245,0
5606,1257,28,174,1208,52,97,8422,6617,15039,0.0949491,0.235767,-0.96716,0
3853,759,49,111,724,72,61,5629,-1000,-1000,-1,-1,-1,0
5716,967,27,146,902,90,79,7927,10057,17984,0.0812356,0.243785,-0.966421,0
2888,460,14,78,421,52,38,3951,6364,10315,0.0663647,0.199715,-0.977604,0
4525,615,20,96,564,51,51,5922,11423,17345,0.0690931,0.231353,-0.970413,0
3208,391,34,64,363,36,35,4131,12921,17052,0.0474919,0.0981223,-0.994041,0
2489,296,13,53,297,28,29,3205,4980,8185,0.0341024,0.276172,-0.960503,0
5403,578,24,95,490,62,49,6701,11147,17848,-0.00356232,0.341532,-0.939863,0
5333,496,24,84,444,60,45,6486,6649,13135,0.0103918,0.209405,-0.977774,0
2729,244,13,51,219,31,24,3311,5380,8691,0.021103,0.212815,-0.976865,0
4266,373,19,66,331,46,35,5136,5497,10633,0.0100884,0.180051,-0.983606,0
5557,443,23,79,410,60,45,6617,10504,17121,0.0282003,0.152619,-0.987882,0
3612,316,16,60,294,40,47,4385,9376,13761,0.011425,0.271311,-0.962424,0
3297,308,15,51,259,33,27,3990,6113,10103,0.201872,0.301124,-0.931972,0
5468,528,29,101,427,55,46,6654,7732,14386,0.016521,0.180995,-0.983345,0
3600,336,17,57,300,37,31,4378,3796,8174,0.194946,0.265803,-0.944111,0
6299,570,27,132,519,53,48,7648,7621,15269,0.22384,0.328067,-0.917751,0
3745,387,17,65,336,26,25,4601,2851,7452,0.0221286,0.187579,-0.982,0
2026,201,9,34,182,17,17,2486,1089,3575,-0.0140087,0.0811484,-0.996603,0
2401,288,14,53,303,22,25,3106,1343,4449,-0.0766904,0.151019,-0.985552,0
6213,708,27,120,664,47,61,7840,3888,11728,0.0228902,0.210773,-0.977267,0
5708,794,25,125,751,48,70,7521,3650,11171,0.0492571,0.153005,-0.986997,0
5611,909,25,143,820,49,74,7631,2020,9651,-0.0655247,0.148892,-0.98668,0
5546,965,26,145,932,45,82,7741,2061,9802,-0.0828896,0.148128,-0.985488,0
5604,1102,26,162,1032,37,88,8051,1741,9792,0.0211352,0.114854,-0.993157,0
5845,1224,26,179,1142,48,97,8561,1507,10068,0.0133458,0.127948,-0.991691,0
5849,1350,27,196,1317,52,108,8899,1449,10348,0.0120657,0.109455,-0.993919,0
5961,1326,26,190,1305,48,105,8961,1300,10261,-0.000959667,0.115972,-0.993252,0
5378,1511,25,202,1908,73,159,9256,1337,10593,-0.0318724,0.143647,-0.989116,0
4899,1503,22,199,1467,63,121,8274,1151,9425,-0.03369,0.121145,-0.992063,0
7462,2074,43,259,2005,45,146,12034,1379,13413,-0.00831688,0.101942,-0.994756,0
4232,1597,18,197,1526,58,110,7738,984,8722,-0.0173411,0.106542,-0.994157,0
6298,2474,27,305,2425,74,175,11778,1427,13205,-0.0222509,0.0952929,-0.995201,0
7006,2746,28,329,2671,89,185,13054,1494,14548,-0.0244536,0.0924251,-0.995419,0
6181,2759,27,329,2705,65,187,12253,1095,13348,-0.00624174,0.0748328,-0.997177,0
4203,1934,18,235,1899,110,131,8530,972,9502,-0.0298224,0.0671594,-0.997296,0
6243,3433,34,371,2229,48,153,12511,972,13483,-0.0306339,0.068972,-0.997148,0
5598,1894,22,244,1390,37,99,9284,790,10074,-0.0218627,0.0794592,-0.996598,0
3187,1294,14,163,1253,34,92,6037,778,6815,-0.0241266,0.0680541,-0.99739,0
5902,2272,27,292,2237,60,163,10953,1582,12535,-0.0265144,0.0713279,-0.997101,0
6816,2155,27,280,2153,67,158,11656,1584,13240,-0.0249451,0.0756362,-0.996824,0
4115,1410,19,177,1348,42,99,7210,1169,8379,-0.0160472,0.0532933,-0.99845,0
5789,1872,26,234,1792,75,134,9922,1773,11695,-0.0231885,0.055251,-0.998203,0
6195,1547,27,211,1521,44,120,9665,1669,11334,-0.0283583,0.0414001,-0.99874,0
5659,1324,27,191,1260,49,102,8612,1516,10128,-0.00124745,0.0296237,-0.99956,0
6522,1141,29,169,956,32,62,8911,976,9887,0.00881921,0.0339503,-0.999385,0
5114,879,27,129,1044,72,114,7379,1472,8851,0.00288636,0.0307478,-0.999523,0
5576,878,32,133,823,39,73,7554,1470,9024,-0.0290127,0.0295974,-0.999141,0
5634,846,28,129,788,40,69,7534,1806,9340,-0.0241619,0.010623,-0.999652,0
5480,811,28,125,756,44,67,7311,1661,8972,-0.0551257,0.0191783,-0.998295,0
5644,809,27,124,739,42,66,7451,1959,9410,-0.0210267,-0.0307582,-0.999306,0
5681,811,27,126,740,42,67,7494,2233,9727,-0.0442027,0.0178727,-0.998863,0
5578,823,27,132,766,38,69,7433,3063,10496,-0.0316856,-0.0134654,-0.999407,0
5632,960,25,137,834,42,74,7704,3631,11335,-0.0622135,0.0086128,-0.998026,0
5548,961,25,143,993,47,84,7801,3368,11169,-0.0726503,0.0283403,-0.996955,0
5890,1107,25,165,1009,48,87,8331,3429,11760,-0.0730171,0.0448196,-0.996323,0
3863,786,15,110,719,39,62,5594,2198,7792,-0.138573,0.0655543,-0.98818,0
5736,1334,22,180,1246,58,102,8678,1950,10628,-0.106567,0.0634966,-0.992276,0
6140,1451,23,197,1367,61,110,9349,2847,12196,-0.160155,0.072664,-0.984413,0
5734,1523,24,206,1487,55,117,9146,2044,11190,-0.162467,0.0752123,-0.983843,0
4037,1185,15,151,1110,43,87,6628,1612,8240,-0.206818,0.099828,-0.973273,0
5954,1868,25,239,1746,81,134,10047,2740,12787,-0.234691,0.105393,-0.96634,0
5971,1953,24,248,1621,61,98,9976,1875,11851,-0.221495,0.0994616,-0.970076,0
5465,1925,24,239,1829,58,133,9673,1780,11453,-0.243576,0.130607,-0.961048,0
5374,2079,24,254,2042,58,169,10000,1394,11394,-0.240376,0.149179,-0.959148,0
6178,2610,27,313,2532,71,178,11909,1445,13354,-0.235191,0.143104,-0.961357,0
6105,2784,30,325,2649,91,182,12166,1441,13607,-0.218963,0.121053,-0.968195,0
5532,2362,28,286,2316,51,161,10736,1253,11989,-0.245624,0.0927093,-0.964922,0
5467,2387,26,284,2273,79,175,10691,1310,12001,-0.250432,0.0995693,-0.963001,0
6231,2812,32,362,2722,77,189,12425,1454,13879,-0.286214,0.0663232,-0.955867,0
6493,2870,26,320,2790,50,183,12732,923,13655,-0.25711,0.0508993,-0.965041,0
4577,2108,19,240,2029,34,152,9159,950,10109,-0.25251,0.0256402,-0.967255,0
5858,2948,26,367,2874,48,196,12317,1544,13861,-0.224391,0.0151946,-0.974381,0
5759,2862,26,339,2897,47,195,12125,1340,13465,-0.22341,0.00904507,-0.974683,0
3960,2025,17,274,1982,42,136,8436,1071,9507,-0.209281,0.002888,-0.977851,0
6197,2611,24,317,2507,37,132,11825,1272,13097,-0.175702,0.000341913,-0.984444,0
4225,1906,17,217,1733,33,123,8254,1129,9383,-0.153203,-0.00446773,-0.988185,0
3054,1366,13,174,1152,27,79,5865,907,6772,-0.137893,-0.00324989,-0.990442,0
5490,2563,30,420,2576,100,167,11346,1812,13158,-0.188553,-0.0225738,-0.981804,0
5488,2145,24,218,1500,31,108,9514,1690,11204,-0.179514,-0.0173528,-0.983602,0
2379,822,11,115,801,18,61,4207,815,5022,-0.154695,-0.0214517,-0.98773,0
6024,1828,32,292,1802,51,141,10170,2162,12332,-0.191653,-0.0642063,-0.979361,0
5473,1128,19,152,1066,33,95,7966,1226,9192,-0.200524,-0.079597,-0.97645,0
3074,774,14,107,742,27,59,4797,1249,6046,-0.147535,-0.052509,-0.987662,0
5163,1294,28,176,1233,57,98,8049,1454,9503,-0.119714,-0.0561553,-0.991219,0
5674,1339,26,188,1276,47,106,8656,1534,10190,-0.135051,-0.0698413,-0.988374,0
5715,1224,27,176,1154,44,96,8436,1786,10222,-0.101858,-0.0484616,-0.993618,0
5574,1150,26,164,1066,41,96,8117,1654,9771,-0.0954447,-0.0589692,-0.993687,0
5816,1013,27,152,989,50,85,8132,1680,9812,-0.0836695,-0.0415119,-0.995629,0
5638,957,25,153,878,69,77,7797,2025,9822,-0.0912461,-0.0452389,-0.9948,0
5440,827,26,127,765,51,69,7305,2091,9396,-0.0839613,-0.0446843,-0.995467,0
5401,759,24,119,724,53,69,7149,3410,10559,-0.0519247,-0.0516155,-0.997316,0
5337,666,24,110,634,52,62,6885,2634,9519,-0.0728963,-0.0635837,-0.995311,0
5347,641,25,106,580,73,60,6832,2427,9259,-0.0798975,-0.0872744,-0.992975,0
5348,660,28,109,657,50,62,6914,2759,9673,-0.05639,-0.085098,-0.994776,0
5357,664,25,127,607,50,59,6889,2697,9586,-0.0454151,-0.0995131,-0.993999,0
5747,697,25,116,643,54,61,7343,2456,9799,-0.0290711,-0.129962,-0.991093,0
5611,784,26,124,721,53,66,7385,2232,9617,-0.0708695,-0.188859,-0.979444,0
5217,601,18,93,559,37,56,6581,1564,8145,-0.037388,-0.140428,-0.989385,0
2819,426,11,65,404,21,35,3781,822,4603,-0.0816774,-0.0907647,-0.992517,0
2294,445,11,75,444,19,38,3326,704,4030,-0.0647275,-0.0799657,-0.994694,0
6088,1325,30,225,1219,49,104,9040,1584,10624,-0.0816171,-0.154017,-0.984692,0
5732,1356,25,191,1306,50,107,8767,1651,10418,-0.0655865,-0.0698702,-0.995398,0
6183,1549,27,263,1496,52,121,9691,1493,11184,-0.0795292,-0.159001,-0.98407,0
6617,1604,27,219,1541,83,122,10213,1450,11663,-0.0497057,-0.133178,-0.989845,0
5767,1689,24,226,1622,52,129,9509,1396,10905,-0.0532925,-0.136039,-0.989269,0
4025,1292,17,169,1264,36,96,6899,975,7874,-0.0553892,-0.0950891,-0.993926,0
5881,2639,30,314,1975,85,153,11077,1432,12509,-0.0405659,-0.0885806,-0.995243,0
5895,2066,25,266,1994,67,152,10465,1406,11871,-0.0333697,-0.0919431,-0.995205,0
6590,1884,17,180,1324,54,102,10151,946,11097,-0.0293781,-0.117397,-0.99265,0
5419,1647,22,218,1623,72,126,9127,1250,10377,-0.036951,-0.10282,-0.994013,0
5591,1487,23,201,1450,51,112,8915,1322,10237,-0.0556351,-0.102633,-0.993162,0
5786,1413,27,201,1344,81,108,8960,1558,10518,-0.0437119,-0.0903912,-0.994947,0
5643,1164,27,163,1113,54,103,8267,1439,9706,-0.033223,-0.103984,-0.994024,0
5831,1032,28,148,902,65,78,8084,1420,9504,-0.0180297,-0.0826162,-0.996419,0
5454,782,24,121,736,54,68,7239,1641,8880,-0.0416846,-0.149902,-0.987822,0
5291,634,24,101,579,39,56,6724,1743,8467,-0.0440094,-0.173063,-0.983927,0
3420,282,15,47,254,21,34,4073,1260,5333,-0.052734,-0.0922903,-0.994335,0
2621,263,13,44,238,24,23,3226,942,4168,-0.0468785,-0.0833112,-0.99542,0
6133,537,25,92,488,43,49,7367,2697,10064,-0.0454613,-0.0943563,-0.9945,0
5390,597,23,98,550,46,53,6757,4428,11185,-0.0208499,0.00371687,-0.999776,0
5423,653,21,102,584,42,58,6883,5215,12098,0.0615677,-0.161617,-0.984931,0
5401,683,21,109,646,68,63,6991,5685,12676,-0.00406992,-0.00179006,-0.99999,0
5482,761,21,119,697,42,64,7186,4566,11752,-0.195424,-0.124474,-0.972787,0
3717,515,15,88,518,29,48,4930,3001,7931,-0.0898043,-0.0987335,-0.991053,0
6248,806,43,129,754,38,70,8088,4302,12390,-0.0561281,-0.00374555,-0.998417,0
5485,890,22,135,862,41,80,7515,4614,12129,-0.0878952,-0.162591,-0.982771,0
2937,541,12,81,513,20,45,4149,3110,7259,-0.0537268,-0.27961,-0.95861,0
5139,1081,20,176,1389,38,94,7937,3833,11770,0.0595158,0.178271,-0.98218,0
5672,1494,24,201,1401,43,113,8948,3548,12496,-0.043595,-0.337665,-0.940256,0
5220,1449,24,201,1405,51,111,8461,4138,12599,0.0142687,-0.204761,-0.978708,0
5766,1719,26,235,1686,59,135,9626,5082,14708,0.0128017,-0.358627,-0.933393,0
4006,1176,18,154,1195,33,90,6672,3878,10550,0.0251276,-0.309339,-0.95062,0
5764,1508,28,212,1424,51,115,9102,5416,14518,0.00903716,-0.301945,-0.953283,0
5769,1309,27,186,1240,43,114,8688,4507,13195,-0.0310848,-0.29841,-0.953932,0
2763,530,16,124,736,32,65,4266,5146,9412,0.0445866,-0.40689,-0.912388,0
5668,945,28,143,883,50,80,7797,8008,15805,0.0791162,-0.567128,-0.819821,0
4981,720,21,111,671,37,60,6601,-1000,-1000,-1,-1,-1,0
2206,291,10,45,266,18,24,2860,4031,6891,-0.125006,-0.343395,-0.930835,0
5028,580,22,94,522,41,49,6336,12054,18390,-0.0306473,-0.378383,-0.925142,0
3455,391,14,63,460,45,54,4482,10196,14678,-0.0511677,-0.241845,-0.968965,0
5318,546,24,91,494,44,65,6582,8378,14960,-0.0692098,-0.332557,-0.94054,0
3641,397,17,61,323,29,33,4501,6384,10885,-0.0417537,-0.462565,-0.885602,0
5533,467,24,81,441,37,44,6627,6149,12776,-0.0102376,-0.44907,-0.893438,0
4663,453,22,75,394,36,41,5684,3453,9137,-0.0314133,-0.283055,-0.958589,0
5275,520,24,88,467,44,47,6465,5227,11692,-0.017719,-0.222026,-0.97488,0
5282,570,24,97,514,39,52,6578,7521,14099,0.0103292,-0.229561,-0.973239,0
4783,595,27,97,535,35,51,6123,4005,10128,0.0753242,-0.228091,-0.970722,0
5573,724,25,115,668,40,74,7219,4454,11673,0.0650222,-0.248936,-0.966335,0
5575,801,25,130,750,41,69,7391,3388,10779,0.0235892,-0.227837,-0.973413,0
5567,908,25,137,824,57,75,7593,2562,10155,0.031573,-0.202217,-0.978832,0
5604,1010,26,155,912,43,82,7832,2856,10688,-0.000161883,-0.193557,-0.981089,0
5558,1105,26,164,1064,44,93,8054,2224,10278,-0.00893158,-0.172911,-0.984897,0
6009,1225,28,180,1194,41,102,8779,1819,10598,-0.0143656,-0.168855,-0.985536,0
5789,1422,25,181,1343,41,123,8924,1582,10506,-0.0299292,-0.138249,-0.989945,0
6130,1543,26,217,1506,42,122,9586,1639,11225,-0.0307905,-0.174024,-0.98426,0
5817,1681,24,230,1634,44,141,9571,1714,11285,-0.0179963,-0.16805,-0.985614,0
6567,1890,26,253,1875,45,143,10799,1439,12238,0.0118652,-0.19569,-0.980594,0
5382,1970,30,258,1919,40,138,9737,1353,11090,0.0163028,-0.176272,-0.984206,0
5871,2157,24,272,2093,73,154,10644,1857,12501,0.0251834,-0.203963,-0.978655,0
5904,2064,26,272,2047,49,155,10517,3175,13692,0.0186069,-0.172895,-0.984765,0
5773,1992,26,264,1979,57,152,10243,1529,11772,0.00877464,-0.120223,-0.992708,0
5880,1938,37,250,1829,75,141,10150,1413,11563,0.0284905,-0.225924,-0.973728,0
5521,1159,21,174,1095,34,88,8092,982,9074,0.0201798,-0.176749,-0.984049,0
2438,559,9,66,443,17,36,3568,514,4082,0.00978147,-0.0778768,-0.996915,0
2132,366,11,55,340,27,30,2961,656,3617,-0.00149044,-0.0471077,-0.998889,0
5397,729,26,116,672,62,63,7065,1515,8580,-0.0199303,-0.0576235,-0.99814,0
5303,571,27,96,523,51,52,6623,1715,8338,-0.0210444,0.00749354,-0.999751,0
5479,519,27,94,458,46,47,6670,1941,8611,-0.0145505,-0.117703,-0.992942,0
6189,503,26,90,454,43,46,7351,2706,10057,0.0113223,-0.135872,-0.990661,0
5397,565,25,95,495,41,50,6668,4213,10881,0.00460332,-0.113621,-0.993514,0
4067,495,15,69,397,29,39,5111,4373,9484,0.0817983,-0.174548,-0.981245,0
4765,591,20,90,509,35,49,6059,5633,11692,-0.0160478,-0.0275835,-0.999491,0
5461,632,22,106,614,40,60,6935,4220,11155,-0.0337318,-0.0424311,-0.99853,0
5834,824,36,258,700,41,67,7760,3521,11281,-0.0621291,-0.262607,-0.962901,0
5806,754,22,120,742,41,70,7555,2019,9574,-0.0762081,-0.195,-0.977838,0
2353,338,10,54,319,14,29,3117,1198,4315,-0.0565384,-0.0870151,-0.994601,0
2310,383,10,59,365,16,32,3175,1066,4241,-0.0856682,-0.132224,-0.987511,0
5808,1095,24,165,1057,39,91,8279,2509,10788,-0.0469745,-0.0565858,-0.997292,0
5601,1418,25,190,1254,34,103,8625,2457,11082,-0.151881,-0.164075,-0.974686,0
5689,1448,26,204,1051,30,79,8527,1556,10083,-0.0431083,-0.200906,-0.978662,0
5820,1612,27,226,1578,39,126,9428,2317,11745,-0.0971472,-0.281391,-0.954663,0
5792,1888,27,238,1820,64,136,9965,2616,12581,-0.0557062,-0.229666,-0.971674,0
5306,1676,27,216,1614,41,137,9017,2852,11869,-0.090594,-0.243496,-0.965662,0
5716,1718,29,225,1623,54,125,9490,2033,11523,-0.137611,-0.229964,-0.963421,0
5900,1607,29,217,1519,70,124,9466,2251,11717,-0.033829,-0.197429,-0.979733,0
3954,997,20,137,1015,31,83,6237,1411,7648,-0.0442381,-0.152632,-0.987292,0
5652,1243,30,172,1107,49,93,8346,3875,12221,-0.00749738,-0.181837,-0.9833,0
5543,1060,28,154,990,41,83,7899,3228,11127,-0.0333309,-0.148065,-0.988416,0
5594,964,27,165,933,39,83,7805,5445,13250,0.002547,-0.317264,-0.948334,0
5308,794,38,122,744,44,75,7125,6229,13354,-0.0418052,-0.208912,-0.97704,0
5646,644,23,102,583,36,54,7088,5841,12929,-0.0445972,-0.239898,-0.969773,0
4752,580,22,92,532,37,50,6065,7778,13843,-0.0735342,-0.127408,-0.989121,0
4360,542,19,81,452,31,44,5529,9739,15268,0.0152331,-0.347,-0.937741,0
3985,437,18,73,393,35,39,4980,12513,17493,-0.0898403,-0.0959497,-0.991323,0
2933,302,14,53,277,27,28,3634,11385,15019,-0.0651837,-0.209641,-0.975603,0
2921,297,14,52,269,24,27,3604,4330,7934,-0.0164575,-0.263903,-0.964409,0
5161,540,24,90,482,54,57,6408,12306,18714,-0.019946,-0.212537,-0.976949,0
3642,346,16,60,316,28,31,4439,12940,17379,-0.0164349,-0.187264,-0.982172,0
2245,209,10,35,185,17,19,2720,-1000,-1000,-1,-1,-1,0
3183,328,14,57,306,39,32,3959,7130,11089,0.0765135,-0.186944,-0.979386,0
5557,667,27,105,557,36,54,7003,6278,13281,0.00940287,-0.186205,-0.982466,0
6095,681,26,116,622,40,60,7640,4814,12454,0.0520272,-0.183121,-0.981713,0
3830,553,19,84,500,29,47,5062,2137,7199,0.0205386,-0.195862,-0.980416,0
5686,855,28,133,772,41,71,7586,1882,9468,0.0626521,-0.183718,-0.98098,0
6316,927,26,157,852,48,80,8406,2053,10459,0.0383771,-0.209057,-0.97715,0
3875,631,13,79,487,23,43,5151,869,6020,-0.014468,-0.108109,-0.994034,0
2432,459,12,68,462,18,37,3488,805,4293,-0.00761833,-0.135352,-0.990768,0
5701,1158,43,167,1062,34,92,8257,1758,10015,-0.00252102,-0.141306,-0.989963,0
5783,1219,26,178,1220,38,100,8564,1329,9893,0.00018615,-0.177754,-0.984075,0
3947,940,18,133,930,27,77,6072,1112,7184,0.00241197,-0.166762,-0.985994,0
6000,1535,26,227,1476,41,120,9425,1698,11123,0.00189469,-0.164907,-0.986307,0
5667,1630,30,299,1940,45,132,9743,1361,11104,-0.02059,-0.142385,-0.989598,0
5310,1585,26,247,1564,40,124,8896,1401,10297,0.00451821,-0.166947,-0.985955,0
5913,2040,27,266,1886,54,156,10342,1550,11892,-0.00952992,-0.157341,-0.987498,0
4214,1573,19,193,1543,33,111,7686,1143,8829,-0.0107387,-0.101321,-0.994796,0
6103,2240,27,288,2198,79,177,11112,1535,12647,-0.00448992,-0.155856,-0.98777,0
5960,2249,29,292,2273,68,169,11040,1678,12718,-0.007079,-0.222406,-0.974929,0
5646,1417,17,183,1383,31,105,8782,1132,9914,-0.00769471,-0.172589,-0.984964,0
2627,842,10,111,835,22,67,4514,564,5078,-0.00795271,-0.0834644,-0.996479,0
5565,1707,22,223,1657,58,126,9358,1303,10661,0.0144687,-0.113078,-0.993481,0
5974,1714,26,230,1662,50,130,9786,1471,11257,0.0132788,-0.103777,-0.994512,0
5746,1431,27,200,1425,55,116,9000,1571,10571,-0.00812872,-0.0892451,-0.995977,0
5685,1180,27,176,1159,47,99,8373,1648,10021,-0.0130144,-0.0630766,-0.997924,0
5738,1047,28,152,1000,72,90,8127,1417,9544,-0.00392356,-0.0708124,-0.997482,0
5939,760,25,123,775,51,73,7746,1423,9169,0.00836209,-0.0566526,-0.998359,0
5427,560,24,98,515,45,53,6722,1406,8128,0.0177637,-0.0623047,-0.997899,0
5490,533,28,90,420,43,45,6649,1435,8084,0.00384147,-0.115445,-0.993306,0
5215,411,26,75,363,40,52,6182,1550,7732,-0.0103844,-0.0745837,-0.997161,0
5447,457,24,95,384,42,42,6491,1918,8409,-0.00558095,-0.113511,-0.993521,0
5379,469,25,84,439,41,45,6482,2640,9122,0.00981637,-0.0629111,-0.997971,0
4179,370,17,64,326,28,40,5024,3340,8364,0.0146918,-0.0622587,-0.997952,0
5473,489,21,87,449,35,45,6599,5113,11712,0.0110407,-0.0590804,-0.998192,0
4930,594,21,97,564,37,53,6296,6960,13256,-0.0109404,-0.0665749,-0.997722,0
4849,546,21,92,537,36,53,6134,3314,9448,0.00848822,-0.0841669,-0.996416,0
4840,582,19,96,632,54,79,6302,2583,8885,0.0112298,-0.140191,-0.990061,0
5443,613,20,119,580,34,56,6865,2189,9054,0.00405495,-0.142484,-0.989789,0
5121,1005,27,172,1028,67,95,7515,2812,10327,-0.020434,-0.168845,-0.985431,0
3523,621,15,91,574,27,50,4901,1720,6621,-0.0310663,-0.161913,-0.986316,0
5659,1143,23,170,1125,36,97,8253,2394,10647,-0.0324713,-0.13382,-0.990473,0
6429,1444,23,199,1353,37,112,9597,2243,11840,-0.0618141,-0.179267,-0.981857,0
5706,1660,25,222,1656,50,162,9481,2378,11859,-0.0176381,-0.266707,-0.963616,0
6087,1852,27,248,1777,39,140,10170,2709,12879,-0.0211909,-0.236882,-0.971307,0
5785,1921,27,247,2228,55,146,10409,3661,14070,-0.0608816,-0.354222,-0.933178,0
4167,1205,19,160,1197,27,89,6864,1633,8497,-0.0874545,-0.262472,-0.960968,0
6242,1496,29,210,1470,44,117,9608,2146,11754,-0.0942728,-0.282406,-0.954652,0
5726,1314,29,184,1294,55,104,8706,1786,10492,-0.0883145,-0.248247,-0.964662,0
5606,1126,29,170,1069,43,89,8132,1902,10034,0.0620831,-0.236053,-0.969755,0
5595,924,28,140,874,54,77,7692,2251,9943,0.063327,-0.217467,-0.974011,0
5542,887,27,139,834,48,75,7552,3730,11282,-0.0207323,-0.150846,-0.988339,0
5470,822,46,129,770,43,69,7349,3016,10365,-0.0524702,-0.107896,-0.992777,0
5339,803,26,124,745,47,70,7154,3535,10689,-0.0919176,-0.118373,-0.988706,0
5519,765,25,118,711,40,64,7242,4109,11351,-0.0365224,-0.0978259,-0.994533,0
5455,732,24,126,681,54,85,7157,5209,12366,0.0388243,-0.145302,-0.988626,0
5333,711,25,111,661,43,60,6944,4749,11693,-0.108072,-0.0741422,-0.991374,0
5479,759,23,117,653,48,61,7140,6321,13461,0.0467899,-0.144056,-0.988463,0
5397,694,24,164,641,51,64,7035,5686,12721,0.0268849,-0.118457,-0.992595,0
4854,626,20,99,611,48,59,6317,10042,16359,-0.101335,-0.0670576,-0.99259,0
2696,345,12,54,321,26,29,3483,2613,6096,0.00193015,-0.111847,-0.993724,0
5464,701,23,109,663,41,64,7065,7578,14643,0.0395561,-0.176566,-0.983494,0
5544,638,23,108,599,41,57,7010,6124,13134,0.0606887,-0.218939,-0.97385,0
5368,615,23,99,597,42,60,6804,5238,12042,0.0362291,-0.159794,-0.986485,0
5336,565,24,95,547,55,57,6679,5197,11876,-0.00505618,-0.193277,-0.981131,0
5298,558,23,93,487,46,49,6554,5679,12233,-0.0208479,-0.115578,-0.993079,0
5291,545,22,91,473,44,48,6514,5798,12312,0.00565358,-0.17876,-0.983876,0
4754,543,20,90,476,40,54,5977,3478,9455,-0.0152732,-0.159116,-0.987142,0
5287,650,23,105,595,48,57,6765,3830,10595,0.00705729,-0.219375,-0.975615,0
5491,695,23,116,687,44,67,7123,3292,10415,0.00522837,-0.169834,-0.985459,0
5609,764,24,123,758,47,72,7397,2833,10230,0.0154365,-0.10816,-0.994014,0
5899,852,24,141,785,48,71,7820,2007,9827,0.0149133,-0.144664,-0.989369,0
5573,877,24,137,856,50,89,7606,1385,8991,0.0113386,-0.171786,-0.985069,0
5025,953,22,138,849,45,75,7107,1510,8617,-0.000376312,-0.135068,-0.990836,0
5642,1211,25,170,1123,39,95,8305,1508,9813,-0.00279841,-0.131237,-0.991347,0
6307,1309,25,192,1295,53,108,9289,1415,10704,0.0170512,-0.164378,-0.98625,0
5696,1469,51,204,1433,40,118,9011,1419,10430,-0.000246351,-0.139502,-0.990222,0
5665,1423,22,196,1446,39,112,8903,1318,10221,0.00125152,-0.138938,-0.9903,0
5359,1547,22,208,1547,48,145,8876,1317,10193,0.0170341,-0.15608,-0.987597,0
5351,1647,24,224,1614,53,126,9039,1345,10384,0.0119427,-0.137375,-0.990447,0
6021,2040,26,267,1893,44,146,10437,1498,11935,0.0233605,-0.127369,-0.99158,0
6008,2151,26,296,2389,77,202,11149,1670,12819,0.0270986,-0.13217,-0.990856,0
4223,1638,19,197,1621,39,141,7878,970,8848,0.0077526,-0.098121,-0.995144,0
6800,2417,27,302,2356,55,172,12129,1407,13536,0.0169446,-0.120979,-0.992511,0
6160,2290,25,368,2294,80,118,11335,956,12291,0.0169083,-0.117687,-0.992907,0
3299,1323,17,196,1415,39,94,6383,768,7151,0.00134431,-0.0887629,-0.996052,0
5957,2044,25,267,1985,56,155,10489,1587,12076,-0.00611898,-0.0957341,-0.995388,0
6034,1924,26,247,1905,59,146,10341,1150,11491,0.000942678,-0.105547,-0.994414,0
4050,1160,19,157,1150,38,92,6666,1234,7900,0.00912608,-0.0781435,-0.9969,0
6240,1509,25,206,1507,53,118,9658,1833,11491,0.031864,-0.0810748,-0.996199,0
6622,1316,28,184,1233,70,100,9553,1718,11271,0.0256281,-0.0635923,-0.997647,0
5561,1150,26,174,1100,63,91,8165,1589,9754,0.0212206,-0.055675,-0.998224,0
5569,945,26,144,899,83,78,7744,1435,9179,0.0442044,-0.0965697,-0.994344,0
4434,560,18,84,511,46,46,5699,983,6682,0.0212159,-0.0594824,-0.998004,0
3086,336,14,55,305,34,41,3871,728,4599,0.0199832,-0.0128112,-0.999718,0
5353,551,26,90,478,61,48,6607,1395,8002,0.0180186,-0.0241567,-0.999546,0
5286,466,28,80,402,52,42,6356,1482,7838,0.0139412,0.00234794,-0.9999,0
5606,477,33,91,424,54,47,6732,1640,8372,-0.0107256,0.0250938,-0.999628,0
5363,473,24,81,409,49,43,6442,2238,8680,-0.0711697,-0.0570941,-0.995829,0
5455,488,24,87,441,49,57,6601,3421,10022,-0.010386,-0.0911932,-0.995779,0
5470,569,44,111,547,50,55,6846,3189,10035,-0.0144169,-0.101628,-0.994718,0
5456,578,22,99,613,44,59,6871,5482,12353,-0.103506,-0.107384,-0.988815,0
3705,468,15,72,406,29,39,4734,3238,7972,-0.0275324,-0.118982,-0.992514,0
5467,677,21,109,636,40,60,7010,3918,10928,-0.161973,-0.143863,-0.976252,0
5383,706,23,114,692,40,66,7024,3149,10173,-0.156437,-0.166902,-0.973484,0
4085,575,15,103,556,21,49,5404,2065,7469,-0.0565652,-0.107196,-0.992628,0
5544,944,27,154,918,31,82,7700,2483,10183,-0.0902556,-0.160716,-0.982865,0
5870,1159,24,168,1067,30,91,8409,2753,11162,-0.0523144,-0.187221,-0.980924,0
5739,1359,24,190,1331,30,108,8781,2635,11416,-0.168861,-0.309783,-0.935693,0
4274,1072,18,152,1133,27,87,6763,1856,8619,-0.133103,-0.348451,-0.927828,0
5300,1665,24,219,1647,40,128,9023,2867,11890,-0.0242383,-0.356574,-0.933953,0
5337,1833,25,231,1694,48,133,9301,2872,12173,-0.0445457,-0.315304,-0.947944,0
3784,1253,17,158,1214,36,90,6552,2096,8648,-0.0837412,-0.301012,-0.949937,0
5841,1711,29,218,1603,56,124,9582,3242,12824,0.0383422,-0.298384,-0.953676,0
5114,1329,26,184,1291,42,105,8091,1472,9563,0.0362987,-0.287743,-0.957019,0
5756,1378,29,192,1333,55,107,8850,1385,10235,0.0318752,-0.245076,-0.96898,0
5547,1114,28,161,1032,40,87,8009,1492,9501,0.0166771,-0.221414,-0.975037,0
5954,867,27,167,813,47,76,7951,2679,10630,0.0339538,-0.236003,-0.971159,0
5471,714,27,135,659,51,63,7120,3286,10406,-0.0537125,-0.185908,-0.981098,0
3718,425,17,71,392,27,37,4687,2672,7359,0.0142052,-0.165573,-0.986095,0
5372,584,26,97,532,47,52,6710,8020,14730,-0.00455546,-0.134226,-0.99094,0
5387,548,49,94,518,52,50,6698,8973,15671,0.017906,-0.313564,-0.949399,0
2787,294,13,48,273,30,27,3472,10699,14171,-0.00236796,-0.284021,-0.958816,0
5575,508,25,91,484,58,49,6790,10291,17081,-0.0288317,-0.266537,-0.963394,0
5398,483,23,88,440,58,54,6544,6271,12815,-0.0554136,-0.338451,-0.939351,0
5430,478,23,84,433,47,49,6544,5688,12232,-0.212709,-0.299445,-0.930101,0
2529,195,10,34,177,21,18,2984,3509,6493,-0.0715776,-0.145423,-0.986777,0
1597,150,7,25,135,13,13,1940,1383,3323,-0.0809061,-0.166016,-0.982799,0
5259,534,23,90,488,43,49,6486,5254,11740,-0.162222,-0.244347,-0.956023,0
5375,624,23,103,606,33,57,6821,6133,12954,-0.0699602,-0.2135,-0.974435,0
5911,695,24,122,673,33,70,7528,2457,9985,-0.058302,-0.246178,-0.96747,0
5359,521,16,81,485,23,43,6528,2670,9198,-0.055834,-0.226403,-0.972432,0
2884,433,13,66,425,17,38,3876,1594,5470,-0.118315,-0.229326,-0.966132,0
6156,968,24,139,882,48,79,8296,3156,11452,-0.115224,-0.206054,-0.971733,0
5630,1008,24,148,981,50,86,7927,2126,10053,-0.10841,-0.183534,-0.977018,0
5512,1170,25,167,1090,46,93,8103,1208,9311,-0.0797843,-0.176772,-0.981013,0
4437,1264,23,194,1227,30,73,7248,1038,8286,-0.0336583,-0.12945,-0.991015,0
6240,1484,26,201,1411,37,115,9514,1410,10924,-0.0390667,-0.13393,-0.99022,0
5937,1667,27,219,1537,39,127,9553,1077,10630,-0.0417534,-0.152549,-0.987414,0
5549,1928,24,210,1506,40,131,9388,1270,10658,-0.0439579,-0.166247,-0.985104,0
5957,1920,26,248,1936,70,145,10302,1439,11741,-0.0541643,-0.147473,-0.987582,0
6346,2051,26,266,2029,44,107,10869,980,11849,-0.0437406,-0.147513,-0.988092,0
4305,1437,18,210,1412,33,109,7524,1065,8589,-0.0246171,-0.130663,-0.991121,0
6228,2266,26,282,2274,106,163,11345,1430,12775,-0.0096049,-0.143069,-0.989666,0
6182,2287,25,280,2028,64,116,10982,969,11951,0.00529655,-0.129463,-0.99157,0
4228,1554,17,190,1497,49,121,7656,991,8647,0.00423423,-0.105496,-0.99441,0
6119,2092,28,267,2083,87,153,10829,1494,12323,0.00814402,-0.124199,-0.992224,0
5983,2046,27,262,1996,88,151,10553,1605,12158,0.0110535,-0.109347,-0.993942,0
5965,1837,27,241,1803,66,139,10078,1608,11686,0.0117,-0.103006,-0.994612,0
5378,1452,24,206,1493,59,114,8726,1567,10293,0.00276007,-0.101694,-0.994812,0
5693,1323,25,185,1252,87,102,8667,1659,10326,0.00690199,-0.0865476,-0.996224,0
5513,1149,26,161,993,86,108,8036,1534,9570,-0.0130518,-0.0577738,-0.998245,0
5606,856,27,133,812,50,72,7556,1567,9123,-0.0312473,-0.0567494,-0.9979,0
5571,735,26,119,666,42,63,7222,1482,8704,-0.0314782,-0.144621,-0.988987,0
5345,603,25,99,572,49,72,6765,1539,8304,-0.0273721,-0.0948496,-0.995116,0
2765,275,14,47,260,27,26,3414,769,4183,-0.0243474,-0.0518463,-0.998358,0
2224,207,11,34,184,29,27,2716,633,3349,-0.0230421,-0.000421964,-0.999735,0
5384,519,26,87,508,44,51,6619,1596,8215,-0.0202884,-0.0153266,-0.999677,0
5523,589,25,99,550,40,54,6880,1920,8800,-0.00677428,-0.0161018,-0.999847,0
5480,647,25,117,584,66,59,6978,2871,9849,-0.0120234,-0.0781153,-0.996872,0
5393,708,26,109,622,52,61,6971,3843,10814,-0.0861906,-0.126097,-0.988267,0
5043,711,20,103,590,47,55,6569,5635,12204,-0.0360379,-0.140954,-0.98936,0
5051,700,20,107,654,71,60,6663,2599,9262,-0.0224307,-0.130263,-0.991226,0
5659,869,23,174,870,47,77,7719,3041,10760,-0.0217799,-0.0666786,-0.997537,0
6543,979,22,168,985,46,84,8827,6307,15134,-0.0311789,-0.0879954,-0.995633,0
3928,721,16,141,794,34,63,5697,4669,10366,-0.0156043,-0.147971,-0.988869,0
5902,1196,23,210,1148,42,102,8623,5729,14352,-0.00229032,-0.164275,-0.986412,0
3887,945,15,128,949,28,73,6025,3164,9189,-0.00611216,-0.206587,-0.978409,0
5695,1602,25,232,1578,44,124,9300,7883,17183,-0.0253152,-0.292951,-0.955792,0
3934,1217,17,156,1212,32,93,6661,3077,9738,-0.0141873,-0.235638,-0.971737,0
4053,1281,18,168,1248,27,95,6890,2477,9367,-0.0193541,-0.260354,-0.965319,0
5937,1993,28,256,2043,49,152,10458,1822,12280,-0.0142123,-0.251767,-0.967684,0
5818,2049,26,264,2024,40,167,10388,1648,12036,-0.00354709,-0.307147,-0.951655,0
4089,1361,21,169,1419,31,97,7187,982,8169,-0.000731465,-0.300015,-0.953934,0
5918,1650,28,216,1608,58,125,9603,1419,11022,0.0145797,-0.308492,-0.951115,0
5869,1377,29,192,1355,75,140,9037,1518,10555,-0.000719875,-0.260282,-0.965532,0
5778,1256,27,171,1215,65,95,8607,1531,10138,0.00134955,-0.28449,-0.958678,0
6141,1382,29,156,1002,60,85,8855,1488,10343,0.011545,-0.287384,-0.957746,0
5519,978,26,140,926,75,105,7769,2297,10066,0.0235326,-0.2957,-0.954991,0
5002,758,22,116,719,38,63,6718,2462,9180,0.0148314,-0.254764,-0.96689,0
4912,692,22,106,646,42,59,6479,3052,9531,0.0198751,-0.276466,-0.960818,0
5388,720,23,114,669,56,63,7033,4264,11297,0.0438809,-0.391075,-0.919312,0
5014,477,16,75,437,41,41,6101,2489,8590,0.0267034,-0.289459,-0.956818,0
2757,329,13,59,292,32,29,3511,2500,6011,0.0254063,-0.229082,-0.973075,0
2909,309,13,50,284,30,28,3623,3048,6671,0.0222559,-0.259145,-0.965582,0
5179,500,24,86,465,50,48,6352,5020,11372,-0.127351,-0.208388,-0.96972,0
5245,489,23,84,445,49,46,6381,3395,9776,-0.113643,-0.247755,-0.962134,0
5225,541,23,90,499,35,48,6461,2277,8738,-0.0880462,-0.314051,-0.945315,0
5307,701,24,109,606,71,66,6884,2339,9223,-0.0793391,-0.252394,-0.964366,0
2548,322,11,50,300,19,27,3277,893,4170,-0.0720855,-0.193349,-0.978478,0
2230,344,10,52,320,19,28,3003,948,3951,-0.0748025,-0.194949,-0.977957,0
5636,980,26,149,924,50,81,7846,1864,9710,-0.0671779,-0.165347,-0.983945,0
5608,1146,26,169,1092,46,92,8179,1722,9901,-0.0772528,-0.173704,-0.981763,0
5661,1411,25,198,1378,42,111,8826,1471,10297,-0.0384222,-0.132181,-0.990481,0
5865,1580,25,215,1501,41,120,9347,1453,10800,-0.0604466,-0.131804,-0.989431,0
5895,1776,27,234,1665,40,130,9767,1442,11209,-0.0322137,-0.212954,-0.976531,0
5898,1858,25,241,1813,40,137,10012,1413,11425,-0.0201299,-0.192901,-0.981012,0
5923,2001,25,269,1932,44,147,10341,1505,11846,-0.0307994,-0.184992,-0.982257,0
9166,2939,28,311,2132,71,157,14804,1480,16284,-0.0229586,-0.248259,-0.968422,0
3196,1219,13,163,930,30,68,5619,621,6240,-0.0153828,-0.189261,-0.981807,0
2170,821,9,104,816,28,60,4008,532,4540,-0.0233188,-0.141889,-0.989608,0
5774,2246,24,265,2226,51,156,10742,1358,12100,-0.0117143,-0.153168,-0.988131,0
6269,2155,38,265,2114,71,170,11082,1316,12398,-0.00133583,-0.143139,-0.989702,0
5543,2012,23,250,1963,93,141,10025,1268,11293,-0.00929849,-0.123426,-0.99231,0
6156,2098,25,271,2127,96,155,10928,1452,12380,-0.0119968,-0.112231,-0.99361,0
6230,1955,25,250,2198,98,188,10944,1657,12601,0.00185481,-0.12449,-0.992219,0
4448,1271,17,157,1172,47,88,7200,1058,8258,4.4189e-05,-0.10099,-0.994888,0
5855,1705,27,239,1600,73,119,9618,1627,11245,-0.00748428,-0.120764,-0.992653,0
5872,1523,26,205,1455,54,110,9245,1623,10868,-0.0251088,-0.0961347,-0.995052,0
5222,1211,24,161,1264,60,94,8036,1450,9486,-0.0234875,-0.0804323,-0.996483,0
5872,1177,28,169,1128,60,91,8525,1805,10330,-0.00546717,-0.0705268,-0.997495,0
5643,1272,28,173,1154,46,93,8409,1244,9653,-0.00651076,-0.0502682,-0.998715,0
3825,794,19,112,752,40,62,5604,1013,6617,-0.00904587,-0.0439628,-0.998992,0
5653,1166,28,160,1036,56,87,8186,1629,9815,-0.0314782,-0.0856481,-0.995828,0
5522,1044,27,160,906,51,75,7785,1342,9127,-0.0285091,-0.0886891,-0.995651,0
5009,946,24,137,963,48,78,7205,1603,8808,-0.020457,-0.1255,-0.991883,0
5055,1032,24,142,944,37,80,7314,1307,8621,-0.00916858,-0.129911,-0.991483,0
5589,1212,26,168,1149,47,96,8287,1966,10253,0.00920774,-0.135652,-0.990714,0
5649,1216,24,173,1163,40,96,8361,1807,10168,-0.00675929,-0.165447,-0.986196,0
5522,1272,22,173,1199,47,96,8331,1735,10066,-0.0468084,-0.153553,-0.987031,0
6222,1244,23,169,1172,36,96,8962,1700,10662,-0.0483462,-0.149131,-0.987635,0
5599,1173,21,172,1054,39,94,8152,2240,10392,-0.0176979,-0.182705,-0.983009,0
4509,900,17,126,889,29,84,6554,1464,8018,-0.0457229,-0.194661,-0.979804,0
4488,946,18,130,918,30,74,6604,2256,8860,-0.0248595,-0.16954,-0.98521,0
5531,1254,20,154,1196,50,101,8306,3222,11528,-0.0407765,-0.209882,-0.976876,0
5918,1346,23,186,1322,51,106,8952,3799,12751,-0.0219022,-0.190729,-0.981399,0
4054,1045,16,139,985,37,78,6354,2729,9083,-0.027622,-0.156864,-0.987234,0
5298,1442,21,194,1413,48,126,8542,2350,10892,-0.0328857,-0.158675,-0.986783,0
5335,1586,22,202,1490,47,118,8800,2237,11037,-0.00589134,-0.122462,-0.992456,0
6185,1833,26,257,1764,45,139,10249,2114,12363,0.00520376,-0.148633,-0.988879,0
4067,1271,17,181,1240,31,95,6902,1180,8082,0.00985067,-0.143742,-0.989566,0
5853,1919,25,243,1771,45,135,9991,2171,12162,0.00159589,-0.229089,-0.973404,0
4119,1223,15,129,981,32,73,6572,903,7475,0.00806412,-0.187201,-0.982288,0
2088,731,10,106,691,22,52,3700,783,4483,0.00955937,-0.141005,-0.989963,0
2268,787,11,101,755,22,57,4001,914,4915,0.0121018,-0.116798,-0.993082,0
5341,1820,25,236,1779,53,138,9392,2066,11458,0.00136161,-0.134104,-0.990967,0
5546,1863,25,240,1824,76,138,9712,1822,11534,0.00277357,-0.142877,-0.989737,0
5597,1841,28,304,1827,46,138,9781,1294,11075,0.0106195,-0.132696,-0.9911,0
6171,2031,28,258,1938,54,144,10624,1443,12067,0.0188615,-0.152556,-0.988115,0
8272,1475,22,232,1299,37,97,11434,728,12162,0.0175982,-0.139595,-0.990052,0
2652,836,13,104,763,25,61,4454,576,5030,0.0126077,-0.0993073,-0.994977,0
2235,752,11,94,726,24,53,3895,542,4437,-0.00155797,-0.0953359,-0.995444,0
5293,1697,27,213,1620,55,121,9026,1336,10362,-0.00952181,-0.0960469,-0.995331,0
5207,1659,26,212,1616,56,121,8897,1231,10128,-0.0108163,-0.079499,-0.996776,0
5926,1896,28,236,1849,66,121,10122,1255,11377,-0.0120091,-0.0748094,-0.997125,0
6141,1682,27,210,1578,52,143,9833,1376,11209,-0.0102028,-0.0597616,-0.998161,0
5346,1635,26,205,1671,64,140,9087,1418,10505,0.0102845,-0.0512586,-0.998633,0
5113,1566,27,201,1529,43,112,8591,1297,9888,0.0165495,-0.0447638,-0.99886,0
5887,2133,32,229,1681,51,126,10139,1353,11492,0.0102082,-0.0439095,-0.998984,0
5233,1610,28,236,1484,46,114,8751,1351,10102,0.0222399,-0.0374731,-0.99905,0
5751,1566,26,205,1519,52,113,9232,1269,10501,0.021988,-0.046424,-0.99868,0
5427,1534,26,195,1480,47,109,8818,1304,10122,0.0190062,-0.0405444,-0.998997,0
5593,1724,50,223,1622,49,111,9372,1555,10927,0.00972739,-0.0575631,-0.998294,0
5789,1930,30,224,1647,52,124,9796,1447,11243,0.00300632,-0.05253,-0.998615,0
5662,1701,28,219,1747,58,128,9543,1516,11059,0.0100746,-0.050162,-0.99869,0
4479,1158,21,154,1111,37,84,7044,1039,8083,-0.00197984,-0.0610968,-0.99813,0
5624,1686,30,221,1603,55,130,9349,1495,10844,0.00412156,-0.0586261,-0.998272,0
5670,1574,29,212,1590,62,153,9290,1431,10721,0.0086145,-0.0549967,-0.99845,0
5427,1438,28,205,1351,58,104,8611,1246,9857,0.00983376,-0.0515622,-0.998622,0
4981,1435,27,189,1352,65,104,8153,1276,9429,0.00871468,-0.0467162,-0.99887,0
5677,1562,29,208,1486,51,114,9127,1459,10586,0.00139606,-0.0399307,-0.999201,0
5528,1559,30,208,1483,51,115,8974,1489,10463,-0.00124623,-0.0378848,-0.999281,0
5544,1591,29,207,1488,64,115,9038,1405,10443,-0.00370697,-0.0291285,-0.999569,0
5530,1560,30,209,1518,47,117,9011,1403,10414,-0.00451973,-0.0274047,-0.999614,0
5544,1599,28,208,1484,60,126,9049,1503,10552,-0.00717811,-0.0242073,-0.999681,0
5621,1637,29,213,1536,57,119,9212,1605,10817,0.0072964,-0.0284614,-0.999568,0
5549,1631,28,227,1527,49,119,9130,1483,10613,0.00107252,-0.0318383,-0.999492,0
5617,1611,34,232,1577,65,121,9257,1417,10674,0.00048901,-0.0399188,-0.999203,0
5692,1656,37,216,1619,52,122,9394,1423,10817,-0.000853083,-0.038065,-0.999275,0
5640,1648,29,227,1545,70,118,9277,1475,10752,-0.0115183,-0.0342336,-0.999348,0
5727,1630,32,215,1565,56,122,9347,1399,10746,0.00408096,-0.0390224,-0.99923,0
5653,1635,29,216,1570,56,120,9279,1459,10738,-0.00994723,-0.0290023,-0.99953,0
5739,1624,40,214,1626,56,123,9422,1433,10855,0.00636942,-0.0378663,-0.999263,0
6145,1688,35,260,1577,82,150,9937,1262,11199,0.000323961,-0.0294429,-0.999567,0
3908,1142,20,149,1084,38,103,6444,1010,7454,0.00680802,-0.0289838,-0.999557,0
5735,1609,29,216,1563,63,123,9338,1461,10799,-0.00997588,-0.0284213,-0.999546,0
5750,1657,29,235,1593,52,122,9438,1406,10844,-0.00694516,-0.0299632,-0.999527,0
6254,1663,30,221,1626,68,125,9987,1685,11672,-4.20927e-05,-0.0367694,-0.999324,0
6300,1619,31,216,1550,50,119,9885,1412,11297,0.00577911,-0.0361733,-0.999329,0
5651,1647,45,215,1578,51,124,9311,1414,10725,0.00236544,-0.0338783,-0.999423,0
5756,1631,29,214,1592,59,121,9402,1448,10850,0.00138338,-0.035366,-0.999374,0
5839,1661,47,214,1568,69,151,9549,1454,11003,0.00762744,-0.0397698,-0.99918,0
3893,1162,21,147,1074,45,82,6424,1015,7439,-0.00533961,-0.0337016,-0.999418,0
6153,1684,29,216,1586,56,121,9845,1421,11266,0.0018474,-0.0321472,-0.999481,0
5658,1657,29,215,1644,52,123,9378,1400,10778,0.0080803,-0.0274824,-0.99959,0
5814,1661,30,220,1529,51,118,9423,1179,10602,0.00660684,-0.0275333,-0.999599,0
5074,1494,26,251,1449,68,112,8474,1334,9808,-0.0010459,-0.0290039,-0.999579,0
6116,1643,30,218,1526,34,86,9653,1011,10664,-0.000202266,-0.0294941,-0.999565,0
3921,1139,21,169,1111,33,83,6477,963,7440,0.00328744,-0.0365246,-0.999327,0
5703,1636,30,215,1568,49,119,9320,1393,10713,0.00253456,-0.0381079,-0.99927,0
5635,1609,31,212,1630,53,123,9293,1368,10661,0.00144428,-0.0415526,-0.999135,0
5989,1654,36,242,1556,52,123,9652,1452,11104,0.0015247,-0.0352684,-0.999376,0
5602,1603,30,215,1653,71,122,9296,1208,10504,-0.00374274,-0.0316025,-0.999493,0
3852,1165,20,149,1106,40,81,6413,993,7406,0.00859386,-0.0282942,-0.999562,0
5610,1620,31,233,1599,51,123,9267,1448,10715,0.00548419,-0.0298363,-0.99954,0
5646,1643,30,218,1618,54,124,9333,1448,10781,0.00387275,-0.035982,-0.999345,0
5611,1665,36,254,1578,50,123,9317,1444,10761,0.00484582,-0.0402051,-0.99918,0
6226,1627,37,221,1546,51,119,9827,1443,11270,-0.00362086,-0.0336715,-0.999426,0
5007,1090,21,150,1086,36,95,7485,867,8352,-7.35504e-05,-0.0319352,-0.99949,0
2932,845,15,111,830,26,64,4823,725,5548,0.00503254,-0.0375249,-0.999283,0
