Downsample[ns],BuildFilTree[ns],SearchFil[ns],DeleteFil[ns],BuildTreeSub[ns],SearchSub[ns],DeleteSub[ns],PreProcTotal[ns],Plane[ns],Total[ns],nx,ny,nz,planeCount
5492,3779,81,464,3636,71,247,13770,1845,15615,0.0236009,0.00884633,-0.999682,0
4366,2942,26,304,2484,34,166,10322,1051,11373,0.0234623,0.00243105,-0.999722,0
3288,2252,22,268,2191,29,148,8198,1017,9215,0.0272898,0.00829297,-0.999593,0
5668,3674,39,498,3545,47,256,13727,1634,15361,0.0288303,0.00562511,-0.999568,0
5366,2573,24,321,2370,30,121,10805,841,11646,0.033356,0.00630276,-0.999424,0
2239,1517,15,196,1627,19,115,5728,687,6415,0.0273111,0.00311354,-0.999622,0
5932,3597,34,462,3406,47,268,13746,1627,15373,0.0291653,0.00647113,-0.999554,0
3551,2488,25,326,2384,32,186,8992,1148,10140,0.0330095,0.00459882,-0.999444,0
5291,3558,35,468,3422,54,296,13124,1637,14761,0.0272891,0.00337739,-0.999622,0
5156,3586,35,470,3534,50,237,13068,1260,14328,0.0327705,0.00124211,-0.999462,0
3792,2540,23,357,2506,32,197,9447,1109,10556,0.0349698,0.00664012,-0.999366,0
4677,3535,33,450,3186,60,242,12183,1363,13546,0.038147,-7.24054e-05,-0.999272,0
4789,3233,32,448,3039,36,170,11747,1045,12792,0.0313902,0.00279787,-0.999503,0
4467,2938,28,337,2854,43,190,10857,1262,12119,0.0265062,0.00616844,-0.99963,0
5232,3675,35,405,3425,61,228,13061,1582,14643,0.0351037,0.00151031,-0.999382,0
5733,3433,36,414,3523,51,233,13423,1152,14575,0.0314966,0.000834869,-0.999504,0
3617,2411,24,293,2306,34,161,8846,1097,9943,0.0294805,0.00714237,-0.99954,0
5002,3159,32,395,3104,43,210,11945,1405,13350,0.0305412,0.000777185,-0.999533,0
5508,3607,40,436,3583,83,260,13517,1566,15083,0.0245955,0.00365409,-0.999691,0
3594,1856,19,231,1799,26,137,7662,646,8308,0.0346843,-0.00118031,-0.999398,0
1868,1122,12,142,1049,18,70,4281,479,4760,0.0340743,0.000862097,-0.999419,0
5333,3553,34,453,3482,45,271,13171,1600,14771,0.0317439,0.00287971,-0.999491,0
5331,3894,46,432,3583,66,281,13633,1500,15133,0.0329574,0.00843182,-0.999421,0
1921,1272,13,160,1237,20,82,4705,560,5265,0.0335319,0.007898,-0.999407,0
3623,2528,30,299,2505,31,198,9214,1061,10275,0.0290281,0.00303733,-0.999574,0
5291,3634,35,479,3456,73,292,13260,1580,14840,0.0298282,0.00254944,-0.999552,0
2925,1941,19,249,1533,19,110,6796,639,7435,0.022838,0.00339636,-0.999733,0
1885,1250,12,158,1225,17,90,4637,561,5198,0.0338221,0.000954406,-0.999427,0
3630,2487,26,318,2392,47,184,9084,1052,10136,0.0279425,0.00431329,-0.9996,0
3654,2504,25,326,2415,75,229,9228,1077,10305,0.0316544,0.00629053,-0.999479,0
4851,3234,31,411,3203,57,240,12027,1403,13430,0.0284614,0.00363104,-0.999588,0
5409,3185,37,414,3127,61,247,12480,1513,13993,0.0269659,0.00166388,-0.999635,0
3363,2285,23,299,2237,32,179,8418,989,9407,0.0309514,0.00494035,-0.999509,0
5355,3603,34,528,3472,68,267,13327,1550,14877,0.0310511,0.0021897,-0.999516,0
5469,3581,46,446,3149,59,166,12916,1116,14032,0.0305168,-0.00169905,-0.999533,0
2793,1857,25,222,1890,34,176,6997,803,7800,0.0284453,-0.00231129,-0.999592,0
5653,3521,36,400,3577,69,288,13544,1500,15044,0.0369954,0.0012332,-0.999315,0
3682,2229,18,211,1858,27,141,8166,811,8977,0.0257936,0.00121439,-0.999667,0
1865,1265,13,161,1133,14,82,4533,472,5005,0.0256066,-0.00555308,-0.999657,0
5428,3490,34,469,3613,48,270,13352,1558,14910,0.0310402,0.00364127,-0.999511,0
3545,1811,17,237,1806,24,139,7579,706,8285,0.0294224,0.000815361,-0.999567,0
1875,1198,13,148,1202,17,80,4533,551,5084,0.0316294,0.00132101,-0.999499,0
4701,3118,33,357,3027,44,202,11482,1348,12830,0.0407769,-0.00195741,-0.999167,0
5269,3530,41,487,3327,82,258,12994,1544,14538,0.0233934,-0.00081331,-0.999726,0
4826,3123,58,413,3047,47,265,11779,1327,13106,0.0415224,-0.00399972,-0.99913,0
4678,3174,31,411,3053,45,239,11631,1344,12975,0.0339781,-0.00241865,-0.999419,0
5048,3348,32,400,3031,44,229,12132,1458,13590,0.0310431,0.000620698,-0.999518,0
3407,2223,22,263,2197,31,143,8286,951,9237,0.0292939,0.00226193,-0.999569,0
5279,3438,35,403,3353,54,229,12791,1540,14331,0.0294147,0.000506277,-0.999567,0
5286,3404,44,419,2725,51,218,12147,1159,13306,0.0222501,-0.000816177,-0.999752,0
2761,1795,19,219,1778,41,127,6740,902,7642,0.0298616,0.000603895,-0.999554,0
5496,3712,91,502,3526,56,266,13649,1535,15184,0.0259267,0.00163481,-0.999662,0
5444,3455,41,334,2306,42,165,11787,1053,12840,0.0287126,0.00109089,-0.999587,0
2247,1488,20,197,1438,30,101,5521,653,6174,0.0349242,0.000165499,-0.99939,0
4073,2634,34,311,2489,69,177,9787,1144,10931,0.0333081,-0.00105033,-0.999444,0
3958,2761,34,353,2572,36,168,9882,1144,11026,0.0209666,-0.00181832,-0.999778,0
5243,3440,34,473,3477,49,267,12983,1572,14555,0.0255437,-0.000268137,-0.999674,0
3664,2447,26,282,2352,40,160,8971,1128,10099,0.0300985,0.000716401,-0.999547,0
5211,3543,50,462,3408,44,225,12943,1538,14481,0.0255554,0.00114015,-0.999673,0
5467,3576,35,435,3543,35,176,13267,1037,14304,0.0343348,-0.00125872,-0.999409,0
2758,2488,24,333,2034,28,137,7802,832,8634,0.0355169,-0.001212,-0.999368,0
5231,3476,36,403,3403,51,235,12835,1548,14383,0.0338632,-0.000435972,-0.999426,0
5300,3446,36,398,3334,54,227,12795,1508,14303,0.0377246,2.85965e-05,-0.999288,0
5263,3419,35,424,3451,50,258,12900,1343,14243,0.0285376,-0.000123638,-0.999592,0
3632,2465,28,302,2364,66,180,9037,1038,10075,0.0374169,-0.00310689,-0.999295,0
5744,3660,37,534,3356,33,171,13535,1038,14573,0.0227075,-0.000478956,-0.999742,0
5613,3397,36,449,3029,37,158,12719,1037,13756,0.0211934,0.000177427,-0.999776,0
2755,2006,19,213,1854,26,124,6997,832,7829,0.0300387,-0.000163789,-0.999549,0
5257,3436,35,457,3473,50,234,12942,1577,14519,0.02874,-0.000406896,-0.999587,0
5731,3366,36,363,2320,45,149,12010,880,12890,0.036998,-0.000670052,-0.999315,0
2839,1825,19,234,1786,24,131,6858,878,7736,0.0281436,-0.00153952,-0.999603,0
5494,3605,37,443,3604,59,259,13501,1249,14750,0.0290937,0.00102863,-0.999576,0
3715,2425,24,334,2365,31,165,9059,1132,10191,0.0315719,0.000707037,-0.999501,0
6517,3374,32,370,3106,32,178,13609,1087,14696,0.0233796,0.00101565,-0.999727,0
3590,2719,31,380,2580,36,157,9493,1025,10518,0.0269958,-0.000509732,-0.999635,0
5482,3507,32,409,3299,42,209,12980,1643,14623,0.0342924,-0.000887981,-0.999412,0
3878,1937,21,269,1892,25,138,8160,823,8983,0.0296935,0.00130844,-0.999558,0
2773,1994,19,251,1805,22,137,7001,827,7828,0.0267354,9.9873e-05,-0.999643,0
4367,3026,72,409,2891,52,211,11028,1278,12306,0.0234874,0.000242351,-0.999724,0
4658,3524,32,477,3266,48,253,12258,1370,13628,0.0348846,-0.00117217,-0.999391,0
5556,3471,37,480,3530,50,269,13393,1604,14997,0.0290443,0.00145893,-0.999577,0
3861,2655,25,320,2455,31,162,9509,1041,10550,0.0353163,-0.00130087,-0.999375,0
5223,3487,37,568,3527,64,231,13137,1589,14726,0.0293401,-0.000484962,-0.999569,0
4050,2499,26,325,2515,38,160,9613,1058,10671,0.0289587,-0.00097376,-0.99958,0
5324,3415,29,371,3104,49,240,12532,1421,13953,0.0238033,-0.00242913,-0.999714,0
4281,3062,42,499,2942,46,252,11124,1229,12353,0.0254568,-0.00697419,-0.999652,0
4697,3155,30,415,3114,46,246,11703,1424,13127,0.0367864,-0.0033973,-0.999317,0
4801,3258,33,415,3032,39,260,11838,1359,13197,0.0277458,-0.000823764,-0.999615,0
3448,2348,25,330,2203,44,147,8545,1044,9589,0.0303541,-0.000900332,-0.999539,0
4301,2970,29,396,2820,61,233,10810,1287,12097,0.0338566,-0.00238681,-0.999424,0
5424,3484,36,458,3197,32,178,12809,1115,13924,0.0323287,-2.98006e-05,-0.999477,0
3705,2431,24,299,2401,38,170,9068,1070,10138,0.0263489,-0.00323041,-0.999648,0
3115,2186,30,277,2326,48,179,8161,943,9104,0.0383973,-0.00502607,-0.99925,0
5269,3532,58,463,3575,87,271,13255,1595,14850,0.031183,0.000229828,-0.999514,0
4361,2530,31,287,1788,42,141,9180,864,10044,0.032045,-8.12024e-05,-0.999486,0
3305,1855,28,301,1780,28,114,7411,645,8056,0.0270257,-0.00453589,-0.999624,0
4680,3111,39,372,2960,54,238,11454,1415,12869,0.0330871,0.00367577,-0.999446,0
4986,3156,40,398,3032,58,208,11878,1370,13248,0.0289999,9.00973e-05,-0.999579,0
3391,2159,31,327,2200,52,148,8308,981,9289,0.0294547,-0.00187104,-0.999564,0
4365,2949,41,404,2712,70,186,10727,1218,11945,0.0340429,-0.00476165,-0.999409,0
4610,2682,36,332,2604,69,176,10509,1225,11734,0.0378492,-0.0050614,-0.999271,0
4107,2457,28,324,2375,44,188,9523,1135,10658,0.0267141,0.00153411,-0.999642,0
5349,2801,30,329,2723,49,185,11466,1421,12887,0.0285377,-0.0012726,-0.999592,0
4683,2679,39,336,2579,63,189,10568,1454,12022,0.033823,-0.00259353,-0.999424,0
5514,2967,39,349,2820,44,178,11911,1696,13607,0.0295659,-0.00170122,-0.999562,0
5374,3063,44,554,4024,78,300,13437,1610,15047,0.0272281,-0.00538617,-0.999615,0
6398,2993,37,383,2230,34,156,12231,1128,13359,0.0305471,0.00547108,-0.999518,0
3711,1934,24,229,1823,30,184,7935,1033,8968,0.0346368,0.00656595,-0.999379,0
3857,1932,28,276,1898,32,156,8179,1031,9210,0.0215242,0.0128656,-0.999686,0
2937,1446,18,176,1443,30,121,6171,851,7022,0.0302992,0.0290731,-0.999118,0
5157,2570,41,373,2475,45,214,10875,1416,12291,0.0330157,0.0542758,-0.99798,0
5345,2598,35,306,2250,29,119,10682,1017,11699,0.0339062,0.0621211,-0.997493,0
4425,2216,29,267,2245,53,156,9391,1210,10601,0.0275504,0.0610825,-0.997752,0
5518,2795,35,399,2655,56,231,11689,1306,12995,0.037898,0.0594164,-0.997514,0
3752,1920,24,306,1865,43,152,8062,1061,9123,0.0296426,0.0553316,-0.998028,0
3814,1898,22,250,1792,41,137,7954,1124,9078,0.0249048,0.0723706,-0.997067,0
5566,2549,31,363,2562,48,177,11296,1577,12873,0.0519983,0.0768125,-0.995689,0
5523,2457,37,285,2263,40,143,10748,1522,12270,0.0491233,0.0896634,-0.99476,0
3173,1197,17,165,1153,26,80,5811,859,6670,0.0278671,0.111118,-0.993416,0
4830,1893,27,267,1832,33,130,9012,1401,10413,0.0327276,0.11196,-0.993174,0
5370,2053,30,250,1928,40,153,9824,1703,11527,0.0428372,0.112821,-0.992692,0
5526,2020,30,250,1785,37,125,9773,1422,11195,0.0232932,0.0994282,-0.994772,0
4927,1888,26,266,1921,39,153,9220,1354,10574,0.00839419,0.116937,-0.993104,0
4812,1960,32,225,1846,49,143,9067,1528,10595,0.00912938,0.127764,-0.991763,0
4276,1700,25,221,1608,42,135,8007,1306,9313,0.0168553,0.108119,-0.993995,0
5481,2044,29,285,1967,39,152,9997,1587,11584,0.0234658,0.141821,-0.989614,0
5066,1945,26,243,1818,36,145,9279,1522,10801,0.0218317,0.123089,-0.992156,0
5037,2111,29,283,1895,40,168,9563,1607,11170,0.0299485,0.139751,-0.989734,0
5030,1904,29,247,1804,37,140,9191,1583,10774,0.0239728,0.142213,-0.989546,0
4826,1981,29,282,1822,41,168,9149,1361,10510,0.0199675,0.152769,-0.98806,0
3198,1186,21,158,1193,25,84,5865,1120,6985,0.0237866,0.14384,-0.989315,0
4129,1466,25,222,1391,43,115,7391,1351,8742,0.0185,0.132804,-0.99097,0
4585,1435,28,194,1459,53,112,7866,1521,9387,0.0232776,0.13706,-0.990289,0
4402,1312,28,188,1263,49,121,7363,1489,8852,0.0219664,0.129913,-0.991282,0
4520,1197,31,180,1278,49,98,7353,1474,8827,0.0305666,0.126704,-0.99147,0
4361,1169,28,209,1139,43,123,7072,1532,8604,0.0344546,0.132309,-0.990609,0
4303,1093,34,179,1082,64,85,6840,1494,8334,0.0387068,0.134863,-0.990108,0
4327,1039,29,152,995,48,88,6678,1563,8241,0.0380636,0.139588,-0.989478,0
3040,821,19,109,842,27,62,4920,1083,6003,0.0444968,0.141101,-0.988995,0
4558,1435,38,234,1354,40,122,7781,1588,9369,0.039695,0.139809,-0.989383,0
4644,1448,32,222,1467,64,143,8020,1499,9519,0.0244594,0.136772,-0.990301,0
4672,1709,32,244,1653,38,149,8497,1569,10066,0.00803088,0.153473,-0.98812,0
4525,1973,27,273,1847,57,189,8891,1488,10379,-0.00422763,0.126253,-0.991989,0
4769,2205,28,313,2139,40,162,9656,1489,11145,-0.00642429,0.1749,-0.984565,0
4817,2537,27,340,2553,42,204,10520,1541,12061,0.00735221,0.220256,-0.975414,0
4451,2659,35,416,2662,47,207,10477,1418,11895,0.0268766,0.229848,-0.972855,0
4622,2902,27,355,2939,31,187,11063,1377,12440,0.0396805,0.193853,-0.980228,0
4777,3320,26,400,3036,20,145,11724,1004,12728,0.0313821,0.190424,-0.981201,0
6268,3656,20,330,2735,19,162,13190,805,13995,0.0286083,0.233429,-0.971953,0
5711,4759,29,504,3189,26,217,14435,1058,15493,0.0455235,0.221649,-0.974063,0
2804,2649,17,296,2608,24,177,8575,799,9374,0.0395045,0.133908,-0.990206,0
5478,5310,28,629,5242,76,347,17110,1576,18686,0.033477,0.223521,-0.974124,0
5857,5744,36,665,3933,38,262,16535,1040,17575,0.0238617,0.276295,-0.960776,0
2578,2531,12,248,2165,20,141,7695,592,8287,0.0218728,0.217782,-0.975752,0
1694,1629,9,179,1582,12,97,5202,492,5694,0.0265495,0.15576,-0.987438,0
3118,2975,16,346,2746,24,191,9416,927,10343,0.0247176,0.137593,-0.99018,0
6318,5164,27,539,4840,66,313,17267,2559,19826,0.0241627,0.147661,-0.988743,0
6285,5111,38,637,5490,75,384,18020,1599,19619,0.00284751,0.239206,-0.970965,0
3303,2337,12,240,2354,32,141,8419,742,9161,-0.0015344,0.205283,-0.978702,0
2109,1548,9,228,1623,21,108,5646,576,6222,0.0351391,0.0753558,-0.996537,0
1568,1247,9,151,1187,16,75,4253,443,4696,0.0242644,0.0807241,-0.996441,0
5257,3752,26,411,3715,49,265,13475,1460,14935,0.0317616,0.0528242,-0.998099,0
5945,3854,37,472,3806,71,288,14473,1539,16012,0.0151217,0.131103,-0.991253,0
4093,1990,16,227,1972,36,129,8463,751,9214,0.0174891,0.0841628,-0.996299,0
2213,1408,11,173,1388,16,105,5314,567,5881,-0.00476625,0.0743002,-0.997225,0
1694,1191,10,140,1132,15,72,4254,577,4831,-0.00817332,0.0223522,-0.999717,0
5946,3827,26,475,3538,40,317,14169,1816,15985,0.00947273,0.0637895,-0.997919,0
4278,3056,23,307,2448,29,181,10322,1053,11375,-0.0151677,0.0586169,-0.998165,0
3565,2270,18,262,2269,24,148,8556,1054,9610,-0.0132932,0.075186,-0.997081,0
5479,3622,26,450,3582,57,291,13507,1837,15344,0.00327185,0.114189,-0.993454,0
3699,2412,19,336,2384,35,183,9068,1327,10395,-0.000662423,0.0459755,-0.998943,0
5101,3135,25,435,3009,35,233,11973,1531,13504,-0.00565685,0.0475195,-0.998854,0
4429,2749,31,342,2663,35,186,10435,1444,11879,-0.0141503,0.0385978,-0.999155,0
4235,2882,26,385,2659,39,210,10436,1397,11833,-0.0212879,0.0425204,-0.998869,0
2971,1837,17,252,1750,24,158,7009,957,7966,-0.0235499,0.0559814,-0.998154,0
4584,2776,26,374,2668,38,203,10669,1507,12176,-0.017083,0.0702514,-0.997383,0
4556,2789,26,458,2684,36,184,10733,1517,12250,-0.00136936,0.109129,-0.994027,0
4490,2811,32,338,2717,71,203,10662,1508,12170,0.0029337,0.0927451,-0.995686,0
4558,2911,30,391,2795,65,232,10982,1482,12464,0.000841137,0.132433,-0.991192,0
3155,2192,16,258,2096,29,134,7880,1056,8936,-0.000282401,0.16969,-0.985497,0
4645,3372,24,370,3154,48,204,11817,1486,13303,-0.02659,0.151917,-0.988035,0
4764,3129,28,368,2945,37,195,11466,1368,12834,-0.0148435,0.210483,-0.977485,0
4323,3241,23,394,3150,35,201,11367,1340,12707,-0.0132938,0.204608,-0.978754,0
4464,3792,24,392,3151,35,149,12007,960,12967,-0.0088413,0.188268,-0.982078,0
4833,3593,23,384,2385,23,150,11391,987,12378,-0.0107651,0.134885,-0.990803,0
2430,1902,14,269,2277,20,142,7054,741,7795,-0.0157268,0.0815135,-0.996548,0
3064,2301,15,285,2280,26,143,8114,903,9017,-0.0145343,0.112632,-0.993531,0
5480,3808,24,428,3637,32,226,13635,1429,15064,-0.0184252,0.105042,-0.994297,0
3203,2563,17,306,2449,38,169,8745,989,9734,-0.00520802,0.134206,-0.99094,0
2822,1956,13,256,1981,22,123,7173,787,7960,-0.00408435,0.139572,-0.990203,0
5497,4127,31,499,3916,37,273,14380,1546,15926,-0.0174612,0.145063,-0.989268,0
5085,3910,27,438,3949,48,304,13761,1586,15347,-0.023988,0.135573,-0.990477,0
2658,2100,15,256,2105,41,153,7328,1194,8522,-0.0962822,0.130518,-0.986759,0
5101,4081,27,485,3988,67,259,14008,2210,16218,-0.0946152,0.142991,-0.985191,0
3485,2852,20,336,2785,51,170,9699,1445,11144,-0.0827184,0.231983,-0.969196,0
5454,4207,40,486,3862,79,275,14403,1722,16125,-0.0369828,0.139396,-0.989546,0
3498,2702,23,344,2681,29,163,9440,1178,10618,-0.0533755,0.140155,-0.98869,0
3871,2969,27,319,2600,26,176,9988,1075,11063,-0.0526567,0.130264,-0.99008,0
3517,2485,23,290,2359,26,169,8869,1006,9875,-0.0294612,0.17753,-0.983674,0
4869,2921,29,363,2807,31,211,11231,1385,12616,-0.0402574,0.262372,-0.964127,0
4530,2550,29,386,2466,34,196,10191,1330,11521,-0.0412047,0.257841,-0.965308,0
3239,1836,23,246,1803,28,126,7301,952,8253,-0.0533204,0.254919,-0.965492,0
5060,2838,53,414,2658,45,196,11264,1654,12918,-0.0488748,0.283109,-0.957842,0
5536,3091,36,408,2859,31,143,12104,1068,13172,-0.0923071,0.263038,-0.960359,0
3246,2209,23,271,2110,24,148,8031,1100,9131,-0.0823991,0.253167,-0.963908,0
5123,3502,26,442,3415,47,249,12804,1837,14641,-0.081385,0.136202,-0.987333,0
5357,3612,36,414,3500,60,240,13219,1892,15111,-0.0533102,0.134933,-0.98942,0
3493,2435,23,280,2281,33,163,8708,1123,9831,0.0152636,0.139558,-0.990096,0
5068,3252,35,395,3230,42,226,12248,1112,13360,0.0190366,0.151615,-0.988256,0
3382,2070,21,270,2035,25,147,7950,1048,8998,0.0130428,0.125365,-0.992025,0
4209,2489,27,341,2367,55,188,9676,1367,11043,-0.0363972,0.061787,-0.997426,0
4263,2075,36,304,2063,34,178,8953,1393,10346,-0.0286741,0.0842055,-0.996036,0
4268,2156,27,307,2067,32,180,9037,1371,10408,0.0212487,0.08694,-0.995987,0
4888,2683,31,365,2500,52,185,10704,1529,12233,0.0477997,0.158373,-0.986222,0
3362,1389,16,187,1338,39,96,6427,826,7253,0.0450351,0.117174,-0.99209,0
2007,1018,15,124,964,21,72,4221,635,4856,0.0378958,0.103402,-0.993917,0
4921,2091,30,271,2121,52,169,9655,1632,11287,0.0384129,0.118936,-0.992159,0
5038,1931,35,258,1892,46,147,9347,1627,10974,0.0314314,0.13032,-0.990974,0
5207,1845,36,271,1765,58,130,9312,1792,11104,0.023069,0.156056,-0.987479,0
5103,1722,29,263,1701,42,162,9022,1695,10717,0.0101018,0.177427,-0.984082,0
5093,1480,30,195,1450,34,118,8400,1914,10314,0.0124441,0.158421,-0.987293,0
4857,1381,29,194,1305,37,106,7909,2229,10138,0.024273,0.118966,-0.992602,0
4920,1371,30,191,1330,38,106,7986,1849,9835,0.0208836,0.168004,-0.985565,0
4718,1336,36,193,1352,76,113,7824,1599,9423,0.0249035,0.152162,-0.988042,0
4823,1248,30,175,1243,37,110,7666,1401,9067,0.0254567,0.141951,-0.989546,0
3195,917,26,128,895,41,74,5276,1114,6390,0.0148529,0.157258,-0.987446,0
4586,1426,34,224,1386,39,110,7805,1514,9319,0.0249727,0.173238,-0.984563,0
5057,1706,35,239,1672,49,140,8898,1469,10367,0.0403776,0.156832,-0.9868,0
4800,2000,37,264,1910,56,146,9213,1484,10697,0.0367512,0.179624,-0.983049,0
6677,3052,53,365,2009,31,153,12340,1301,13641,0.0331185,0.188253,-0.981562,0
5050,2590,27,286,2970,34,204,11161,1566,12727,0.00238644,0.248007,-0.968755,0
3619,1525,25,169,1481,23,96,6938,779,7717,-0.0106558,0.172133,-0.985016,0
1813,1150,10,134,1113,14,72,4306,537,4843,-0.00124472,0.111657,-0.993746,0
3758,3184,26,347,3011,39,241,10606,1380,11986,-0.0288369,0.127362,-0.991437,0
5234,3927,31,475,3764,42,288,13761,1867,15628,-0.0235534,0.150868,-0.988273,0
5816,4692,34,574,3701,38,224,15079,1187,16266,-0.000567539,0.136247,-0.990675,0
3072,2869,17,312,2652,33,170,9125,1053,10178,0.0246938,0.105378,-0.994126,0
5504,4800,25,527,4871,49,316,16092,1108,17200,0.0149725,0.137407,-0.990401,0
4136,3361,18,376,3339,52,211,11493,1004,12497,0.00538719,0.126736,-0.991922,0
5764,4688,26,564,4747,57,329,16175,1243,17418,-0.0167897,0.133351,-0.990927,0
3992,3291,19,402,3270,39,207,11220,945,12165,-0.0207708,0.134533,-0.990692,0
6094,5214,27,605,5096,54,368,17458,1562,19020,-0.0500676,0.129102,-0.990367,0
4162,3345,19,428,2964,56,198,11172,815,11987,-0.0371845,0.11524,-0.992642,0
3023,2359,17,249,2238,20,181,8087,802,8889,-0.0246038,0.0476691,-0.99856,0
6089,3812,26,382,3670,54,228,14261,1399,15660,-0.0409731,0.118669,-0.992088,0
3513,2320,18,288,2351,30,174,8694,984,9678,-0.0346039,0.101408,-0.994243,0
5694,2975,23,369,2905,64,213,12243,1240,13483,-0.0342322,0.114381,-0.992847,0
4755,2964,28,338,2913,64,224,11286,1240,12526,-0.0264715,0.123094,-0.992042,0
4628,3052,25,344,2979,36,194,11258,1260,12518,-0.0363203,0.0978199,-0.994541,0
5643,3892,29,444,3658,43,251,13960,1675,15635,-0.0290397,0.111476,-0.993343,0
3875,2890,23,354,2818,34,206,10200,1052,11252,-0.0327924,0.0675763,-0.997175,0
5046,3590,29,429,3574,46,271,12985,1434,14419,-0.0232146,0.0941659,-0.995286,0
5693,3973,29,540,4159,62,372,14828,1626,16454,-0.00774694,0.181211,-0.983414,0
3372,1984,14,257,1888,20,118,7653,694,8347,-0.0130148,0.148581,-0.988815,0
1861,1326,11,161,1284,15,81,4739,569,5308,-0.0122673,0.117954,-0.992943,0
4514,3302,25,480,3215,44,273,11853,1367,13220,-0.00055621,0.192279,-0.98134,0
5041,3820,26,458,3684,43,290,13362,1573,14935,-0.00483964,0.259386,-0.965762,0
3416,2638,17,366,2602,37,210,9286,1229,10515,-0.00916657,0.261058,-0.96528,0
3624,3034,18,310,2686,25,184,9881,1178,11059,-0.0112307,0.279145,-0.960183,0
3418,2837,18,324,2711,30,213,9551,1128,10679,-0.0090099,0.307674,-0.951449,0
4482,3540,29,420,3573,51,255,12350,1386,13736,-0.0221065,0.360364,-0.93255,0
4628,3532,24,445,3571,48,330,12578,1257,13835,-0.0229355,0.381573,-0.924054,0
3232,2795,20,315,2555,29,181,9127,949,10076,-0.0142111,0.320583,-0.947114,0
3243,2592,20,289,2611,35,191,8981,1002,9983,0.0143956,0.291386,-0.956497,0
5316,3968,28,427,3614,29,171,13553,984,14537,0.0180945,0.261195,-0.965116,0
2482,1893,17,232,1910,23,133,6690,924,7614,-8.60225e-05,0.233146,-0.972441,0
5881,3674,39,541,3527,57,258,13977,1594,15571,-0.0143286,0.406783,-0.913413,0
2748,1541,16,187,1431,33,101,6057,614,6671,-0.0209319,0.285624,-0.958113,0
1906,1318,15,154,1284,15,93,4785,548,5333,-0.0105131,0.244147,-0.969681,0
2493,1680,18,223,1654,25,130,6223,748,6971,-0.0273319,0.245862,-0.968919,0
5244,3292,35,387,2866,44,225,12093,1376,13469,-0.0429814,0.262802,-0.963892,0
4632,2826,32,381,2775,49,202,10897,1349,12246,-0.0288166,0.228758,-0.973057,0
5069,2766,35,347,2742,44,215,11218,1582,12800,-0.00882501,0.205982,-0.978516,0
3358,1685,19,224,1658,25,119,7088,1047,8135,0.00783201,0.170458,-0.985334,0
5453,2288,29,324,2194,32,152,10472,1601,12073,0.0343083,0.25945,-0.965147,0
2939,1145,22,164,1093,22,80,5465,827,6292,0.0432709,0.197144,-0.979419,0
1802,778,12,113,746,13,52,3516,607,4123,0.0259974,0.164154,-0.986092,0
5610,2036,27,279,2078,51,181,10262,1775,12037,0.022395,0.19081,-0.981372,0
5160,1884,36,280,1836,50,147,9393,1837,11230,0.0298766,0.195892,-0.98017,0
5385,1714,31,223,1635,46,124,9158,1469,10627,0.0176446,0.221711,-0.974953,0
3362,1056,22,146,1019,42,96,5743,1104,6847,0.016237,0.197793,-0.980109,0
4982,1605,33,215,1497,60,125,8517,1540,10057,0.0167529,0.183765,-0.982828,0
4740,1660,31,217,1554,54,128,8384,1607,9991,0.00631596,0.17696,-0.984198,0
4958,1761,37,267,1675,44,126,8868,1502,10370,0.00950316,0.171894,-0.98507,0
4764,1884,29,267,1933,36,99,9012,1030,10042,0.0195495,0.149522,-0.988565,0
3444,1397,24,251,1355,24,95,6590,1032,7622,0.023452,0.143837,-0.989323,0
3453,1496,25,191,1501,41,124,6831,1186,8017,0.028842,0.174014,-0.984321,0
4651,2447,31,271,2092,47,155,9694,1435,11129,0.0267657,0.164319,-0.986044,0
5141,2606,35,367,2527,41,172,10889,1449,12338,0.016437,0.190765,-0.981498,0
4780,3249,37,354,2596,23,134,11173,989,12162,0.0244554,0.131463,-0.99102,0
3315,2049,19,256,2042,43,157,7881,1042,8923,0.0241335,0.197082,-0.98009,0
5203,3047,32,391,2950,40,198,11861,1390,13251,0.00797467,0.153008,-0.988193,0
4717,3149,33,352,3015,49,213,11528,1322,12850,0.00897696,0.146159,-0.98922,0
3524,2355,34,291,2394,40,156,8794,989,9783,0.0166837,0.110035,-0.993788,0
5394,3602,29,375,3759,50,285,13494,1377,14871,0.00895707,0.202711,-0.979198,0
5218,3533,28,407,3604,39,226,13055,1237,14292,-0.0262366,0.211113,-0.97711,0
2792,2418,13,199,1811,36,125,7394,624,8018,-0.0219987,0.138529,-0.990114,0
1753,1522,9,153,1482,20,96,5035,478,5513,0.0282703,0.103748,-0.994202,0
6367,5024,29,618,4400,47,214,16699,1011,17710,0.059351,0.117216,-0.991331,0
3827,2951,19,341,2901,33,201,10273,974,11247,0.00965781,0.067472,-0.997675,0
5876,4198,30,509,3911,64,267,14855,1465,16320,-0.0119194,0.0287538,-0.999516,0
3880,2536,20,293,2504,34,176,9443,1196,10639,-0.0196688,0.0216809,-0.999572,0
4522,2833,23,314,2775,38,181,10686,1294,11980,-0.0206615,-0.00306425,-0.999782,0
5983,3562,31,382,3282,42,217,13499,1252,14751,-0.019805,-0.0124603,-0.999727,0
3685,2279,20,252,2174,39,142,8591,1036,9627,-0.0100309,-0.0173171,-0.9998,0
5434,3145,29,379,3226,58,253,12524,1532,14056,-0.00888416,-0.0376784,-0.99925,0
4879,2951,26,390,2592,32,166,11036,1019,12055,-0.0191367,-0.0346402,-0.999217,0
2861,1706,16,212,1645,27,123,6590,830,7420,-0.0213752,-0.0600142,-0.997969,0
5638,3488,32,393,3533,43,258,13385,1877,15262,-0.0318565,0.0480273,-0.998338,0
3421,1833,16,212,1823,19,110,7434,676,8110,-0.0253632,-0.0174029,-0.999527,0
5605,3545,38,496,3490,69,261,13504,1603,15107,-0.023091,-0.0160116,-0.999605,0
3716,2555,20,331,2419,37,169,9247,1058,10305,-0.0164942,0.00556235,-0.999849,0
5224,3210,25,415,3241,39,216,12370,1560,13930,-0.019141,-0.025775,-0.999484,0
3405,2310,23,266,2235,45,159,8443,998,9441,-0.0213544,0.000343002,-0.999772,0
5331,3535,35,459,3476,47,251,13134,1365,14499,-0.0137751,0.0394355,-0.999127,0
4681,3293,30,385,3648,50,157,12244,1067,13311,-0.0178945,0.0505066,-0.998563,0
5189,3652,32,427,3641,57,258,13256,1625,14881,-0.0124345,0.160267,-0.986995,0
5191,3177,19,317,2565,21,127,11417,896,12313,-0.0142443,0.167785,-0.985721,0
2131,1450,12,161,1313,20,89,5176,612,5788,-0.0133463,0.0770998,-0.996934,0
2060,1471,12,168,1441,21,97,5270,664,5934,-0.0144702,0.0782005,-0.996833,0
4542,3473,26,415,3875,69,227,12627,1600,14227,-0.00790764,0.151642,-0.988404,0
5103,3781,30,425,3515,43,247,13144,1583,14727,0.00197719,0.29819,-0.954504,0
4515,3246,17,261,2336,25,148,10548,976,11524,0.00217311,0.282697,-0.959207,0
2058,1401,10,163,1347,15,78,5072,554,5626,0.0059901,0.216007,-0.976373,0
1629,1152,9,130,1164,15,79,4178,587,4765,0.00160496,0.186585,-0.982438,0
4289,3341,23,357,3226,41,211,11488,1443,12931,0.00295592,0.178218,-0.983987,0
4468,3114,32,394,3071,37,235,11351,1463,12814,0.0258781,0.169838,-0.985132,0
4337,3088,24,344,3004,65,250,11112,1364,12476,0.0366081,0.193161,-0.980484,0
5007,3205,27,353,3219,62,206,12079,1254,13333,0.0373046,0.238591,-0.970404,0
3309,2300,23,263,2330,45,146,8416,965,9381,0.0503723,0.243254,-0.968654,0
5258,3224,31,353,3009,54,238,12167,1361,13528,0.0588975,0.185799,-0.980821,0
3490,2483,23,314,2166,46,178,8700,967,9667,0.0396533,0.149086,-0.988029,0
4564,2936,33,378,3006,63,266,11246,1729,12975,0.0194951,0.141488,-0.989748,0
3565,2172,25,291,2207,35,162,8457,943,9400,0.00525744,0.127074,-0.991879,0
3208,2074,21,280,2137,53,143,7916,1074,8990,0.0071401,0.137939,-0.990415,0
5280,3422,33,397,3224,53,234,12643,1511,14154,0.0239513,0.128638,-0.991402,0
5725,3632,34,412,3372,43,166,13384,1031,14415,0.051698,0.138894,-0.988957,0
2742,1823,18,217,1822,23,122,6767,781,7548,0.0495805,0.116761,-0.991922,0
5236,3596,33,475,3415,48,244,13047,1399,14446,0.0413701,0.0986785,-0.994259,0
4655,3189,29,407,3153,62,248,11743,1356,13099,0.0373384,0.0968687,-0.994597,0
3397,2334,26,318,2212,42,182,8511,982,9493,0.0381447,0.0988428,-0.994372,0
4520,3179,38,429,3062,82,238,11548,1439,12987,0.0427846,0.0859917,-0.995377,0
5146,3597,34,458,3504,46,272,13057,1534,14591,0.0490084,0.0843529,-0.99523,0
3557,2498,23,319,2474,41,237,9149,1131,10280,0.0607456,-0.0071664,-0.998127,0
5083,3406,30,408,3216,47,241,12431,1352,13783,0.0567025,0.00409671,-0.998382,0
4581,3295,31,423,3106,46,243,11725,1395,13120,0.0467618,0.0827515,-0.995473,0
4568,3125,30,405,3007,55,239,11429,1477,12906,0.0506617,0.0690032,-0.996329,0
4904,3030,31,358,2887,61,199,11470,1394,12864,0.0599429,0.0926812,-0.99389,0
4793,3000,30,352,2895,47,242,11359,1417,12776,0.049254,0.105614,-0.993187,0
5255,2177,19,218,1702,54,127,9552,673,10225,0.0469352,0.0963688,-0.994239,0
1802,1150,15,145,1098,19,87,4316,575,4891,0.0503234,0.111312,-0.992511,0
5206,2992,31,373,2878,53,192,11725,1450,13175,0.0621072,-0.00140838,-0.998069,0
4739,3131,31,394,2911,63,225,11494,1470,12964,0.0475562,0.0622786,-0.996926,0
4482,2854,33,338,2614,48,215,10584,1244,11828,0.0439632,0.0686481,-0.996672,0
5196,3148,41,423,3174,67,218,12267,1643,13910,0.038887,0.0569459,-0.99762,0
4750,3062,31,366,2147,31,142,10529,1096,11625,0.0296843,0.0396765,-0.998772,0
2581,1565,23,209,1561,29,113,6081,764,6845,0.030479,0.0595173,-0.997762,0
5056,3288,34,429,3146,47,224,12224,1662,13886,0.0387421,-0.0243231,-0.998953,0
5356,3266,34,495,3107,98,269,12625,1579,14204,0.0356297,0.0642565,-0.997297,0
4702,2960,29,440,2902,67,230,11330,1500,12830,0.0423023,0.102198,-0.993864,0
4640,2849,31,340,2712,55,224,10851,1029,11880,0.0434226,0.109339,-0.993056,0
3419,2006,22,246,2009,45,134,7881,1031,8912,0.0542029,-0.0082552,-0.998496,0
4175,2588,28,329,2530,43,179,9872,1294,11166,0.0427754,0.0799971,-0.995877,0
5313,3331,34,419,3234,48,212,12591,1652,14243,0.0423743,0.0653324,-0.996964,0
4763,3134,30,451,2941,37,144,11500,984,12484,0.040201,0.0858717,-0.995495,0
3254,2029,22,288,2012,33,135,7773,1006,8779,0.043037,0.0648271,-0.996968,0
6264,3356,34,438,3286,61,213,13652,1576,15228,0.0408546,0.076508,-0.996232,0
5216,3121,32,399,2820,47,191,11826,1332,13158,0.0501623,-0.015631,-0.998619,0
4314,2749,34,387,2692,46,189,10411,1281,11692,0.0392074,0.0692468,-0.996829,0
5062,3096,30,384,3000,40,192,11804,1393,13197,0.0362529,0.0661382,-0.997152,0
4711,2841,32,369,2747,61,190,10951,1523,12474,0.0376793,0.0911864,-0.995121,0
4665,2863,31,344,2823,61,197,10984,1488,12472,0.0425896,0.058699,-0.997367,0
5199,3212,42,405,3168,66,213,12305,1629,13934,0.0467172,-0.00632505,-0.998888,0
3508,2231,28,301,2179,34,178,8459,1125,9584,0.0378251,0.0775701,-0.996269,0
5288,3277,33,432,3468,66,249,12813,1579,14392,0.0383416,0.0992038,-0.994328,0
3178,1645,20,214,1539,39,125,6760,794,7554,0.0421189,0.0851434,-0.995478,0
1764,1112,12,146,1073,20,78,4205,538,4743,0.0346412,0.0851691,-0.995764,0
3403,2340,21,246,2014,26,159,8209,951,9160,0.0383092,0.0763795,-0.996342,0
5397,3242,34,459,3142,60,251,12585,1900,14485,0.0423368,0.0969923,-0.994384,0
5275,3231,34,381,3016,33,147,12117,1046,13163,0.0413914,0.0824291,-0.995737,0
3160,1660,19,200,1630,33,111,6813,780,7593,0.0365582,0.0651508,-0.997206,0
4698,2784,31,346,2763,44,190,10856,1720,12576,0.0313867,0.074421,-0.996733,0
5355,3191,34,440,3146,67,239,12472,1536,14008,0.0368977,0.0728586,-0.99666,0
3427,2243,23,295,2205,47,178,8418,1140,9558,0.036045,0.0974094,-0.994592,0
5021,3132,33,378,3136,60,213,11973,1560,13533,0.0435194,0.0858674,-0.995356,0
5381,3384,35,383,3049,48,197,12477,1210,13687,0.0398267,0.0784154,-0.996125,0
3236,2050,22,271,2020,29,152,7780,963,8743,0.0417555,0.078555,-0.996035,0
5215,3292,33,464,3219,67,260,12550,1466,14016,0.0416164,0.0911805,-0.994964,0
3505,2214,25,289,2201,50,177,8461,1135,9596,0.0406377,0.0988246,-0.994275,0
3580,2915,34,295,2257,40,180,9301,1104,10405,0.0375517,0.094114,-0.994853,0
5420,3259,34,451,3221,47,256,12688,1599,14287,0.0401974,0.0602001,-0.997377,0
2155,1315,15,156,1283,21,86,5031,581,5612,0.0386458,0.076307,-0.996335,0
1553,927,13,151,763,15,104,3526,375,3901,0.0434771,0.0790914,-0.995919,0
1341,858,10,103,845,14,66,3237,417,3654,0.0413405,0.0931616,-0.994792,0
4486,2937,30,375,2762,41,190,10821,1394,12215,0.0408988,0.077045,-0.996189,0
4636,2830,37,345,2784,44,197,10873,1438,12311,0.0421318,0.088073,-0.995223,0
5106,3221,33,387,3017,52,191,12007,1527,13534,0.0412032,0.0800641,-0.995938,0
3465,2405,38,393,2186,38,148,8673,1067,9740,0.0359565,0.0784058,-0.996273,0
5010,3153,32,418,3183,66,225,12087,1501,13588,0.0424791,0.0782601,-0.996028,0
5151,3173,33,384,3162,59,220,12182,1620,13802,0.0415731,0.0910448,-0.994978,0
5039,3161,33,387,3127,52,219,12018,1548,13566,0.0427611,0.0772045,-0.996098,0
3595,2260,23,300,2147,39,177,8541,1051,9592,0.0368511,0.0905082,-0.995214,0
4709,2943,30,436,3262,52,226,11658,1638,13296,0.0434149,0.0789199,-0.995935,0
3502,1863,18,241,1683,32,129,7468,950,8418,0.041284,0.0638764,-0.997104,0
2194,1341,18,166,1332,31,96,5178,676,5854,0.0366075,0.090179,-0.995253,0
5119,3106,38,357,2890,63,200,11773,1411,13184,0.0416672,0.082424,-0.995726,0
5124,3274,39,412,3111,73,235,12268,1547,13815,0.0403267,0.0998675,-0.994183,0
3615,2271,32,309,2387,52,181,8847,1077,9924,0.0428522,0.0758679,-0.996196,0
5025,3573,36,396,3303,71,248,12652,1576,14228,0.0422136,0.0776502,-0.996087,0
5062,3343,34,445,2849,46,173,11952,1171,13123,0.039835,0.0812191,-0.9959,0
2713,1702,22,236,1687,36,131,6527,840,7367,0.0380118,0.0801341,-0.996059,0
5162,3345,36,429,3220,55,274,12521,1550,14071,0.0443252,0.0800106,-0.995808,0
5059,3203,34,429,3138,47,245,12155,1489,13644,0.040947,0.077897,-0.99612,0
3537,2231,24,294,2146,36,167,8435,1044,9479,0.0445781,0.0804578,-0.995761,0
4838,3097,32,375,3121,53,220,11736,1629,13365,0.0426166,0.101179,-0.993955,0
5514,3175,34,406,3028,40,162,12359,1137,13496,0.0441403,0.0793046,-0.995873,0
3536,2584,30,370,2782,40,177,9519,1124,10643,0.0483794,0.0847421,-0.995228,0
3484,2311,23,308,2275,31,170,8602,1087,9689,0.0419942,0.0746036,-0.996329,0
4671,2833,31,342,2768,51,197,10893,1551,12444,0.0418585,0.0727356,-0.996472,0
4483,2974,31,345,2825,48,197,10903,1390,12293,0.0413441,0.074599,-0.996356,0
4580,2831,31,341,2833,59,193,10868,1372,12240,0.0383811,0.0703548,-0.996784,0
5097,3303,33,405,3234,55,219,12346,1572,13918,0.0386098,0.0653264,-0.997116,0
3575,2194,22,272,2120,40,147,8370,1039,9409,0.0463659,0.0888907,-0.994962,0
4546,2980,35,377,2863,83,252,11136,1609,12745,0.0414739,0.0690729,-0.996749,0
4626,2886,35,359,2858,67,199,11030,1337,12367,0.0404511,0.067684,-0.996886,0
4901,3219,40,429,3146,60,200,11995,1524,13519,0.0402559,0.075721,-0.996316,0
5119,3237,40,392,3149,66,223,12226,1539,13765,0.0442468,0.0897163,-0.994984,0
3547,2356,23,301,2174,37,177,8615,1085,9700,0.0448636,0.0771757,-0.996008,0
4673,3051,37,409,2844,68,224,11306,1547,12853,0.038877,0.089787,-0.995202,0
4857,3206,41,512,3284,44,231,12175,1340,13515,0.0389565,0.073037,-0.996568,0
4742,3183,39,437,3139,77,192,11809,1112,12921,0.0443378,0.0835266,-0.995519,0
3223,2012,21,244,1995,46,163,7704,941,8645,0.0431548,0.079095,-0.995933,0
4584,2914,30,343,2831,54,201,10957,1582,12539,0.0422888,0.0686917,-0.996741,0
4489,2918,31,406,3110,67,193,11214,1221,12435,0.0409254,0.0809371,-0.995879,0
2689,1664,41,208,1571,24,116,6313,776,7089,0.042312,0.0722094,-0.996492,0
4639,2922,31,345,2832,43,213,11025,1391,12416,0.0399464,0.0979549,-0.994389,0
4553,2925,30,337,2839,41,189,10914,1375,12289,0.0416503,0.0782361,-0.996065,0
4529,2990,32,383,2898,89,255,11176,1135,12311,0.0422672,0.0926615,-0.9948,0
3349,2051,21,241,2027,40,137,7866,1042,8908,0.0461977,0.0659437,-0.996754,0
4597,2875,31,353,2898,43,194,10991,1354,12345,0.0396945,0.0769413,-0.996245,0
4656,2856,40,353,2802,53,218,10978,1446,12424,0.042496,0.0876641,-0.995243,0
4668,2825,31,351,2912,52,229,11068,1523,12591,0.0463514,0.0844305,-0.995351,0
4547,2784,30,340,2803,54,200,10758,1522,12280,0.0423379,0.0511854,-0.997791,0
4635,2807,30,345,3007,62,192,11078,1378,12456,0.0376512,0.0718833,-0.996702,0
3213,2030,21,277,1995,28,144,7708,1069,8777,0.0469161,-0.0162426,-0.998767,0
5148,3244,33,435,3115,54,224,12253,1522,13775,0.0367294,0.0596777,-0.997542,0
5144,3372,34,448,3193,54,252,12497,1171,13668,0.0408615,0.0745621,-0.996379,0
3332,2217,28,272,2033,41,152,8075,1037,9112,0.0379381,0.066932,-0.997036,0
5525,3198,33,438,3254,45,206,12699,1638,14337,0.0461831,0.0779188,-0.99589,0
4787,3132,30,391,2611,49,139,11139,1008,12147,0.043175,0.0918583,-0.994836,0
4446,2655,29,373,2542,43,179,10267,1257,11524,0.0399813,0.081168,-0.995898,0
4764,2938,32,345,3283,51,196,11609,1344,12953,0.0384497,0.0652486,-0.997128,0
4844,2930,30,343,2796,39,202,11184,1478,12662,0.0353737,0.073564,-0.996663,1
5100,3237,31,356,2804,59,225,11812,1365,13177,0.0397286,0.0740294,-0.996464,1
4601,2888,31,382,2841,51,190,10984,1264,12248,0.0419254,0.0662171,-0.996925,1
3780,2060,23,241,1972,54,136,8266,973,9239,0.0419261,0.0692326,-0.996719,1
4802,2845,31,391,2744,54,220,11087,1643,12730,0.041493,0.0741061,-0.996387,1
4858,3121,32,343,2866,61,192,11473,1283,12756,0.0339053,0.0897958,-0.995383,1
3242,2041,23,248,2031,31,134,7750,972,8722,0.039533,0.0779522,-0.996173,1
4516,2825,28,312,2513,51,206,10451,1218,11669,0.0415365,0.0750944,-0.996311,1
5100,2660,29,313,2537,48,199,10886,1284,12170,0.0387642,0.0927639,-0.994933,1
4074,2668,28,366,1907,34,150,9227,935,10162,0.0384606,0.0909442,-0.995113,1
3261,1910,19,210,1701,29,115,7245,827,8072,0.04001,0.0812485,-0.995891,1
5019,3141,35,378,3045,48,213,11879,1651,13530,0.0380397,0.0949103,-0.994759,1
3882,2159,24,285,2138,54,146,8688,1146,9834,0.0356048,0.0961917,-0.994726,1
4831,3043,31,350,3017,58,192,11522,1568,13090,0.0426557,0.0820358,-0.995716,1
4654,2824,30,339,2847,73,245,11012,1337,12349,0.038974,0.0637769,-0.997203,1
3792,2083,27,285,2091,36,153,8467,1009,9476,0.0398716,0.0665077,-0.996989,1
4281,2669,29,361,2506,55,192,10093,1603,11696,0.0383625,0.0677094,-0.996968,1
5270,3156,37,385,3193,49,233,12323,1733,14056,0.0403659,0.0774319,-0.99618,1
3679,2173,23,281,2221,47,165,8589,1198,9787,0.0956739,0.00444884,-0.995403,1
3716,2279,23,310,2234,41,189,8792,1042,9834,0.0385408,0.0846454,-0.995666,1
4562,2853,29,385,2807,43,240,10919,1385,12304,0.0401881,0.0663617,-0.996986,1
4630,2882,31,430,2809,60,227,11069,1478,12547,0.0389506,0.0760022,-0.996347,1
4713,3055,32,404,2726,39,146,11115,985,12100,0.037331,0.0836453,-0.995796,1
3276,2235,22,276,2045,35,160,8049,1036,9085,0.0393689,0.0871688,-0.995415,1
5246,3237,34,421,3259,51,239,12487,1501,13988,0.037011,0.079589,-0.996141,1
3289,2073,22,269,2247,45,138,8083,947,9030,0.0377705,0.0603346,-0.997463,1
5006,3151,31,456,3004,50,248,11946,1368,13314,0.0385673,0.0710219,-0.996729,1
4607,2893,32,420,2833,60,214,11059,1417,12476,0.0381631,0.0719921,-0.996675,1
3275,2088,21,317,2082,33,135,7951,989,8940,0.0412661,0.0722679,-0.996531,1
5232,3330,52,521,3224,90,263,12712,1498,14210,0.0358876,0.0628319,-0.997379,1
5238,3302,30,394,2904,48,225,12141,1271,13412,0.0381754,0.0734066,-0.996571,1
4117,2669,28,365,2627,48,205,10059,1267,11326,0.0370646,0.0828393,-0.995874,1
4131,2670,28,358,2618,49,213,10067,1229,11296,0.0375883,0.0720042,-0.996696,1
5067,3244,33,439,3242,64,263,12352,1309,13661,0.0390207,0.0948551,-0.994726,1
4500,2996,37,403,2817,67,233,11053,1359,12412,0.0388238,0.0722368,-0.996631,1
4602,2963,40,361,2824,59,199,11048,1325,12373,0.0416914,0.0768318,-0.996172,1
4134,2618,33,322,2563,65,183,9918,1261,11179,0.0382809,0.0642607,-0.997199,1
4902,3053,31,385,2890,57,229,11547,1390,12937,0.0413756,0.0785784,-0.996049,1
4828,2979,29,414,2932,62,214,11458,1209,12667,0.040873,0.075742,-0.996289,1
4184,2901,29,365,2627,42,183,10331,1445,11776,0.0278925,0.0692991,-0.997206,1
4292,2766,29,331,2686,84,206,10394,1359,11753,0.0266066,0.0934158,-0.995272,1
4209,2622,27,349,2586,48,204,10045,1287,11332,0.0394696,0.0568854,-0.9976,1
4588,3036,30,394,2909,57,225,11239,1369,12608,0.0402132,0.0634259,-0.997176,1
4589,2917,30,397,2888,58,218,11097,1469,12566,0.0415865,0.0755901,-0.996271,1
4164,2701,29,368,2583,61,200,10106,1258,11364,0.0363389,0.0671134,-0.997083,1
5212,3311,34,442,3273,61,251,12584,1556,14140,0.0355023,0.0853683,-0.995717,1
3475,2255,24,306,2411,47,169,8687,1119,9806,0.0478044,-0.0193595,-0.998669,1
4690,2916,36,395,2843,54,226,11160,1497,12657,0.0378585,0.0577003,-0.997616,1
5262,3206,35,433,3229,69,238,12472,1636,14108,0.0360069,0.0893213,-0.995352,1
3610,2347,24,267,2147,44,147,8586,1168,9754,0.0409379,-0.026779,-0.998803,1
3532,2248,23,296,2226,34,147,8506,1012,9518,0.0366698,0.0830138,-0.995874,1
5300,3070,30,438,2836,63,218,11955,1555,13510,0.0416298,0.0861704,-0.99541,1
4661,2996,32,411,2938,42,233,11313,1405,12718,0.039622,0.080871,-0.995937,1
4702,3482,29,379,2781,39,142,11554,1075,12629,0.0385651,0.0490954,-0.998049,1
3273,2100,22,322,2076,63,161,8017,983,9000,0.0415662,0.0811449,-0.995835,1
4851,2820,27,378,2679,55,209,11019,1316,12335,0.0306502,0.0519695,-0.998178,1
5212,3622,35,427,3317,69,260,12942,1615,14557,0.0365379,0.0677684,-0.997032,1
4338,2282,24,273,1833,31,117,8898,951,9849,0.0381829,0.0886953,-0.995327,1
1857,1207,13,141,1152,21,78,4469,552,5021,0.039385,0.0829188,-0.995778,1
2361,1601,16,186,1529,22,100,5815,658,6473,0.0432818,0.0846376,-0.995471,1
5271,3272,30,358,3393,73,240,12637,1431,14068,0.0451945,0.0904268,-0.994877,1
4774,3048,51,382,3037,73,266,11631,1149,12780,0.0401753,0.0649461,-0.99708,1
4242,2779,27,427,2797,54,213,10539,1289,11828,0.0344149,0.0668899,-0.997167,1
4261,3009,29,374,2720,56,212,10661,1266,11927,0.0391935,0.0841965,-0.995678,1
3861,2587,26,343,2551,48,188,9604,1222,10826,0.0385318,0.0907559,-0.995127,1
3850,2840,27,316,2501,40,174,9748,1177,10925,0.0415835,0.073102,-0.996457,1
3971,2532,25,339,2495,35,173,9570,1158,10728,0.0403227,0.0910195,-0.995032,1
4081,2630,25,306,2523,46,173,9784,1138,10922,0.0416699,0.125844,-0.991175,1
4721,3079,29,366,3085,55,209,11544,1445,12989,0.0470639,0.137604,-0.989369,1
3408,2220,21,263,2181,46,149,8288,948,9236,0.0472127,0.128223,-0.990621,1
4839,3250,40,397,3140,63,220,11949,1358,13307,0.0523404,0.142044,-0.988475,1
5292,3750,35,447,3615,42,245,13426,1285,14711,0.058459,0.193728,-0.979312,1
3710,2766,27,318,2632,34,180,9667,1038,10705,0.063994,0.175749,-0.982353,1
4673,3467,30,401,3435,48,230,12284,1457,13741,0.0657708,0.0938474,-0.993412,1
5040,3449,31,395,3423,40,225,12603,1210,13813,0.0543375,0.103638,-0.99313,1
3472,2513,23,274,2509,32,153,8976,987,9963,0.0383165,0.0318271,-0.998759,1
3401,2456,20,307,2342,26,176,8728,1011,9739,0.0373635,0.00256818,-0.999299,1
4284,3231,30,424,3086,36,232,11323,1374,12697,0.0422488,0.00121762,-0.999106,1
4344,3211,26,373,3180,35,254,11423,1325,12748,0.0529763,-0.0143309,-0.998493,1
4815,3457,27,436,3372,47,229,12383,1424,13807,0.0481471,-0.0172192,-0.998692,1
3311,2434,34,268,2336,28,149,8560,969,9529,0.0391829,-0.017873,-0.999072,1
4636,3268,27,369,3398,54,223,11975,1343,13318,0.0278825,0.0068599,-0.999588,1
4721,3194,35,375,3591,50,155,12121,996,13117,0.0226992,0.0368319,-0.999064,1
3318,2288,19,292,2243,41,175,8376,955,9331,0.0330887,0.0440556,-0.998481,1
4966,2780,30,313,2590,57,186,10922,1212,12134,0.0324591,0.0624343,-0.997521,1
4221,2541,28,303,2490,41,180,9804,1260,11064,0.0397164,0.0507831,-0.99792,1
4575,2360,28,306,2348,59,166,9842,1251,11093,0.0460371,0.0903067,-0.994849,1
4743,2464,28,305,2424,41,164,10169,1371,11540,0.0415164,0.0874171,-0.995306,1
4828,2358,31,276,2371,40,157,10061,1338,11399,0.0441679,0.0786103,-0.995926,1
5141,2615,33,311,2245,42,175,10562,1350,11912,0.0436239,0.0880366,-0.995162,1
4766,2136,26,274,2045,39,164,9450,1365,10815,0.0410823,0.0883718,-0.99524,1
3812,1507,22,195,1400,30,107,7073,970,8043,0.0281588,0.0966975,-0.994916,1
4086,2020,23,255,1916,39,157,8496,1241,9737,0.0295586,0.123186,-0.991943,1
5175,2692,29,321,2603,52,156,11028,1625,12653,0.0260598,0.137989,-0.990091,1
4486,2523,28,287,2409,46,164,9943,1507,11450,0.0255203,0.128114,-0.991431,1
4627,2475,26,288,2542,56,202,10216,1512,11728,0.0243614,0.0857613,-0.996018,1
4801,2839,27,352,2722,34,211,10986,1439,12425,0.0201374,0.0384644,-0.999057,1
4855,2949,25,345,2937,33,213,11357,1230,12587,0.0367552,0.0428704,-0.998404,1
3360,2180,19,245,1895,22,108,7829,776,8605,0.0386169,0.0398067,-0.998461,1
3752,2449,19,280,2397,25,155,9077,1065,10142,0.0435184,0.0168077,-0.998911,1
5259,3350,25,372,3365,38,211,12620,1336,13956,0.0388905,0.013103,-0.999158,1
4799,3341,26,418,3336,41,246,12207,1406,13613,0.0197303,0.00798858,-0.999773,1
4179,2332,18,270,2296,22,146,9263,960,10223,0.0219225,-0.00939556,-0.999716,1
5232,3663,30,419,3588,34,245,13211,1576,14787,0.0421626,0.0357861,-0.99847,1
4747,3576,27,427,3540,42,255,12614,1363,13977,0.0498722,0.121895,-0.991289,1
4736,3087,27,298,2574,24,171,10917,775,11692,0.0260539,0.111287,-0.993447,1
2119,1795,14,204,1670,19,126,5947,553,6500,0.0164893,0.0946855,-0.995371,1
2763,2292,38,280,2255,22,139,7789,819,8608,0.0183355,0.0881451,-0.995939,1
4848,3964,27,483,4028,50,292,13692,1187,14879,0.0126481,0.0927796,-0.995606,1
4374,2967,22,316,2930,29,178,10816,967,11783,0.0160397,0.0827385,-0.996442,1
5166,4367,26,484,4536,62,297,14938,1542,16480,0.0142355,0.0332544,-0.999345,1
5366,4690,27,491,3715,48,198,14535,1024,15559,0.010462,0.0289803,-0.999525,1
3068,2522,15,300,2499,29,174,8607,841,9448,0.0391704,-0.0106433,-0.999176,1
5838,4467,25,491,4289,108,338,15556,1952,17508,-0.0199619,-0.0676838,-0.997507,1
4170,3108,17,344,3004,38,193,10874,997,11871,-0.0392744,-0.0531493,-0.997814,1
7195,5352,35,613,3827,45,230,17297,1052,18349,-0.00728611,-0.0742649,-0.997212,1
3227,2521,14,298,2502,36,189,8787,795,9582,0.00837729,-0.108669,-0.994043,1
3705,2927,17,307,2715,31,192,9894,906,10800,0.00540217,-0.124885,-0.992157,1
3493,2627,18,293,2664,26,170,9291,878,10169,0.00668286,-0.148123,-0.988946,1
5435,3972,24,509,3916,41,283,14180,1442,15622,-0.00560349,-0.141692,-0.989895,1
5202,3770,24,469,3139,29,194,12827,1007,13834,-0.0235995,-0.124704,-0.991913,1
3501,2388,16,299,2333,26,203,8766,943,9709,-0.0105872,-0.124566,-0.992155,1
3334,2397,17,275,2314,44,173,8554,936,9490,-0.0167562,-0.113114,-0.993441,1
5815,3618,34,442,3336,68,323,13636,1196,14832,-0.0259203,-0.0744916,-0.996885,1
3119,2360,17,219,1808,24,115,7662,756,8418,-0.016962,-0.109145,-0.993881,1
5236,3239,27,404,3197,56,219,12378,1406,13784,-0.00383443,-0.0595601,-0.998217,1
5083,3347,29,427,3271,50,252,12459,1378,13837,0.0015538,-0.069258,-0.997598,1
5044,3364,27,422,2739,29,172,11797,962,12759,0.00936753,-0.0467422,-0.998863,1
3292,2281,17,287,2344,25,147,8393,1032,9425,0.00535737,-0.0415545,-0.999122,1
4776,3572,26,430,3379,46,222,12451,1442,13893,-0.0142335,-0.023306,-0.999627,1
5189,3927,27,480,3761,53,288,13725,1323,15048,-0.0310221,-0.0280362,-0.999125,1
3524,2787,22,347,2708,48,180,9616,1025,10641,-0.0286452,-0.00632428,-0.99957,1
5101,3911,30,447,3571,49,260,13369,1069,14438,-0.0143488,0.037163,-0.999206,1
4021,2666,17,307,2488,27,174,9700,1006,10706,-0.00866466,0.0255829,-0.999635,1
4088,3200,23,382,3194,30,231,11148,1255,12403,-0.0088803,0.0136571,-0.999868,1
4543,3164,25,412,3111,40,220,11515,1390,12905,-0.00727034,0.0279349,-0.999583,1
5664,3693,30,440,3742,53,247,13869,1715,15584,-0.0297082,0.217482,-0.975612,1
3659,2302,18,259,1973,32,150,8393,969,9362,-0.0175891,0.137423,-0.990356,1
1689,1182,10,150,1134,11,84,4260,549,4809,-0.0133115,0.075334,-0.99707,1
5309,3484,28,449,3380,70,268,12988,1535,14523,-0.0108578,0.10534,-0.994377,1
4822,3320,26,414,3219,50,249,12100,1496,13596,-0.00380084,0.0951797,-0.995453,1
4700,3795,26,482,3725,44,249,13021,1729,14750,0.0222567,0.0922244,-0.995489,1
3619,2739,22,307,2673,46,198,9604,1153,10757,0.0143959,0.0576161,-0.998235,1
3360,2891,20,328,2792,34,185,9610,1164,10774,0.00646241,0.0291497,-0.999554,1
3334,2867,20,309,2692,30,180,9432,1163,10595,-0.0044047,0.0112922,-0.999926,1
4823,3886,31,425,3791,75,250,13281,1686,14967,-0.0129246,-0.00636398,-0.999896,1
5270,4334,33,495,4314,61,273,14780,1724,16504,-0.00291013,-0.0132931,-0.999907,1
3633,3061,23,332,3028,53,199,10329,1234,11563,-0.00205219,-0.0206451,-0.999785,1
4308,3525,28,403,3499,57,222,12042,1437,13479,-0.00272191,-0.00705429,-0.999972,1
5318,4298,33,502,4215,69,279,14714,1661,16375,-0.00567909,0.00790388,-0.999952,1
4839,3780,34,470,3709,68,256,13156,1495,14651,-0.00938959,0.0287486,-0.999543,1
5271,4330,32,476,4263,76,270,14718,1452,16170,-0.00461323,0.00817913,-0.999956,1
3538,2893,23,329,2812,34,194,9823,1131,10954,0.00195868,-0.00498106,-0.999986,1
5665,4303,33,516,4215,69,275,15076,1329,16405,0.0044715,-0.0101444,-0.999938,1
3714,3010,24,338,2949,47,196,10278,1019,11297,0.0118816,-0.0357566,-0.99929,1
5393,4050,33,457,3967,70,289,14259,1436,15695,-0.00184672,-0.0223854,-0.999748,1
5205,3876,23,362,2891,62,183,12602,991,13593,0.00249478,-0.0255503,-0.99967,1
2749,2354,16,308,2446,23,162,8058,848,8906,-0.0110731,-0.0260885,-0.999598,1
5325,4611,29,496,4092,39,285,14877,1399,16276,-0.0199487,0.0169487,-0.999657,1
4657,3747,35,553,3704,28,176,12900,1032,13932,-0.0171034,0.0194207,-0.999665,1
2478,1786,15,199,1741,19,113,6351,750,7101,-0.00639641,0.0232568,-0.999709,1
5565,3435,37,397,3273,65,214,12986,1278,14264,0.00110739,0.0627929,-0.998026,1
5177,3090,30,352,2983,52,199,11883,1584,13467,-0.00324799,0.0924778,-0.995709,1
5431,2725,37,328,2475,35,130,11161,1112,12273,-0.00663358,0.0613327,-0.998095,1
4271,1907,28,238,1823,47,153,8467,1386,9853,0.00423559,0.0715843,-0.997426,1
4767,1840,27,261,1800,40,137,8872,1365,10237,0.0132509,0.0707883,-0.997403,1
4431,1449,34,226,1358,45,137,7680,1657,9337,0.0188585,0.0394523,-0.999044,1
4501,1298,32,171,1180,44,100,7326,1685,9011,0.0358201,0.0248137,-0.99905,1
4223,1154,30,164,1124,51,96,6842,1533,8375,0.066652,0.0282032,-0.997378,1
4634,1416,31,229,1417,72,127,7926,1361,9287,0.061348,-0.00114263,-0.998116,1
4359,1507,25,240,1550,41,143,7865,1434,9299,0.0725772,-0.13933,-0.987583,1
1944,764,12,111,747,16,53,3647,617,4264,0.0448419,-0.138872,-0.989295,1
4846,2154,46,286,2126,48,141,9647,1482,11129,0.0485816,-0.0833604,-0.995335,1
5608,2460,30,314,2430,41,194,11077,1469,12546,0.0416236,-0.0169553,-0.998989,1
4848,1873,20,210,1706,21,115,8793,1030,9823,0.0146051,0.0107964,-0.999835,1
3877,2250,25,272,2209,30,157,8820,1218,10038,0.0403699,-0.0188707,-0.999007,1
4946,2996,25,380,3397,57,302,12103,1882,13985,0.0200315,0.0203088,-0.999593,1
5797,3089,19,271,2268,44,154,11642,1040,12682,0.0344644,0.0248335,-0.999098,1
2707,1856,15,217,1628,20,104,6547,643,7190,0.00547278,0.00919755,-0.999943,1
5154,3575,31,411,3581,44,228,13024,1483,14507,-0.0156886,-0.01512,-0.999763,1
5132,3704,28,402,3634,45,232,13177,1524,14701,-0.00590682,-0.0350965,-0.999367,1
3682,2637,23,345,2603,38,212,9540,1056,10596,0.0505941,-0.0515789,-0.997387,1
5276,3985,32,485,3862,87,252,13979,1524,15503,0.0269135,-0.0404953,-0.998817,1
3696,2706,21,304,2641,58,203,9629,1029,10658,0.0383445,-0.0302305,-0.998807,1
5555,4470,29,561,4301,40,300,15256,1972,17228,0.0223956,0.0752726,-0.996911,1
4801,2967,18,327,2281,26,144,10564,739,11303,0.00837467,0.0703502,-0.997487,1
2518,1690,10,183,1588,23,103,6115,510,6625,0.0325423,-0.0120107,-0.999398,1
5748,4382,27,559,3866,44,229,14855,1035,15890,-0.024395,0.0488529,-0.998508,1
3115,2337,13,296,2402,24,171,8358,803,9161,-0.0201091,-0.0113873,-0.999733,1
5505,4185,24,528,4073,42,302,14659,1407,16066,-0.0279226,0.0157872,-0.999485,1
5243,3866,25,458,2991,40,171,12794,1003,13797,-0.0112106,-0.0704974,-0.997449,1
2928,2058,14,232,1920,23,151,7326,823,8149,-0.0123316,-0.112234,-0.993606,1
5406,3507,36,492,3453,53,246,13193,1188,14381,-0.0237853,-0.080545,-0.996467,1
3671,2493,19,285,2472,36,161,9137,978,10115,-0.0113704,-0.112162,-0.993625,1
5310,3544,34,479,3488,39,238,13132,1391,14523,-0.0118775,-0.086138,-0.996213,1
5209,3320,28,383,3205,37,237,12419,1218,13637,-0.0150693,-0.0536922,-0.998444,1
3547,2345,20,296,2332,40,176,8756,970,9726,-0.0184453,-0.0888692,-0.995873,1
5088,3946,28,458,3955,59,318,13852,1355,15207,-0.000585727,-0.00258103,-0.999997,1
4597,2548,19,323,2553,35,162,10237,960,11197,0.000805301,-0.0156261,-0.999877,1
4916,3523,28,394,3501,39,245,12646,1683,14329,0.00523588,-0.0456295,-0.998945,1
4095,2588,18,298,2519,29,163,9710,1045,10755,-0.0082823,-0.0566867,-0.998358,1
5463,3993,26,439,3837,46,251,14055,1445,15500,-0.0368905,0.0760873,-0.996419,1
4488,2690,15,229,1987,22,128,9559,822,10381,-0.0458567,0.0471882,-0.997833,1
1880,1314,9,147,1321,15,85,4771,553,5324,-0.0364477,-0.0207452,-0.99912,1
1709,1205,9,135,1196,11,77,4342,541,4883,-0.0399872,-0.0240927,-0.99891,1
5303,3385,27,426,3409,50,248,12848,1529,14377,-0.0479032,-0.0129327,-0.998768,1
4971,3638,27,448,3520,66,261,12931,1578,14509,-0.0560409,0.106265,-0.992757,1
4100,2571,25,387,1999,33,139,9254,824,10078,-0.0477608,0.039263,-0.998087,1
3368,1942,14,228,1855,23,137,7567,837,8404,-0.0412214,0.0235103,-0.998873,1
2051,1456,11,164,1434,22,92,5230,648,5878,-0.0369307,0.00524194,-0.999304,1
5935,3738,33,426,3751,58,256,14197,1636,15833,-0.0170664,0.0174108,-0.999703,1
5145,3470,18,306,2617,37,186,11779,1013,12792,-0.00108039,0.0206906,-0.999785,1
3321,2202,15,288,2212,26,154,8218,850,9068,-0.016779,-0.0161818,-0.999728,1
1381,1086,10,119,991,20,70,3677,398,4075,-0.019382,-0.00595508,-0.999795,1
5181,3966,35,507,3956,62,289,13996,1654,15650,-0.00582126,0.0415404,-0.99912,1
5169,3891,27,538,3128,26,193,12972,1033,14005,-0.0110806,0.0405163,-0.999118,1
3287,2488,18,302,2474,25,177,8771,1010,9781,-0.0269017,0.021793,-0.9994,1
5055,3748,32,495,3586,75,265,13256,1577,14833,-0.040761,0.0164184,-0.999034,1
5415,3567,34,404,3510,76,226,13232,1307,14539,-0.0601015,0.00735291,-0.998165,1
4522,3289,28,362,3112,35,196,11544,1023,12567,-0.0476869,-0.00377139,-0.998855,1
3004,2137,19,247,2059,24,133,7623,946,8569,-0.046821,-0.0133994,-0.998813,1
5078,3670,35,480,3537,67,275,13142,1670,14812,-0.0389816,0.0016873,-0.999239,1
5070,3881,37,529,3374,36,206,13133,1013,14146,-0.0244619,0.0150791,-0.999587,1
2662,2015,21,271,1876,29,148,7022,794,7816,-0.0344265,-0.0182601,-0.99924,1
5096,3914,31,493,3831,60,289,13714,1537,15251,-0.0270606,0.0122044,-0.999559,1
5328,4148,35,498,3177,33,181,13400,1030,14430,-0.0335299,-0.000150538,-0.999438,1
3783,2870,25,365,2794,49,185,10071,1021,11092,-0.0361114,-0.0272816,-0.998975,1
4822,3916,29,532,3938,42,283,13562,1282,14844,-0.031583,0.0376617,-0.998791,1
4336,3525,24,425,3480,32,227,12049,1255,13304,-0.036087,0.0564917,-0.997751,1
3960,3072,23,368,3002,30,202,10657,1099,11756,-0.0339173,0.0390184,-0.998663,1
5103,3670,30,407,3575,32,208,13025,982,14007,-0.0240561,0.0189171,-0.999531,1
3190,2247,18,278,2207,24,165,8129,975,9104,-0.0237864,-0.0151907,-0.999602,1
4953,3276,31,381,3067,31,142,11881,950,12831,-0.00818171,0.0260794,-0.999627,1
4412,2561,27,296,2712,50,227,10285,1384,11669,-0.00127587,0.0191052,-0.999817,1
5127,2753,31,306,2726,47,177,11167,1664,12831,0.0182966,0.0271648,-0.999464,1
5630,3120,29,364,1785,41,123,11092,1069,12161,0.0111925,0.0296572,-0.999498,1
3306,1454,22,182,1405,32,107,6508,1044,7552,-0.002958,0.043371,-0.999055,1
5488,1963,34,252,1903,79,149,9868,1582,11450,-0.0151894,0.0562254,-0.998302,1
5917,1672,24,196,1168,34,97,9108,1120,10228,0.00111185,0.0466802,-0.998909,1
2992,826,20,113,807,21,62,4841,963,5804,0.00485675,0.0372485,-0.999294,1
4632,1263,29,186,1174,36,121,7441,1369,8810,0.0119544,0.0366096,-0.999258,1
4390,1510,29,218,1556,37,140,7880,1486,9366,0.0287713,0.0112043,-0.999523,1
4902,1783,29,280,1775,58,156,8983,1489,10472,-0.0119686,0.0675428,-0.997645,1
5203,2148,29,294,1929,39,140,9782,1533,11315,-0.0159071,0.0520518,-0.998518,1
4826,2261,27,348,2270,39,182,9953,1500,11453,-0.0416439,0.0460051,-0.998073,1
3386,1921,20,211,1785,23,120,7466,1160,8626,-0.00937877,0.00909651,-0.999915,1
2626,1534,14,174,1509,19,100,5976,865,6841,-0.00649642,0.00270648,-0.999975,1
5125,3263,30,403,3095,36,211,12163,1517,13680,-0.0109457,0.0477841,-0.998798,1
4854,3264,27,352,3213,53,201,11964,1222,13186,0.00929103,0.017865,-0.999797,1
3296,2608,18,330,2673,35,189,9149,992,10141,-0.0131394,0.0496351,-0.998681,1
5151,4303,30,548,4199,53,279,14563,1062,15625,-0.014605,0.0619927,-0.99797,1
3964,3726,24,387,3433,47,240,11821,787,12608,0.00561747,0.0374863,-0.999281,1
3789,3344,17,408,3272,49,217,11096,1100,12196,0.0302885,0.00314088,-0.999536,1
6340,5289,28,584,4145,43,241,16670,1066,17736,0.000846124,-0.0118048,-0.99993,1
3301,2719,16,315,2767,34,171,9323,814,10137,-0.0143419,-0.0922416,-0.995633,1
6436,5244,34,618,4212,50,229,16823,1115,17938,-0.00952991,-0.0760127,-0.997061,1
3165,2560,14,284,2521,36,173,8753,882,9635,-0.0284983,-0.102806,-0.994293,1
5270,4523,28,609,4220,57,295,15002,1547,16549,-0.0247582,-0.0780774,-0.99664,1
6913,4093,26,477,3394,37,200,15140,1009,16149,-0.0344011,-0.0672542,-0.997143,1
2870,2230,15,256,2196,28,149,7744,796,8540,-0.046219,-0.0780137,-0.99588,1
5757,4308,32,473,3981,62,287,14900,1368,16268,-0.0570476,-0.0597237,-0.996584,1
3610,2783,20,339,2737,41,188,9718,1020,10738,-0.0554045,-0.0760222,-0.995566,1
5043,3833,28,464,3833,61,259,13521,1365,14886,-0.0580489,-0.0430853,-0.997384,1
5752,4353,31,529,4069,30,215,14979,1141,16120,-0.042285,-0.0863157,-0.99537,1
5157,3702,26,457,3475,31,190,13038,1077,14115,-0.0327756,-0.0858531,-0.995769,1
5516,4091,27,499,3954,53,289,14429,1749,16178,-0.015133,0.0810746,-0.996593,1
3188,2179,18,277,1805,17,133,7617,703,8320,-0.0224143,0.000725831,-0.999749,1
1927,1185,11,141,1149,17,77,4507,458,4965,-0.0348193,-0.028011,-0.999001,1
4976,3302,28,385,3307,64,227,12289,1371,13660,-0.01813,0.0245238,-0.999535,1
5000,3330,26,383,3222,40,234,12235,1297,13532,-0.0297196,0.0522965,-0.998189,1
4884,3129,22,376,3022,38,203,11674,1356,13030,-0.0335328,0.0746013,-0.99665,1
4357,3098,27,408,3055,61,234,11240,1532,12772,-0.0308262,0.0683058,-0.997188,1
4399,3018,26,358,2955,48,208,11012,1365,12377,-0.0190575,0.0913096,-0.99564,1
4322,2950,29,361,2868,79,205,10814,1340,12154,-0.00797609,0.0774927,-0.996961,1
4620,3055,24,330,2949,76,189,11243,1386,12629,0.00314463,0.108987,-0.994038,1
4437,2970,30,351,2914,59,203,10964,1553,12517,-0.0265151,0.0791488,-0.99651,1
4416,3004,28,398,2919,56,193,11014,1496,12510,-0.0197539,0.0858824,-0.99611,1
3965,2558,21,327,2607,35,193,9706,1752,11458,-0.0375027,0.0850991,-0.995667,1
4236,2799,25,357,3314,100,234,11065,1899,12964,-0.0581331,0.103419,-0.992938,1
4201,2719,25,319,2241,34,122,9661,1400,11061,-0.0361401,0.107119,-0.993589,1
2802,1893,17,220,1814,45,154,6945,899,7844,-0.00515228,0.0588519,-0.998253,1
4370,3028,29,359,2897,34,193,10910,1373,12283,-0.0194485,0.0572221,-0.998172,1
4535,2987,27,375,3385,40,256,11605,1446,13051,-0.0109962,0.0301327,-0.999485,1
3138,2093,19,243,2049,21,136,7699,964,8663,-0.0337565,-0.00262178,-0.999426,1
4443,3045,30,413,2926,82,232,11171,1352,12523,-0.0160622,0.0232144,-0.999601,1
4703,3250,29,416,3279,41,278,11996,1400,13396,-0.00299468,0.0454534,-0.998962,1
5451,3816,32,497,3624,49,283,13752,1553,15305,-0.017815,0.0849533,-0.996226,1
4074,2848,24,372,2792,28,219,10357,1207,11564,-0.0476731,0.0913591,-0.994676,1
2993,2249,16,295,2217,28,163,7961,1250,9211,0.0345439,0.009059,-0.999362,1
5147,3785,55,492,3783,41,255,13558,1514,15072,-0.025149,0.0607012,-0.997839,1
5003,3277,25,403,3259,93,234,12294,1557,13851,-0.0173593,0.0116128,-0.999782,1
3207,2037,19,230,2085,28,147,7753,1037,8790,-0.00968545,-0.0103064,-0.9999,1
4639,2814,29,323,2666,35,190,10696,1785,12481,-0.00498775,-0.0247744,-0.999681,1
4323,2683,25,302,2550,35,174,10092,1528,11620,-0.0139784,-0.0569675,-0.998278,1
4572,2575,29,296,2499,29,175,10175,1149,11324,-0.00544096,-0.0453624,-0.998956,1
5096,2943,25,366,3018,59,278,11785,1723,13508,-0.0115776,-0.0425359,-0.999028,1
4933,2793,27,344,2856,42,180,11175,1916,13091,-0.00311031,-0.0491524,-0.998787,1
3603,1847,20,243,1813,28,122,7676,1094,8770,5.22651e-05,-0.0436017,-0.999049,1
3408,1841,18,222,1823,24,148,7484,1435,8919,0.0115844,-0.0780866,-0.996879,1
4650,2455,26,304,2317,33,184,9969,1802,11771,0.00381314,-0.0114275,-0.999928,1
4616,2386,26,272,2283,32,152,9767,1517,11284,0.00581541,-0.00124136,-0.999982,1
5156,2587,27,320,3157,41,187,11475,2093,13568,0.0190303,-0.0197534,-0.999624,1
3718,1743,23,213,1696,37,128,7558,1449,9007,0.00763361,-0.0768727,-0.997012,1
4834,2311,30,290,2228,45,166,9904,1627,11531,0.0131685,-7.08288e-05,-0.999913,1
5418,2560,31,301,2130,26,111,10577,1398,11975,-0.00199123,0.000203427,-0.999998,1
4300,1828,24,207,1738,35,118,8250,1459,9709,-0.00784679,0.00890782,-0.99993,1
5342,2009,36,254,1927,44,153,9765,1649,11414,-0.00250018,-0.00310504,-0.999992,1
5324,1851,29,264,1940,39,166,9613,1524,11137,-0.00747436,-0.0228489,-0.999711,1
5240,1891,28,292,1949,47,113,9560,1135,10695,-0.00999838,-0.0415873,-0.999085,1
3371,1255,19,170,1210,24,102,6151,1074,7225,-0.00231093,-0.0614607,-0.998107,1
4484,1563,25,218,1473,32,127,7922,1604,9526,0.000497685,-0.0427405,-0.999086,1
4609,1643,29,235,1546,36,145,8243,1607,9850,0.00183789,-0.0698301,-0.997557,1
4729,1640,26,255,1453,31,106,8240,1453,9693,0.00892201,-0.0493262,-0.998743,1
4892,1548,29,272,1537,68,121,8467,2032,10499,0.00725039,-0.0984817,-0.995112,1
4759,1533,27,195,1445,38,124,8121,2745,10866,0.00882318,-0.146935,-0.989107,1
4225,1368,26,192,1332,35,102,7280,2927,10207,0.00151391,-0.146087,-0.989271,1
4175,1569,25,192,1479,34,109,7583,2183,9766,0.00786361,-0.0694269,-0.997556,1
4829,2002,28,245,2069,82,166,9421,2156,11577,0.0131986,-0.022904,-0.99965,1
4373,2016,25,253,1969,34,136,8806,1566,10372,0.00151757,-0.0204042,-0.999791,1
4657,2491,35,369,2440,44,200,10236,1631,11867,-0.0223849,-0.0296411,-0.99931,1
4874,2601,29,376,2520,47,214,10661,1117,11778,-0.0320923,-0.028902,-0.999067,1
3327,1884,24,278,1900,32,140,7585,1054,8639,-0.0193306,-0.0418819,-0.998936,1
5176,2584,26,358,2578,37,208,10967,1369,12336,-0.0366571,-0.0184922,-0.999157,1
4409,2754,27,400,2732,35,196,10553,1358,11911,-0.0200993,-0.0513546,-0.998478,1
3286,2009,18,226,1901,30,124,7594,994,8588,-0.0122214,-0.0641999,-0.997862,1
4334,3021,26,418,2907,41,225,10972,1426,12398,0.0156197,-0.0188552,-0.9997,1
4572,3296,28,409,3287,44,242,11878,1458,13336,0.0243643,-0.0027804,-0.999699,1
4750,3858,27,503,3785,46,308,13277,1158,14435,0.0138962,0.0189503,-0.999724,1
3531,3091,18,382,3109,35,199,10365,1019,11384,0.046544,-0.0658645,-0.996743,1
5721,4951,39,659,4170,36,229,15805,1049,16854,0.0509429,-0.0662093,-0.996505,1
3042,2598,16,317,2605,53,179,8810,824,9634,0.0163269,-0.0861681,-0.996147,1
6185,5087,29,623,4448,65,223,16660,1285,17945,-0.0123268,-0.0685533,-0.997571,1
7525,4108,21,426,3170,38,196,15484,828,16312,-0.0503817,-0.0863402,-0.994991,1
6132,5097,26,558,4780,44,306,16943,1448,18391,-0.0576031,-0.0980306,-0.993515,1
4942,3682,20,433,3308,30,182,12597,778,13375,-0.0390501,-0.0965986,-0.994557,1
2604,2205,12,274,2230,22,158,7505,655,8160,-0.0227746,-0.0747933,-0.996939,1
4524,3606,20,477,3691,44,255,12617,1154,13771,-0.0295145,-0.0818776,-0.996205,1
4796,3149,22,355,3084,39,240,11685,1196,12881,-0.0459048,-0.0897756,-0.994904,1
2480,1826,14,223,1790,24,125,6482,674,7156,-0.0462434,-0.0685211,-0.996578,1
5332,3828,33,447,3619,46,247,13552,1546,15098,-0.0702184,-0.044624,-0.996533,1
3810,2401,22,302,2434,36,161,9166,1040,10206,-0.0694592,-0.0448318,-0.996577,1
4978,3135,27,418,3868,59,236,12721,1441,14162,-0.0675642,-0.0373996,-0.997014,1
5212,3151,21,282,2717,45,194,11622,1183,12805,-0.0568996,-0.03457,-0.997782,1
2832,1785,16,201,1812,33,129,6808,867,7675,-0.0548474,-0.0213065,-0.998267,1
3287,2203,17,266,2193,27,164,8157,1185,9342,-0.0465441,-0.0464296,-0.997837,1
4141,2816,25,411,2728,27,200,10348,1389,11737,-0.0463464,-0.000920986,-0.998925,1
4635,3694,24,361,3215,40,214,12183,1462,13645,-0.0377867,0.00772002,-0.999256,1
4601,3340,29,393,3183,43,228,11817,959,12776,-0.0506979,0.0809641,-0.995427,1
4227,2905,24,326,2789,71,189,10531,1236,11767,-0.048014,0.0703018,-0.99637,1
4429,3138,44,355,3003,53,205,11227,1331,12558,-0.0409212,0.0830863,-0.995702,1
4737,3008,27,343,2909,56,198,11278,1392,12670,-0.0379186,0.096167,-0.994643,1
4313,2870,22,346,2800,35,223,10609,1465,12074,-0.047671,0.0897856,-0.99482,1
4535,3034,22,362,2675,33,150,10811,975,11786,-0.0542742,0.0845444,-0.994941,1
3123,2347,29,269,1921,43,146,7878,1004,8882,-0.0624853,0.0699443,-0.995592,1
2965,1957,16,236,1771,45,139,7129,1053,8182,-0.0694687,0.0992506,-0.992635,1
3186,1836,21,228,1755,42,137,7205,1023,8228,-0.0757655,0.108137,-0.991245,1
3910,2379,26,292,2119,47,164,8937,1790,10727,-0.0759357,0.119698,-0.989902,1
4205,2201,25,294,2325,26,173,9249,1214,10463,-0.101529,0.0521275,-0.993466,1
3951,2117,25,292,2910,39,210,9544,1561,11105,-0.0797967,0.0770528,-0.993829,1
2960,1765,17,221,1720,51,139,6873,1192,8065,-0.0195534,0.100832,-0.994711,1
4676,2797,30,348,3241,45,208,11345,1570,12915,-0.0315396,0.0374606,-0.9988,1
5155,3027,35,355,3071,84,229,11956,1542,13498,-0.0117644,0.0305175,-0.999465,1
4841,3875,40,615,3151,46,215,12783,1199,13982,0.00651203,0.0167046,-0.999839,1
3289,2321,19,301,2365,29,154,8478,2215,10693,-0.0311835,-0.0215921,-0.999281,1
5257,4123,32,469,3907,66,253,14107,8486,22593,-0.0109453,0.0446532,-0.998943,1
2208,1638,14,192,1598,18,106,5774,4044,9818,-0.00117783,-0.0496568,-0.998766,1
3835,2692,21,302,2671,29,167,9717,1636,11353,-0.015204,-0.0123501,-0.999808,1
5167,3289,35,388,3366,60,221,12526,1794,14320,-0.0274979,0.0183243,-0.999454,1
5090,3045,28,371,2963,37,197,11731,1595,13326,-0.0432921,0.00524854,-0.999049,1
3477,1903,20,223,1831,31,120,7605,1160,8765,-0.0510066,0.00153685,-0.998697,1
5233,2643,28,344,2604,36,205,11093,1803,12896,-0.069791,-0.00374242,-0.997555,1
5362,2560,30,318,2456,44,161,10931,1876,12807,-0.0617584,-0.0122065,-0.998017,1
6350,2121,33,267,2061,45,154,11031,1672,12703,-0.0367764,-0.0219921,-0.999082,1
3663,1374,24,182,1317,30,97,6687,1831,8518,-0.0307984,-0.0306847,-0.999054,1
5824,1762,29,244,1675,35,147,9716,1822,11538,-0.0346489,-0.05176,-0.998058,1
5160,1348,28,224,943,34,84,7821,1553,9374,-0.0501834,-0.0915751,-0.994533,1
3968,941,21,128,954,26,91,6129,1385,7514,-0.0453307,-0.0543811,-0.997491,1
5348,1049,37,181,1021,35,82,7753,1785,9538,-0.0491825,-0.0350794,-0.998174,1
5036,1052,40,150,1032,34,103,7447,1906,9353,-0.0458159,-0.0171684,-0.998802,1
3269,900,19,139,789,21,78,5215,1173,6388,-0.0452762,-0.027629,-0.998592,1
3225,926,18,139,941,31,73,5353,1077,6430,-0.0335826,-0.0365508,-0.998767,1
4633,1494,34,181,1422,51,120,7935,1409,9344,-0.0511715,-0.00879441,-0.998651,1
4776,1749,37,269,1659,56,116,8662,1473,10135,-0.0548597,-0.0199719,-0.998294,1
4825,2181,33,257,1891,120,147,9454,1477,10931,-0.0633782,-0.0266723,-0.997633,1
4653,2205,28,317,2190,41,173,9607,1471,11078,-0.0662515,-0.00359466,-0.997796,1
3268,1579,19,206,1563,75,117,6827,1073,7900,-0.0598744,-0.0254049,-0.997883,1
4013,2160,26,283,1959,36,170,8647,1327,9974,-0.0562261,-0.0180215,-0.998256,1
4481,2356,36,277,2444,113,163,9870,1616,11486,-0.0642094,-0.017679,-0.99778,1
4512,2340,36,320,2389,83,168,9848,1645,11493,-0.0589349,-0.00177183,-0.99826,1
4534,2609,32,352,2332,42,172,10073,1505,11578,-0.0605438,-0.0165489,-0.998028,1
4852,2700,33,320,2535,49,191,10680,1490,12170,-0.047268,-0.0105535,-0.998827,1
3330,2040,23,243,2004,38,139,7817,1024,8841,-0.046728,-0.0326766,-0.998373,1
5018,3518,33,428,3352,61,237,12647,1626,14273,-0.0482054,-0.0349858,-0.998224,1
3713,2857,23,364,2759,32,184,9932,1105,11037,-0.0422247,-0.0542549,-0.997634,1
3924,3193,20,344,3189,60,199,10929,1045,11974,-0.0580934,-0.0276678,-0.997927,1
6161,4988,25,544,4327,39,222,16306,961,17267,-0.0527672,-0.0268109,-0.998247,1
4012,3269,21,404,3196,42,232,11176,966,12142,-0.0485388,-0.0720272,-0.996221,1
7305,4923,27,585,4803,40,222,17905,1084,18989,-0.0344416,-0.0376685,-0.998697,1
4192,3372,20,400,3324,30,202,11540,805,12345,-0.0411704,-0.086969,-0.99536,1
4867,3690,24,406,3626,46,234,12893,1233,14126,-0.0630333,-0.083592,-0.994505,1
4616,3206,25,368,3129,40,223,11607,1071,12678,-0.0735922,-0.115981,-0.990522,1
5130,3270,26,445,3187,38,216,12312,1099,13411,-0.0863313,-0.106175,-0.990593,1
3570,2293,20,288,2295,36,171,8673,966,9639,-0.0835591,-0.143049,-0.986182,1
3535,2299,19,283,2314,26,157,8633,1004,9637,-0.0746884,-0.12104,-0.989834,1
5079,3300,40,408,3196,43,238,12304,1411,13715,-0.0685132,-0.0626687,-0.99568,1
5234,3305,28,549,4594,61,263,14034,1387,15421,-0.0654868,-0.075221,-0.995014,1
3585,2339,21,286,2266,32,172,8701,1231,9932,-0.0687999,-0.123035,-0.990015,1
4993,3538,27,427,3776,46,296,13103,1556,14659,-0.0510985,-0.110739,-0.992535,1
5555,3411,27,366,3229,38,208,12834,1355,14189,-0.052449,-0.115467,-0.991926,1
3509,2621,48,307,2470,27,184,9166,1103,10269,-0.0539695,-0.103603,-0.993153,1
5624,3923,28,480,3902,41,277,14275,1700,15975,-0.0418507,0.0644383,-0.997044,1
3727,2138,15,237,1969,31,130,8247,818,9065,-0.0572135,0.0648949,-0.996251,1
2012,1256,9,138,1263,13,79,4770,539,5309,-0.0624593,-0.0241898,-0.997754,1
4624,3113,23,367,2955,29,196,11307,1443,12750,-0.0707299,0.0199201,-0.997297,1
4281,2788,24,317,3082,49,240,10781,1012,11793,-0.0750984,0.0191135,-0.996993,1
3745,2366,23,274,2286,30,154,8878,1348,10226,-0.081972,0.0345966,-0.996034,1
3827,2243,21,267,2272,32,152,8814,1233,10047,-0.0698789,0.0205332,-0.997344,1
4654,3006,31,322,2699,61,181,10954,1678,12632,-0.0731482,0.0372925,-0.996624,1
3044,2087,28,224,1773,52,128,7336,1014,8350,-0.0610933,0.0463086,-0.997057,1
4367,2588,30,395,2519,69,189,10157,1489,11646,-0.0530819,0.0447409,-0.997588,1
4417,2305,24,280,2331,167,167,9691,2943,12634,-0.0628321,0.0460342,-0.996962,1
4068,2004,22,274,1979,113,173,8633,7296,15929,-0.00363129,0.0449603,-0.998982,1
2163,1014,13,124,991,68,69,4442,7776,12218,0.170188,-0.491996,-0.853801,1
4562,1991,25,302,1879,67,138,8964,17157,26121,0.249419,-0.195738,-0.948408,1
1925,684,10,87,685,35,53,3479,3961,7440,0.212951,-0.113168,-0.970487,1
1319,480,7,73,481,24,42,2426,1691,4117,0.0254073,0.0802497,-0.996451,1
5046,2297,33,322,2245,96,156,10195,7715,17910,0.0725014,0.0605696,-0.995527,1
5357,2743,36,455,2724,58,218,11591,4796,16387,-0.00645319,0.075762,-0.997105,1
2804,1559,13,210,1553,34,133,6306,4651,10957,0.0563139,0.0404268,-0.997594,1
4289,2581,21,308,2542,41,174,9956,13264,23220,0.377448,0.446066,-0.811516,1
2032,1553,10,162,1354,26,91,5228,12914,18142,0.412402,0.563925,-0.715481,1
1474,1006,9,111,993,12,63,3668,13254,16922,0.185653,0.438204,-0.879495,1
1597,1027,9,115,1007,14,64,3833,2622,6455,-0.0645117,-0.0887339,-0.993964,1
4809,3431,39,407,3244,46,247,12223,4622,16845,-0.0808427,-0.023793,-0.996443,1
4991,2746,28,405,2753,34,154,11111,1464,12575,-0.070807,0.00920861,-0.997448,1
4570,2812,33,301,2336,48,199,10299,1713,12012,-0.0524345,-0.0210306,-0.998403,1
5294,2363,28,360,2338,42,191,10616,1785,12401,-0.0321403,-0.0353503,-0.998858,1
3649,1548,19,214,1955,32,125,7542,1223,8765,-0.0230564,-0.0363482,-0.999073,1
5440,2872,61,285,2215,38,149,11060,1907,12967,-0.0238333,-0.0250799,-0.999401,1
5177,2121,28,270,2207,42,157,10002,1552,11554,-0.0274524,-0.0263973,-0.999275,1
3591,1405,19,175,1667,30,129,7016,1080,8096,-0.0301985,-0.0776653,-0.996522,1
5213,2212,27,275,2172,40,154,10093,1549,11642,-0.0103648,-0.0576028,-0.998286,1
5649,2523,30,344,2274,47,179,11046,1523,12569,0.00470398,-0.0939963,-0.995561,1
3422,1557,21,176,1411,43,98,6728,1070,7798,-0.000581774,-0.0968605,-0.995298,1
4881,2124,35,310,1999,40,188,9577,1452,11029,-0.0199862,-0.0900126,-0.99574,1
4900,2117,30,333,1965,37,183,9565,1646,11211,-0.0323797,-0.0695039,-0.997056,1
4778,1831,29,284,1753,49,141,8865,1566,10431,-0.0416562,-0.0300226,-0.998681,1
4245,1598,30,224,1510,30,113,7750,1441,9191,-0.0514958,-0.00826003,-0.998639,1
4116,1507,26,200,1566,37,144,7596,1398,8994,-0.0520866,-0.00675021,-0.99862,1
4467,1687,30,254,1573,47,129,8187,1597,9784,-0.0434427,0.0148904,-0.998945,1
4252,1391,34,220,1402,85,119,7503,1531,9034,-0.0449211,0.0419936,-0.998108,1
4225,1498,46,212,1408,37,107,7533,1548,9081,-0.026957,0.0327483,-0.9991,1
4309,1553,35,220,1454,52,120,7743,1492,9235,-0.0108011,-0.0061198,-0.999923,1
4301,1826,35,236,1794,36,130,8358,1533,9891,-0.0470995,0.117788,-0.991921,1
4456,2154,31,264,1442,34,114,8495,1068,9563,-0.0500075,0.0682341,-0.996415,1
4083,1781,20,223,1663,21,89,7880,819,8699,-0.0401719,-0.0029781,-0.999189,1
2342,1523,15,179,1526,25,118,5728,754,6482,-0.0435821,-0.000608251,-0.99905,1
5122,3768,30,468,3948,88,283,13707,1659,15366,-0.0325449,-0.0231917,-0.999201,1
5296,6005,38,738,4221,57,266,16621,1100,17721,-0.0334999,-0.0786927,-0.996336,1
2345,2090,12,258,2083,21,141,6950,648,7598,-0.042129,-0.0945835,-0.994625,1
5983,5850,28,609,5257,56,329,18112,1396,19508,-0.0591113,-0.0661755,-0.996056,1
4263,4153,25,613,4369,41,224,13688,860,14548,-0.0333584,-0.0960948,-0.994813,1
2670,2611,13,298,2652,22,171,8437,652,9089,-0.0310452,-0.106011,-0.99388,1
5044,4563,21,486,4227,38,269,14648,1119,15767,-0.0306102,-0.131266,-0.990875,1
4725,4210,20,457,4171,38,302,13923,1288,15211,-0.0278363,-0.154787,-0.987556,1
3547,2980,18,328,3027,30,188,10118,913,11031,-0.0391253,-0.154067,-0.987285,1
4022,3412,22,388,3249,37,227,11357,1042,12399,-0.047722,-0.125572,-0.990937,1
5168,4097,28,532,4339,44,175,14383,973,15356,-0.0430034,-0.109701,-0.993034,1
3583,2634,21,289,2847,35,226,9635,1019,10654,-0.0489719,-0.105201,-0.993245,1
5750,4082,30,512,3991,56,294,14715,1548,16263,-0.0337907,-0.0624342,-0.997477,1
3890,2823,23,357,2744,38,224,10099,1074,11173,-0.0382408,-0.0837395,-0.995754,1
5146,3763,25,412,3557,51,188,13142,1051,14193,-0.0441069,-0.0760455,-0.996128,1
3716,2593,18,325,2582,40,181,9455,1169,10624,-0.0370675,-0.0675539,-0.997027,1
5573,4046,28,489,4026,74,292,14528,1779,16307,-0.0573317,-0.0440105,-0.997385,1
5421,3966,28,445,3742,57,238,13897,1324,15221,-0.0529385,0.0283496,-0.998195,1
3550,2425,19,265,2355,26,188,8828,1053,9881,-0.062105,-0.0052674,-0.998056,1
4855,3167,26,403,3050,36,251,11788,1522,13310,-0.0722258,0.00654435,-0.997367,1
4293,2923,23,347,3243,48,192,11069,1615,12684,-0.0509711,0.0381743,-0.99797,1
4277,2522,25,332,2485,49,177,9867,1509,11376,-0.0333126,0.0921139,-0.995191,1
2261,1262,13,176,1224,29,104,5069,811,5880,-0.0389003,0.0553089,-0.997711,1
4304,2355,25,309,2268,41,155,9457,1631,11088,-0.0385657,0.0819596,-0.995889,1
4198,2270,26,301,2390,48,156,9389,1615,11004,-0.0405821,0.0978823,-0.99437,1
4551,2124,24,308,2094,43,193,9337,1604,10941,-0.0457603,0.168553,-0.98463,1
4070,1936,23,247,1774,35,102,8187,1307,9494,-0.0401796,0.100037,-0.994172,1
2326,1171,15,142,1135,27,80,4896,964,5860,0.00606946,0.0355031,-0.999351,1
4533,2440,31,309,2341,49,164,9867,1654,11521,-0.0677526,0.0840907,-0.994152,1
4751,3592,49,441,2763,51,192,11839,1618,13457,-0.0163474,0.0916603,-0.995656,1
5164,3413,32,476,3248,44,210,12587,1371,13958,-0.0392782,0.104873,-0.99371,1
5518,4709,39,491,3426,25,177,14385,1409,15794,-0.009812,0.0865442,-0.9962,1
2844,2204,17,251,2228,21,144,7709,1043,8752,-0.0162507,0.0197763,-0.999672,1
4619,3801,24,415,3750,35,237,12881,1298,14179,0.00514653,0.0592464,-0.99823,1
3224,2753,19,296,2975,35,248,9550,1662,11212,0.0115496,0.0180169,-0.999771,1
5321,4347,31,463,4823,40,270,15295,2321,17616,0.0439567,-0.00869408,-0.998996,1
3144,2154,25,231,1919,23,108,7604,727,8331,0.014449,-0.0821539,-0.996515,1
1849,1391,13,155,1376,21,89,4894,559,5453,-0.0037468,-0.0997095,-0.99501,1
5275,3848,27,420,3748,69,235,13622,1589,15211,-0.00559466,-0.0978283,-0.995187,1
4948,4013,26,369,3185,25,148,12714,987,13701,-0.0210906,-0.0750349,-0.996958,1
7137,4633,32,403,2856,21,145,15227,940,16167,-0.037206,-0.0448373,-0.998301,1
2561,1775,18,193,1728,16,109,6400,822,7222,-0.0380702,-0.0688394,-0.996901,1
5677,3523,30,414,3966,34,202,13846,1520,15366,-0.0399263,-0.05936,-0.997438,1
3004,1766,16,205,1769,19,119,6898,1006,7904,-0.0322096,-0.0534317,-0.998052,1
5205,2887,26,391,2883,32,216,11640,1480,13120,-0.0180724,-0.0504217,-0.998565,1
5077,2753,26,391,2708,43,207,11205,1621,12826,-0.0100111,-0.0510121,-0.998648,1
3692,1764,20,256,1812,30,137,7711,1042,8753,-0.00750166,-0.0500879,-0.998717,1
3319,1461,19,236,1414,35,119,6603,979,7582,-0.00837499,-0.0553335,-0.998433,1
4867,1768,29,263,1655,38,155,8775,1507,10282,-0.00497638,0.0668629,-0.99775,1
4487,1020,28,158,962,36,82,6773,1912,8685,-0.0122053,0.049377,-0.998706,1
3033,511,15,81,471,28,48,4187,800,4987,-0.0147071,-0.046595,-0.998805,1
1785,449,12,60,455,15,34,2810,649,3459,-0.017742,-0.0825664,-0.996428,1
4141,1170,29,209,1015,75,112,6751,1548,8299,-0.0238919,-0.0474807,-0.998587,1
4198,1105,27,155,1011,35,87,6618,1672,8290,-0.0176476,-0.0569569,-0.998221,1
4127,1031,26,220,1034,35,76,6549,1334,7883,-0.0236127,-0.0274858,-0.999344,1
4240,1224,25,200,1158,27,110,6984,1384,8368,-0.0361608,-0.0279171,-0.998956,1
3870,1225,25,209,1252,28,126,6735,1371,8106,-0.0484711,-0.00230217,-0.998822,1
3889,1363,24,221,1366,62,132,7057,1391,8448,-0.0466746,-0.0385223,-0.998167,1
3927,1537,24,229,1446,40,144,7347,1349,8696,-0.0384523,-0.0333619,-0.998703,1
3832,1614,30,262,1602,46,125,7511,1317,8828,-0.0224007,-0.0186055,-0.999576,1
3970,1973,25,260,1798,62,153,8241,1365,9606,-0.00480594,-0.0368818,-0.999308,1
4470,2282,42,314,2250,49,159,9566,1360,10926,-0.00681883,-0.0185356,-0.999805,1
4533,3131,30,345,2967,51,245,11302,1424,12726,-0.0178413,-0.04643,-0.998762,1
4635,3886,25,416,3775,43,241,13021,1476,14497,-0.0442408,-0.0333374,-0.998464,1
5226,4739,36,522,4485,35,223,15266,1029,16295,-0.0517591,-0.0913269,-0.994475,1
3885,3673,23,402,3591,53,229,11856,958,12814,-0.0525682,-0.0475291,-0.997485,1
6584,5617,32,624,5048,54,263,18222,972,19194,-0.0429539,-0.0245628,-0.998775,1
3178,3083,17,346,2950,41,193,9808,753,10561,-0.0560688,-0.0527636,-0.997032,1
3767,3721,17,408,3513,37,247,11710,913,12623,-0.0424578,-0.0688766,-0.996722,1
5563,4931,30,553,4976,63,316,16432,970,17402,-0.0322051,-0.0633492,-0.997472,1
3908,3352,24,399,3308,49,231,11271,937,12208,-0.0324283,-0.0907814,-0.995343,1
3871,3150,18,331,3071,36,237,10714,1002,11716,-0.0297012,-0.131842,-0.990826,1
4982,3954,24,419,3958,52,244,13633,1205,14838,-0.0439903,-0.130942,-0.990414,1
3544,2807,20,306,2792,39,181,9689,982,10671,-0.0430392,-0.10933,-0.993074,1
5301,4191,26,453,4115,51,288,14425,1452,15877,-0.0589896,-0.118666,-0.991181,1
5163,4182,26,480,4075,44,284,14254,1513,15767,-0.0671872,-0.119773,-0.990525,1
4116,2917,20,311,2740,45,214,10363,1346,11709,-0.0626265,-0.133925,-0.989011,1
5527,4215,28,562,4187,48,267,14834,1731,16565,-0.0602091,-0.111154,-0.991978,1
3815,2915,20,341,2811,34,193,10129,1323,11452,-0.0601212,-0.135562,-0.988943,1
4932,3600,32,524,3596,51,256,12991,1848,14839,-0.0375548,-0.0939574,-0.994868,1
3287,2414,17,328,2351,30,153,8580,1181,9761,-0.0580899,-0.126764,-0.99023,1
3230,2176,16,277,2211,22,165,8097,963,9060,-0.0623866,-0.0665623,-0.99583,1
5029,3114,22,393,2784,38,216,11596,1339,12935,-0.0705304,-0.0172704,-0.99736,1
4906,2509,23,332,2592,50,197,10609,1378,11987,-0.0771482,-0.0287766,-0.996604,1
2786,1625,15,221,1630,33,134,6444,956,7400,-0.0595549,-0.0155262,-0.998104,1
3850,2115,27,255,2009,60,151,8467,1319,9786,-0.0427279,-0.0112431,-0.999024,1
3743,1973,26,244,1983,61,152,8182,1340,9522,-0.0299645,0.0064161,-0.99953,1
4131,2219,29,307,2103,60,158,9007,1509,10516,-0.0213702,0.0499334,-0.998524,1
4215,2143,31,287,1969,83,155,8883,1741,10624,-0.0195999,0.0526561,-0.99842,1
4212,2020,29,282,2065,51,187,8846,1575,10421,0.00236383,0.18042,-0.983587,1
3857,1838,38,271,1749,55,180,7988,1601,9589,-0.0248329,0.132119,-0.990923,1
2753,1295,16,192,1295,32,86,5669,826,6495,-0.0263507,0.0521757,-0.99829,1
2287,1108,18,138,1075,45,95,4766,1019,5785,-0.00193633,0.0835895,-0.996498,1
4049,2189,26,276,2192,84,148,8964,2264,11228,-0.00990684,0.094984,-0.99543,1
4411,2630,35,297,2399,72,165,10009,2407,12416,-0.0176154,0.108607,-0.993929,1
4753,3197,31,414,2547,31,163,11136,2168,13304,-0.0318522,0.0920836,-0.995242,1
2615,1833,17,214,1769,44,122,6614,1604,8218,-0.0490838,0.0497917,-0.997553,1
5857,3942,49,513,3671,45,236,14313,2046,16359,-0.0492715,0.0463732,-0.997708,1
5134,3506,31,450,2852,31,154,12158,1093,13251,-0.014671,0.0595739,-0.998116,1
2275,1847,20,206,1790,26,119,6283,1085,7368,-0.0222104,-0.00768639,-0.999724,1
5048,4292,33,446,3946,72,259,14096,2116,16212,-0.0093258,0.060581,-0.99812,1
5061,3643,37,408,2941,41,167,12298,1226,13524,-0.0239008,0.0815829,-0.99638,1
2781,1700,16,189,1697,28,122,6533,844,7377,-0.0227429,0.0361503,-0.999088,1
4859,2453,27,281,2485,34,160,10299,1350,11649,4.16544e-06,0.0280267,-0.999608,1
5111,2181,32,296,2078,40,184,9922,1527,11449,0.0092712,0.0313875,-0.999464,1
4282,1548,32,270,1516,52,136,7836,1337,9173,0.011221,-0.00152255,-0.999936,1
4857,1525,27,240,1511,38,105,8303,1482,9785,0.00580968,0.00416075,-0.999975,1
4166,1493,27,240,1516,53,102,7597,1330,8927,-0.00280299,-0.0173521,-0.999846,1
4055,1538,29,203,1407,40,124,7396,1342,8738,-0.0143278,-0.048884,-0.998702,1
4063,1416,26,203,1365,46,134,7253,1393,8646,-0.0113856,-0.0449015,-0.998927,1
4013,1390,29,202,1268,53,107,7062,1329,8391,-0.00562482,-0.0658952,-0.997811,1
4342,1480,32,191,1399,58,113,7615,1552,9167,-0.00274861,-0.0651799,-0.99787,1
3911,1264,30,165,1245,71,107,6793,1363,8156,-0.0037182,-0.0720466,-0.997394,1
4358,1256,26,163,1314,79,103,7299,2269,9568,-0.00350808,-0.078928,-0.996874,1
4256,1180,29,190,1142,76,104,6977,2923,9900,-0.0140271,-0.0675516,-0.997617,1
3748,977,28,142,925,73,85,5978,3139,9117,-0.00852954,-0.0988683,-0.995064,1
3986,978,29,155,823,67,86,6124,5302,11426,0.00471329,-0.122912,-0.992406,1
3537,796,27,184,804,74,88,5510,6303,11813,0.0342433,-0.187154,-0.981733,1
3656,795,27,156,758,51,85,5528,6459,11987,0.0433479,-0.249874,-0.967307,1
3528,722,25,112,753,48,65,5253,17628,22881,0.114937,-0.141298,-0.983272,1
1554,393,12,53,357,23,34,2426,9921,12347,0.0648028,-0.40607,-0.911541,1
3991,1245,28,191,1210,83,116,6864,19546,26410,0.229303,-0.06948,-0.970872,1
2684,576,13,88,515,18,53,3947,2178,6125,-0.000257236,-0.0321321,-0.999484,1
4243,1768,31,255,1660,48,119,8124,1400,9524,-0.00391252,-0.0633556,-0.997984,1
3537,1304,34,173,1351,55,109,6563,1404,7967,-0.00082139,-0.0904633,-0.995899,1
3689,1466,45,200,1289,31,126,6846,1394,8240,8.18306e-07,-0.0627906,-0.998027,1
3624,1411,25,201,1383,31,128,6803,1341,8144,-0.0169147,-0.0706189,-0.99736,1
3629,1400,32,224,1325,39,127,6776,1369,8145,-0.0422984,-0.0880812,-0.995214,1
3727,1577,24,244,1514,32,124,7242,1380,8622,-0.0241952,-0.0545788,-0.998216,1
3766,1786,25,262,1870,36,167,7912,1438,9350,-0.0254553,-0.0535617,-0.99824,1
4336,2646,28,311,2463,48,197,10029,1496,11525,-0.014964,-0.0178686,-0.999728,1
4167,1887,17,224,1764,25,131,8215,968,9183,-0.0235774,-0.0295946,-0.999284,1
2214,2014,16,278,1603,25,90,6240,624,6864,-0.0334195,-0.0712362,-0.9969,1
4114,3135,25,346,2972,44,200,10836,1388,12224,-0.0238318,-0.0580286,-0.99803,1
4336,3373,25,391,3261,46,252,11684,1457,13141,-0.0276331,-0.0425002,-0.998714,1
4509,3735,29,441,3721,53,263,12751,1689,14440,-0.0285936,-0.0190649,-0.999409,1
4602,4321,24,549,4212,47,303,14058,2045,16103,-0.0378581,-0.0388456,-0.998528,1
4914,4999,29,613,4705,85,333,15678,1415,17093,0.109051,-0.029083,-0.993611,1
3736,3766,22,427,3468,35,232,11686,1202,12888,0.116736,-0.039267,-0.992386,1
3768,3813,21,456,3712,40,259,12069,1111,13180,0.107977,-0.057914,-0.992465,1
5218,4875,26,581,4693,52,256,15701,1248,16949,0.109008,-0.0665715,-0.991809,1
3715,3513,21,442,3420,45,232,11388,1477,12865,0.0995934,-0.0767519,-0.992064,1
2866,2710,17,329,2751,38,180,8891,797,9688,-0.0409643,-0.0706333,-0.996661,1
5663,5176,30,641,5187,58,347,17102,1130,18232,-0.0513626,-0.0533372,-0.997255,1
4214,3635,23,423,3575,49,264,12183,1004,13187,-0.0483533,-0.065602,-0.996673,1
3728,3367,19,406,3305,44,237,11106,919,12025,-0.0417438,-0.0747799,-0.996326,1
3601,3228,20,382,3161,33,224,10649,920,11569,-0.0354379,-0.0693546,-0.996963,1
6196,4523,30,494,4540,69,304,16156,1085,17241,-0.0384095,-0.0731199,-0.996583,1
3976,2955,23,344,2828,46,208,10380,997,11377,-0.0301542,-0.127753,-0.991347,1
3756,2688,22,338,2680,49,226,9759,968,10727,-0.0501059,-0.101013,-0.993623,1
5600,3820,24,436,3495,58,232,13665,1386,15051,-0.0447778,-0.103948,-0.993574,1
5156,3688,29,407,3446,40,186,12952,1072,14024,-0.0312199,-0.0651463,-0.997387,1
4093,2712,19,334,2657,28,193,10036,1193,11229,-0.044992,-0.0514848,-0.99766,1
4550,3415,23,445,3351,38,261,12083,1899,13982,-0.0412717,-0.0426232,-0.998238,1
4797,3441,25,415,3355,41,237,12311,1536,13847,-0.059404,-0.0173385,-0.998084,1
5160,3615,26,474,3466,35,246,13022,1388,14410,-0.0780967,-0.00199127,-0.996944,1
3187,2178,19,359,2606,25,142,8516,1013,9529,-0.0688549,-0.0361988,-0.99697,1
4814,3175,29,370,3083,46,219,11736,1534,13270,-0.0601261,0.000688675,-0.998191,1
5777,3011,24,351,2900,64,214,12341,1581,13922,-0.0477341,-0.0133641,-0.998771,1
2370,1368,17,186,1345,39,115,5440,910,6350,-0.0497419,-0.0274688,-0.998384,1
4558,2467,31,324,2321,63,174,9938,1573,11511,-0.0479592,-0.023105,-0.998582,1
4538,2448,31,339,2387,69,166,9978,1760,11738,-0.0484344,-0.0374181,-0.998125,1
3030,1590,17,201,1527,46,112,6523,1161,7684,-0.0499912,-0.0587111,-0.997023,1
4304,2186,31,256,2152,73,175,9177,1614,10791,-0.0514827,-0.0348582,-0.998065,1
4389,2398,26,247,2073,72,181,9386,1227,10613,-0.038252,-0.0355709,-0.998635,1
2682,1284,17,180,1224,70,87,5544,1115,6659,-0.0479418,-0.0110871,-0.998789,1
4019,1723,27,220,1689,63,133,7874,1383,9257,-0.0522308,0.00991334,-0.998586,1
3887,2205,30,236,1604,77,136,8175,1415,9590,-0.05812,-0.00573684,-0.998293,1
4008,2060,32,360,2099,61,154,8774,1619,10393,-0.0430961,0.00697417,-0.999047,1
4136,1859,27,265,1752,61,144,8244,1591,9835,-0.0378425,0.0234729,-0.999008,1
3671,1716,27,220,1731,50,129,7544,1484,9028,-0.0524278,0.0458066,-0.997574,1
3682,1684,25,201,1602,45,118,7357,1485,8842,-0.0365957,0.0655365,-0.997179,1
4348,1778,30,289,1741,61,130,8377,2417,10794,-0.0221186,0.0919576,-0.995517,1
4304,2063,25,310,1853,72,136,8763,6085,14848,-0.0156717,0.138936,-0.990178,1
2737,1522,19,187,1472,45,108,6090,2739,8829,-0.0120623,0.141116,-0.98992,1
4447,2641,33,367,2623,95,211,10417,7730,18147,-0.0396136,0.1512,-0.987709,1
3141,2070,20,280,1977,50,161,7699,11031,18730,-0.100858,0.0229759,-0.994636,1
2163,1443,12,187,1493,29,103,5430,8914,14344,-0.0941007,0.119746,-0.988335,1
2256,1645,12,203,1604,34,121,5875,10238,16113,-0.103338,0.115977,-0.987862,1
2059,1429,11,186,1502,29,109,5325,8365,13690,-0.0888939,0.10217,-0.990787,1
2507,2021,13,215,1987,34,124,6901,14344,21245,0.0413345,0.513759,-0.856938,1
2067,1654,11,213,1623,19,100,5687,13066,18753,0.0889056,0.460428,-0.883234,1
1532,1256,9,142,1205,16,83,4243,1566,5809,-0.0219854,-0.00866384,-0.999721,1
3558,2829,18,312,2823,29,178,9747,1629,11376,-0.00693338,-0.0180134,-0.999814,1
4617,3559,25,425,3484,51,241,12402,1458,13860,-0.00808205,-0.00827801,-0.999933,1
4313,3535,22,406,3210,40,177,11703,964,12667,0.00878556,-0.00562414,-0.999946,1
3208,2495,17,319,2443,33,150,8665,1207,9872,0.00940166,-0.00850885,-0.99992,1
4870,3685,25,477,3536,32,250,12875,2050,14925,0.0126254,0.0331749,-0.99937,1
3324,2412,19,315,2478,27,169,8744,1299,10043,0.00996373,0.0207016,-0.999736,1
5326,3308,27,359,3260,43,239,12562,1936,14498,-0.0106873,0.0656054,-0.997789,1
5203,3001,50,403,2882,38,197,11774,1196,12970,-0.0135475,0.0495182,-0.998682,1
4952,3027,34,350,3031,64,172,11630,1703,13333,-0.0180722,0.0962559,-0.995193,1
3626,1099,21,155,1124,40,94,6159,941,7100,-0.0151101,0.0563497,-0.998297,1
1892,623,12,95,523,12,47,3204,586,3790,-0.00165024,-0.0118834,-0.999928,1
1715,429,12,70,396,13,42,2677,615,3292,-0.0038372,-0.0150802,-0.999879,1
4284,718,27,147,658,35,83,5952,1626,7578,0.0101996,0.00233326,-0.999945,1
4111,603,27,132,535,61,73,5542,1669,7211,0.0102159,-0.0245962,-0.999645,1
4207,516,28,124,457,48,66,5446,1694,7140,0.0254136,-0.0346787,-0.999075,1
4063,463,31,94,418,50,60,5179,1937,7116,0.0189058,-0.0407438,-0.998991,1
4607,555,35,96,505,35,65,5898,1681,7579,-0.0047739,-0.0150897,-0.999875,1
4029,495,33,90,388,48,55,5138,1540,6678,-0.00136696,-0.0204643,-0.99979,1
4038,501,33,96,450,48,59,5225,1550,6775,0.00220773,-0.0333765,-0.999441,1
4202,657,33,96,534,42,62,5626,1614,7240,-0.0206508,-0.0239864,-0.999499,1
4496,766,37,154,775,43,75,6346,1620,7966,-0.0225848,-0.0189275,-0.999566,1
4106,935,30,192,865,64,95,6287,1480,7767,-0.0230494,-0.0333636,-0.999178,1
4264,1342,38,234,1211,55,89,7233,1535,8768,-0.0316085,-0.0233575,-0.999227,1
4147,1435,28,186,1391,36,110,7333,1477,8810,-0.0352583,-0.000774361,-0.999378,1
4850,2073,35,334,2114,40,186,9632,1504,11136,-0.0418764,0.0338872,-0.998548,1
4574,2695,29,352,2618,30,136,10434,1046,11480,-0.039706,0.0136398,-0.999118,1
3420,2605,20,372,2497,30,188,9132,1054,10186,-0.0234858,0.00865635,-0.999687,1
5997,4725,32,542,4465,55,337,16153,1378,17531,0.002659,0.048233,-0.998832,1
3784,3763,20,437,3712,35,230,11981,1034,13015,-0.00501458,-0.00584647,-0.99997,1
6352,5861,38,728,4654,36,272,17941,1379,19320,0.0344049,-0.0359474,-0.998761,1
2605,2582,13,295,2510,31,174,8210,666,8876,0.0236829,0.0132021,-0.999632,1
5013,4568,21,538,4468,82,305,14995,1172,16167,0.0276861,0.0290621,-0.999194,1
3178,2609,17,326,2562,27,189,8908,679,9587,0.0228649,0.0136588,-0.999645,1
2780,2505,16,288,2518,19,160,8286,680,8966,0.0169955,-0.0231428,-0.999588,1
4069,3571,18,425,3393,35,249,11760,984,12744,0.00695962,-0.00648004,-0.999955,1
4912,4652,23,539,4148,43,278,14595,1028,15623,0.000211596,-0.00327195,-0.999994,1
3572,2892,16,364,2766,29,209,9848,913,10761,-0.00534029,-0.036496,-0.99932,1
4767,3167,21,397,3132,52,249,11785,1170,12955,-0.00847953,-0.0404215,-0.999147,1
4222,2841,23,323,2768,42,183,10402,1114,11516,-0.023335,-0.047985,-0.998576,1
5917,3702,35,451,3824,59,274,14262,1580,15842,-0.00978685,0.00714942,-0.999926,1
3820,2460,26,406,3182,32,159,10085,846,10931,-0.0033751,0.00235749,-0.999992,1
3603,2239,64,376,2121,33,162,8598,1165,9763,-0.0292406,-0.0555492,-0.998028,1
4283,2516,26,396,2509,43,185,9958,1428,11386,-0.0164884,-0.00345451,-0.999858,1
5107,2891,29,332,2858,53,214,11484,2534,14018,0.0176905,0.0522269,-0.998479,1
2565,1472,17,184,1399,29,109,5775,1024,6799,-0.0159251,0.021044,-0.999652,1
4558,2655,28,347,2413,72,179,10252,1452,11704,-0.0127658,0.116205,-0.993143,1
4771,2287,25,360,2327,61,161,9992,1626,11618,-0.0186166,0.141805,-0.98972,1
3965,1865,22,228,1849,32,135,8096,1500,9596,-0.0169821,0.149724,-0.988582,1
4687,2165,28,383,2154,40,152,9609,1618,11227,-0.0220957,0.17465,-0.984383,1
3808,1906,22,230,1754,32,132,7884,1376,9260,-0.0117562,0.18789,-0.98212,1
4307,1909,43,239,1823,39,138,8498,1904,10402,-0.0290693,0.148768,-0.988445,1
4149,1887,31,236,1969,39,184,8495,1705,10200,-0.000361647,0.20305,-0.979169,1
4206,2002,25,292,1961,34,157,8677,1539,10216,0.00284485,0.173039,-0.984911,1
3761,1833,27,235,1919,44,171,7990,1790,9780,0.0137986,0.203246,-0.979031,1
4467,2289,33,312,2210,49,200,9560,2846,12406,0.0148027,0.189495,-0.98177,1
5273,2465,39,408,2050,40,132,10407,1670,12077,0.00536573,0.167091,-0.985927,1
2329,1340,14,178,1361,28,105,5355,1247,6602,0.00977355,0.117946,-0.992972,1
4073,2430,26,326,2421,64,184,9524,2160,11684,0.0340591,0.11737,-0.992504,1
3936,2296,29,287,2250,101,166,9065,2081,11146,0.0129416,0.0624713,-0.997963,1
3974,2339,30,293,2364,56,167,9223,2188,11411,0.0350342,0.0877879,-0.995523,1
4797,2825,39,377,2687,77,219,11021,2437,13458,0.0335227,0.0913096,-0.995258,1
4106,2405,29,288,2323,74,183,9408,2135,11543,0.00613529,0.0695397,-0.99756,1
2210,1279,15,175,1270,23,96,5068,1222,6290,0.00126598,0.0699441,-0.99755,1
4339,2518,27,276,2416,73,155,9804,2631,12435,0.0482975,0.109428,-0.992821,1
4408,2747,37,313,2662,57,186,10410,2240,12650,0.0383528,0.110346,-0.993153,1
4044,2440,30,294,2396,57,219,9480,1955,11435,0.0161811,0.11448,-0.993294,1
3972,2438,26,314,2359,60,161,9330,1547,10877,0.0208824,0.144116,-0.98934,1
3686,2361,25,277,2335,42,161,8887,1952,10839,0.0384825,0.151853,-0.987654,1
4592,3111,32,375,2984,51,241,11386,1738,13124,0.0428893,0.149358,-0.987853,1
4635,3572,38,487,3478,49,268,12527,1724,14251,0.0580522,0.153491,-0.986443,1
4597,3551,29,471,3487,37,265,12437,1138,13575,0.0637257,0.0981183,-0.993132,1
3891,3294,29,424,3251,37,249,11175,1299,12474,0.0636727,0.0959847,-0.993344,1
4052,3412,27,430,3495,48,309,11773,1514,13287,0.0819597,0.0870929,-0.992823,1
4024,3188,28,418,2743,29,156,10586,965,11551,0.0474099,0.0895756,-0.994851,1
2861,2379,20,276,2580,37,206,8359,924,9283,0.0348132,0.0749373,-0.99658,1
4890,3993,51,524,3787,32,239,13516,1259,14775,0.0258857,0.058905,-0.997928,1
3131,2574,22,326,2506,37,169,8765,1049,9814,0.012507,0.0521887,-0.998559,1
5193,4166,37,469,4116,52,278,14311,1621,15932,0.0105409,0.0315163,-0.999448,1
5134,4258,38,508,4062,37,289,14326,1611,15937,0.00586265,0.0270145,-0.999618,1
3542,2879,24,342,3801,71,253,10912,806,11718,0.0206025,0.0132396,-0.9997,1
4007,3312,29,422,3185,55,248,11258,1218,12476,0.0144341,0.0144479,-0.999792,1
4423,3636,46,486,3503,42,276,12412,1372,13784,0.0138329,0.0126119,-0.999825,1
4463,3585,31,473,3593,42,238,12425,1357,13782,0.0167415,0.00784577,-0.999829,1
4954,4095,34,512,3856,48,296,13795,1584,15379,0.0120351,0.0121856,-0.999853,1
3379,2799,23,406,2713,32,208,9560,1092,10652,0.0109759,0.019498,-0.99975,1
4921,4234,44,502,3781,66,272,13820,1340,15160,0.00983214,0.00875335,-0.999913,1
4519,4351,37,642,3133,31,180,12893,1014,13907,0.00929689,0.0127929,-0.999875,1
2404,2007,17,245,1947,19,139,6778,756,7534,0.00694619,0.0135932,-0.999884,1
4710,3659,40,518,3534,39,274,12774,1466,14240,0.0130617,0.0170678,-0.999769,1
4507,3822,31,449,3514,40,266,12629,1422,14051,0.00432932,0.0182128,-0.999825,1
3175,2563,26,367,2531,37,189,8888,985,9873,0.0171604,0.0132168,-0.999766,1
5171,3894,32,507,3732,45,236,13617,1451,15068,0.00481243,0.0147994,-0.999879,1
4349,3902,31,439,3555,31,183,12490,985,13475,0.000211044,0.0115574,-0.999933,1
2455,1993,17,230,1947,25,130,6797,905,7702,0.0108261,0.021162,-0.999718,1
4943,3729,38,409,3460,43,265,12887,1390,14277,0.000354624,0.013887,-0.999904,1
4474,3798,31,461,3555,94,272,12685,997,13682,0.000702428,0.0184288,-0.99983,1
3971,3305,34,444,3128,35,272,11189,1366,12555,0.00192408,0.0196127,-0.999806,1
4087,3630,42,475,3269,54,212,11769,1215,12984,-0.00278669,0.0212205,-0.999771,1
1748,1312,12,168,1298,13,110,4661,511,5172,0.00193552,0.0209704,-0.999778,1
4655,3687,31,459,3566,31,263,12692,1338,14030,0.00531247,0.0204423,-0.999777,1
3153,2731,26,466,3266,41,176,9859,981,10840,-0.00329531,0.0231645,-0.999726,1
4511,3418,30,407,3393,39,233,12031,1351,13382,0.000182467,0.0151639,-0.999885,1
4365,3591,31,415,3457,43,234,12136,1352,13488,0.0099955,0.0147457,-0.999841,1
4479,3687,32,417,3464,33,259,12371,972,13343,0.000215312,0.0226547,-0.999743,1
4034,3327,29,448,3223,30,263,11354,1223,12577,0.00620547,0.0182994,-0.999813,1
4509,3653,32,417,3505,35,240,12391,1395,13786,0.00141389,0.0236756,-0.999719,1
3156,2549,22,327,2544,27,206,8831,958,9789,0.0113075,0.00920489,-0.999894,1
4679,3766,31,468,3921,37,272,13174,1506,14680,0.00224737,0.0138541,-0.999901,1
4455,3646,33,477,3567,42,273,12493,1496,13989,0.00287709,0.0235566,-0.999718,1
4542,4398,32,421,3506,45,236,13180,1370,14550,0.00496691,0.0193351,-0.999801,1
4356,3551,30,418,2947,24,169,11495,994,12489,0.00139092,0.0209253,-0.99978,1
2501,1995,18,256,1978,18,152,6918,759,7677,0.00553406,0.0231421,-0.999717,1
4824,4049,31,501,3587,40,279,13311,1360,14671,-0.00124005,0.022463,-0.999747,1
4586,3821,32,414,3556,34,238,12681,1326,14007,0.00283631,0.0115734,-0.999929,1
4379,3562,32,417,3375,28,170,11963,950,12913,0.000550597,0.0142284,-0.999899,1
3916,3181,28,370,3277,42,246,11060,1241,12301,0.00414121,0.0170989,-0.999845,1
4396,3630,31,461,3506,39,271,12334,1489,13823,-0.00828408,0.0187313,-0.99979,1
4430,3573,30,458,3436,36,284,12247,1368,13615,0.00488175,0.0109591,-0.999928,1
4360,3491,30,419,3407,35,236,11978,1388,13366,0.0027017,0.0189391,-0.999817,1
4325,3581,30,412,3552,39,236,12175,1379,13554,0.00454106,0.0152052,-0.999874,1
3992,3244,28,374,3116,30,212,10996,1336,12332,-0.00133764,0.0210541,-0.999778,1
4846,3671,33,420,3545,34,237,12786,1338,14124,-0.00130129,0.020746,-0.999784,1
5024,4085,39,532,3160,31,211,13082,1076,14158,-0.00961944,0.0209685,-0.999734,1
2671,2040,29,273,2092,29,143,7277,773,8050,-0.00154467,0.0304102,-0.999536,1
4831,3526,34,498,3486,37,277,12689,1519,14208,-0.0107519,0.016075,-0.999813,1
4412,3577,34,442,3570,43,247,12325,1293,13618,0.00656767,0.0174799,-0.999826,1
3940,3226,33,386,3227,51,227,11090,1237,12327,0.00417401,0.017999,-0.999829,1
4838,4054,42,531,3843,52,312,13672,1649,15321,0.0072324,0.0164197,-0.999839,1
4981,3897,39,475,3375,35,217,13019,1059,14078,0.00192192,0.0160929,-0.999869,1
4411,3708,38,405,2472,22,182,11238,1032,12270,0.0155581,0.0144201,-0.999775,1
2420,2007,17,246,2220,39,166,7115,1013,8128,0.0039486,0.00345471,-0.999986,1
3693,3088,25,364,2983,33,214,10400,1215,11615,0.00306397,0.0240129,-0.999707,1
3836,3049,25,364,2973,25,232,10504,1160,11664,0.0124787,0.0164811,-0.999786,1
3753,3039,27,399,2884,26,206,10334,1151,11485,0.00493069,0.0169542,-0.999844,1
2726,2231,20,284,2267,30,168,7726,914,8640,-0.00237303,0.0261289,-0.999656,1
4428,4267,38,639,4825,51,311,14559,1388,15947,0.00812413,0.0139527,-0.99987,1
3178,2566,22,355,2557,24,182,8884,990,9874,0.00396617,0.0143682,-0.999889,1
4013,3774,33,506,3186,33,241,11786,1259,13045,0.00269078,0.00984585,-0.999948,1
4480,3587,28,417,3190,34,210,11946,1219,13165,0.00512618,0.0125412,-0.999908,1
4112,3677,29,457,3222,28,257,11782,1317,13099,-0.00377103,0.025633,-0.999664,1
5168,4617,30,500,3860,38,260,14473,1636,16109,0.0111502,0.0151742,-0.999823,1
5095,3827,23,336,2714,30,228,12253,1016,13269,0.0101149,0.0171193,-0.999802,1
4656,3636,32,429,3610,44,232,12639,1045,13684,0.00502017,0.0283637,-0.999585,1
3169,2569,23,365,2480,25,177,8808,973,9781,0.0108544,0.0129287,-0.999857,1
5166,3869,41,470,3847,47,295,13735,1447,15182,0.000404052,0.0234201,-0.999726,1
3431,2834,22,347,2684,34,210,9562,1095,10657,0.0147479,0.0135537,-0.999799,1
4502,3632,31,447,3558,34,263,12467,1327,13794,-0.00335427,0.0246671,-0.99969,1
5279,4031,37,426,3570,41,243,13627,1356,14983,0.00345252,0.0202524,-0.999789,1
3280,2599,27,365,2498,34,179,8982,941,9923,0.000440871,0.0221453,-0.999755,1
5053,4138,40,478,3918,51,278,13956,1622,15578,0.0034896,0.00354044,-0.999988,1
5007,3680,37,490,3071,35,185,12505,1052,13557,-0.00544385,0.0116326,-0.999918,1
2550,2038,21,248,2110,29,143,7139,818,7957,0.00730068,0.014868,-0.999863,1
4449,3650,35,419,3540,43,266,12402,1360,13762,0.00847425,0.0049229,-0.999952,1
4221,3397,35,396,3197,43,254,11543,1241,12784,0.0103909,0.0177046,-0.999789,1
4831,3566,38,430,3436,49,240,12590,1129,13719,0.00414728,0.0183161,-0.999824,1
3187,2632,28,303,2685,51,250,9136,1038,10174,0.00266294,0.0222923,-0.999748,1
4511,3704,36,456,3624,40,268,12639,1432,14071,0.00263876,0.0239529,-0.999709,1
4598,3761,31,409,3356,27,184,12366,1018,13384,-0.00737319,0.0184641,-0.999802,1
3267,2702,40,452,2603,37,201,9302,964,10266,0.00702823,0.015064,-0.999862,2
4513,3826,37,469,3582,40,301,12768,1363,14131,0.00979978,0.0134833,-0.999861,2
4615,3749,30,455,2959,26,178,12012,977,12989,0.00712439,0.0166407,-0.999836,2
2468,2030,16,297,2051,27,134,7023,768,7791,0.00288495,0.0236593,-0.999716,2
4439,3524,31,412,3413,38,241,12098,1333,13431,0.00502461,0.0180334,-0.999825,2
4521,4039,31,447,3517,51,294,12900,1325,14225,0.00686541,0.0170674,-0.999831,2
4987,3956,37,452,3285,33,178,12928,1158,14086,0.00306784,0.0201908,-0.999792,2
2585,2068,19,244,2065,23,136,7140,854,7994,0.00687521,0.0114364,-0.999911,2
4355,3560,32,409,3554,47,278,12235,1369,13604,0.0072739,0.0114234,-0.999909,2
4921,4063,35,518,4050,49,313,13949,1520,15469,0.0065424,0.0142618,-0.999877,2
4904,4130,42,539,3960,51,252,13878,1555,15433,0.00721892,0.0149219,-0.999863,2
4323,3560,37,451,2818,32,174,11395,976,12371,0.00528129,0.0163804,-0.999852,2
2384,1707,38,222,1632,20,122,6125,631,6756,0.00429193,0.0157859,-0.999866,2
3097,2559,30,291,2520,25,164,8686,1126,9812,-0.00954547,0.0103007,-0.999901,2
5004,4110,34,461,3981,44,304,13938,1699,15637,0.0213711,0.00992442,-0.999723,2
5487,4329,35,493,3002,30,196,13572,1055,14627,0.0037461,0.00831498,-0.999958,2
2562,2100,20,266,2095,27,163,7233,805,8038,0.0117479,0.00904018,-0.99989,2
4945,4041,67,532,3965,41,299,13890,1563,15453,0.00490936,0.0178124,-0.999829,2
3329,2780,24,317,2687,29,183,9349,1048,10397,0.00856832,0.0155504,-0.999843,2
4356,3735,36,482,3585,43,270,12507,1393,13900,0.00242523,0.0123151,-0.999921,2
3901,2681,22,263,1943,22,150,8982,756,9738,0.0100424,0.0173212,-0.9998,2
1954,1620,14,193,1571,15,104,5471,636,6107,-0.000985151,0.00497345,-0.999987,2
4534,3766,30,406,3684,34,242,12696,1560,14256,0.00465599,0.0029649,-0.999985,2
4390,3725,37,416,3452,44,250,12314,1324,13638,0.0137955,0.0103737,-0.999851,2
4927,4066,34,556,3917,37,305,13842,1474,15316,-0.000132854,0.0204175,-0.999792,2
3489,2839,29,422,2737,27,207,9750,1065,10815,0.00733911,0.00919968,-0.999931,2
5929,3566,30,483,3542,60,266,13876,1420,15296,0.0136707,0.013226,-0.999819,2
3208,2512,26,325,2515,26,179,8791,975,9766,0.00633932,0.00992149,-0.999931,2
4978,3898,34,457,3898,37,261,13563,1608,15171,-0.00417268,0.00375184,-0.999985,2
4999,3422,25,362,2743,27,223,11801,787,12588,-0.00616875,0.0155949,-0.99986,2
2400,1920,16,226,2243,38,161,7004,900,7904,-0.00966267,0.0178745,-0.999794,2
4495,4021,45,500,3414,36,237,12748,1428,14176,0.012215,0.0116655,-0.999857,2
4429,3648,31,421,3492,39,240,12300,1354,13654,-0.00423812,0.00676795,-0.999968,2
5007,3915,30,473,3489,36,286,13236,977,14213,-0.000698021,0.00536656,-0.999985,2
5028,4138,36,521,3950,45,298,14016,1489,15505,0.00319171,0.0141284,-0.999895,2
5814,2829,35,418,2436,23,146,11701,825,12526,-0.000421929,8.88775e-05,-1,2
2088,1535,12,178,1381,12,107,5313,551,5864,-0.00060058,0.00520155,-0.999986,2
4514,3781,32,464,3514,33,243,12581,1377,13958,-0.000950438,0.00640801,-0.999979,2
4439,4116,35,512,3628,42,274,13046,1315,14361,0.00562193,0.00925581,-0.999942,2
3279,2550,21,302,2526,23,166,8867,969,9836,0.00481491,0.0110768,-0.999927,2
5987,3958,38,481,3946,40,277,14727,1549,16276,-0.00290523,-3.69437e-05,-0.999996,2
4941,3399,24,316,2644,28,177,11529,966,12495,0.00343642,0.00939907,-0.99995,2
2591,2054,19,242,2064,23,144,7137,859,7996,0.0120422,0.00930464,-0.999884,2
5376,4050,36,470,3967,37,268,14204,1491,15695,0.00270805,0.0166378,-0.999858,2
4617,3631,32,481,2681,26,194,11662,956,12618,0.00471761,0.00940404,-0.999945,2
3183,2834,28,467,3132,33,175,9852,1001,10853,0.00349252,0.0106543,-0.999937,2
5036,3966,41,504,3671,35,194,13447,1069,14516,0.00265441,0.00591289,-0.999979,2
3485,2741,34,340,2709,25,180,9514,1067,10581,0.00807028,0.00651242,-0.999947,2
4909,3939,30,413,3630,41,266,13228,1471,14699,0.00520091,0.0094382,-0.999942,2
5286,3903,33,463,3796,25,233,13739,1099,14838,-0.000216025,0.00844368,-0.999964,2
4565,3682,34,501,3996,29,173,12980,1014,13994,0.00298578,0.00829468,-0.999961,2
3169,2582,22,381,2629,29,169,8981,1012,9993,0.00485434,0.0083904,-0.999953,2
5507,4128,36,558,4016,35,241,14521,1312,15833,-0.0015156,0.0111983,-0.999936,2
4454,3593,31,420,3523,39,223,12283,939,13222,-0.0019031,0.00839537,-0.999963,2
4292,3287,30,426,3214,30,215,11494,1345,12839,0.000476516,0.000924659,-0.999999,2
4055,3342,28,448,3279,34,250,11436,1342,12778,-0.000592055,0.0100973,-0.999949,2
4270,3246,27,380,3206,33,216,11378,1189,12567,0.000936569,0.0134672,-0.999909,2
4054,3373,34,537,3648,35,249,11930,1212,13142,0.0024505,0.0118747,-0.999927,2
5037,3974,33,420,3957,30,266,13717,1526,15243,0.00196921,0.0116023,-0.999931,2
3466,2749,23,422,3341,45,190,10236,1130,11366,-0.00560255,0.0101752,-0.999932,2
4565,3701,30,470,3542,39,287,12634,1353,13987,0.00664232,0.00967345,-0.999931,2
4463,3644,31,428,3672,35,237,12510,1358,13868,0.00465839,0.00391313,-0.999981,2
4483,3664,56,415,3466,31,233,12348,1316,13664,0.000635,0.00983231,-0.999951,2
4999,3967,41,538,3886,44,267,13742,1580,15322,0.0042984,0.00373252,-0.999984,2
3605,2813,24,318,2767,32,183,9742,1027,10769,0.00172281,0.012432,-0.999921,2
4645,3978,39,460,3678,35,262,13097,1417,14514,0.00464464,0.00545141,-0.999974,2
3203,3561,29,417,2512,41,188,9951,884,10835,0.00157129,0.0130516,-0.999914,2
2516,1989,16,260,1958,19,145,6903,789,7692,0.00351263,-0.00178579,-0.999992,2
5205,4017,34,462,3826,49,261,13854,1469,15323,-0.00150472,0.010991,-0.999938,2
5146,3886,29,639,5256,34,228,15218,977,16195,0.00932397,0.00705249,-0.999931,2
2811,1967,19,257,2056,23,132,7265,770,8035,-0.00691042,0.0143434,-0.999873,2
4537,3583,30,457,3535,48,302,12492,1580,14072,-0.00110427,0.00943611,-0.999955,2
4746,3534,30,411,3488,36,239,12484,1390,13874,0.0174202,0.00602486,-0.99983,2
3282,2534,22,297,2782,34,188,9139,937,10076,0.000446342,0.00878548,-0.999961,2
4954,3531,33,411,3493,34,233,12689,1343,14032,0.0068313,0.00294709,-0.999972,2
3616,2654,22,311,2506,29,223,9361,969,10330,0.00592522,0.00680789,-0.999959,2
4735,3771,31,450,3860,46,307,13200,1386,14586,0.00721714,0.0056332,-0.999958,2
5687,3648,34,474,3500,36,243,13622,1352,14974,-0.00106731,0.00777376,-0.999969,2
3202,2619,21,318,3614,35,239,10048,966,11014,0.0066888,0.00029763,-0.999978,2
4833,3535,43,477,3502,34,238,12662,1430,14092,-0.00226721,0.00861511,-0.999961,2
5070,4022,35,539,3586,34,265,13551,1012,14563,0.00201312,0.00903292,-0.999958,2
3189,2665,22,380,2570,26,184,9036,997,10033,-0.00997681,0.00973956,-0.999903,2
4956,3616,31,455,3651,40,243,12992,1450,14442,0.0098107,0.00425328,-0.999943,2
3153,2603,21,323,2577,28,189,8894,1049,9943,0.00181737,0.0129924,-0.999914,2
5151,4006,31,479,3838,38,253,13796,1314,15110,0.00482036,0.00652098,-0.999967,2
4565,4032,38,586,3682,41,270,13214,1114,14328,-0.00105004,0.00876108,-0.999961,2
3215,2656,22,334,2545,34,175,8981,972,9953,-0.00178473,0.00943039,-0.999954,2
5229,4109,32,515,3982,37,276,14180,1536,15716,-0.000220859,0.00334177,-0.999995,2
4522,3722,30,470,3593,39,257,12633,1367,14000,-0.00237815,0.00573753,-0.999981,2
4574,3740,29,472,3587,37,236,12675,1063,13738,0.00221023,-0.00465979,-0.999987,2
5072,3987,35,496,3923,37,259,13809,1482,15291,0.000437614,0.00700153,-0.999975,2
3934,2985,26,319,2662,27,178,10131,1041,11172,0.00440285,0.00949582,-0.999945,2
5013,4065,35,521,3971,36,268,13909,1471,15380,0.00279657,-0.0020479,-0.999994,2
2617,2141,17,275,2136,20,142,7348,789,8137,0.00294288,0.00733333,-0.999969,2
5072,4060,33,514,4012,33,281,14005,1547,15552,-0.00947252,0.00986259,-0.999906,2
5044,4091,36,537,4264,73,286,14331,1038,15369,-0.00162083,0.00665127,-0.999977,2
2618,2135,23,373,2308,19,160,7636,790,8426,-0.00126392,0.0108204,-0.999941,2
5142,3957,35,531,4010,42,261,13978,1484,15462,0.000389209,0.00492523,-0.999988,2
3499,2780,23,369,2683,31,179,9564,1061,10625,0.00491169,0.0026749,-0.999984,2
5684,3574,29,423,3623,33,238,13604,1178,14782,0.0137782,-0.00205503,-0.999903,2
3295,2580,24,329,2527,23,168,8946,981,9927,-0.00494299,0.00699977,-0.999963,2
4856,3398,35,424,3279,29,218,12239,1200,13439,-0.000788783,-0.00636877,-0.999979,2
4730,3746,31,473,3649,37,284,12950,1406,14356,0.006018,-0.00902725,-0.999941,2
4845,3281,29,381,3201,35,213,11985,1241,13226,0.00258168,0.00803562,-0.999964,2
5214,4133,35,473,3946,25,181,14007,1010,15017,0.00607407,0.0062639,-0.999962,2
3529,2844,22,352,2826,23,183,9779,1019,10798,-0.00354713,0.0105078,-0.999939,2
5137,4020,34,516,3960,39,260,13966,1527,15493,0.00138973,0.0114498,-0.999934,2
3511,3019,30,376,2764,32,212,9944,1090,11034,0.00667767,0.00507753,-0.999965,2
5244,4085,30,462,3667,39,275,13802,1401,15203,0.00467872,-0.00146076,-0.999988,2
4477,3715,61,496,3622,47,275,12693,1378,14071,0.00432707,-0.00520326,-0.999977,2
4685,3629,33,515,3658,35,277,12832,1442,14274,-0.000847969,-0.00499074,-0.999987,2
4953,3942,38,434,3510,41,245,13163,1355,14518,0.0106787,-0.00142143,-0.999942,2
3229,2585,27,338,2603,28,192,9002,969,9971,0.00825797,0.000196626,-0.999966,2
5139,4114,31,528,3834,34,243,13923,1524,15447,0.00411849,0.00543381,-0.999977,2
4579,3734,29,441,3479,31,253,12546,1014,13560,0.00589859,-0.00019528,-0.999983,2
5414,4025,34,550,3752,27,183,13985,1048,15033,0.00232718,0.00282207,-0.999993,2
2741,2166,18,270,2184,18,140,7537,804,8341,0.00488397,-0.00272595,-0.999984,2
5406,4066,35,544,3937,45,274,14307,1694,16001,0.0151119,-0.0121434,-0.999812,2
5103,4085,31,566,4045,40,219,14089,1036,15125,0.00697751,-0.000690014,-0.999975,2
3442,2894,24,393,2827,26,231,9837,1043,10880,0.00387326,-0.00426839,-0.999984,2
5080,4258,36,560,4165,50,301,14450,1477,15927,0.0078066,-0.00271977,-0.999966,2
3532,2804,25,344,2819,30,196,9750,1169,10919,-0.00382094,0.00553803,-0.999977,2
2716,2201,33,336,2099,33,148,7566,801,8367,-0.00102328,0.00578345,-0.999982,2
4564,3620,31,461,3538,35,253,12502,1338,13840,0.000694006,-0.00559078,-0.999984,2
4757,3628,31,470,3534,34,239,12693,1456,14149,0.00561742,-0.00383569,-0.999976,2
5839,3945,40,615,4138,55,277,14909,1488,16397,0.00437317,-0.00308509,-0.999985,2
5066,4029,40,544,3993,42,298,14012,1520,15532,0.00846686,0.000509606,-0.999964,2
5259,4160,36,568,4019,43,288,14373,1285,15658,0.00341676,-0.00147336,-0.999993,2
3465,2818,25,360,2810,27,210,9715,1188,10903,0.00496002,0.000802847,-0.999987,2
5221,4094,38,522,4034,51,276,14236,1574,15810,0.00317199,-0.000135327,-0.999995,2
3447,2837,26,359,2797,28,210,9704,1060,10764,0.00627573,-0.00975336,-0.999933,2
4613,3621,31,468,3522,33,275,12563,1353,13916,0.0073768,0.000162817,-0.999973,2
4750,3676,31,468,3610,34,277,12846,1330,14176,-0.00115091,-0.00237391,-0.999997,2
3246,2601,24,351,2516,26,167,8931,966,9897,0.002051,0.00656916,-0.999976,2
5258,3880,32,423,3817,35,241,13686,1349,15035,0.00663275,-0.00613494,-0.99996,2
4717,3632,32,424,3558,41,179,12583,996,13579,-0.000231275,-0.00369773,-0.999993,2
4624,3653,29,413,3509,33,235,12496,1503,13999,-0.00240496,0.00114941,-0.999997,2
5375,3952,33,461,3681,39,263,13804,1434,15238,0.00692263,-0.00321296,-0.999971,2
3239,2680,22,317,2585,28,183,9054,976,10030,0.00370913,-0.00281905,-0.999989,2
4874,3732,31,452,3612,36,270,13007,1627,14634,0.00518941,-0.000706635,-0.999986,2
5021,4906,27,418,3631,27,196,14226,984,15210,-0.00230795,0.00242162,-0.999994,2
2080,1602,19,212,1638,26,115,5692,638,6330,0.00144477,0.00452489,-0.999989,2
4663,5097,38,592,3775,32,270,14467,1464,15931,0.0103372,-0.00131269,-0.999946,2
4660,3637,32,421,3302,41,224,12317,940,13257,0.0118564,-0.00329098,-0.999924,2
2519,1981,18,227,2204,19,137,7105,789,7894,0.00516787,0.00134044,-0.999986,2
5217,4089,33,520,4028,35,306,14228,1547,15775,-0.000772694,0.00471815,-0.999988,2
4405,2851,23,366,2784,30,211,10670,1042,11712,0.00222516,0.000344159,-0.999998,2
5028,3709,29,430,3599,33,281,13109,1339,14448,-0.00157815,-0.00163065,-0.999997,2
3262,2674,28,342,2516,32,200,9054,977,10031,0.00774265,-0.00856332,-0.999933,2
4659,3624,38,509,3636,44,258,12768,1031,13799,-0.000751466,0.000555829,-1,2
3348,2621,27,341,2552,31,204,9124,942,10066,0.00231203,0.00462754,-0.999987,2
4582,4533,49,514,3293,35,180,13186,988,14174,0.0126089,-0.00970322,-0.999873,2
4547,3603,39,440,3545,60,243,12477,1350,13827,0.000667726,0.00274057,-0.999996,2
4254,3311,32,393,3209,37,224,11460,1190,12650,-0.000295628,-0.0037687,-0.999993,2
4590,3639,39,430,3597,43,246,12584,1395,13979,0.00106743,0.00853408,-0.999963,2
5213,4029,43,488,3824,91,273,13961,1514,15475,-0.0038374,-0.00499578,-0.999981,2
3459,2828,23,333,2763,24,182,9612,1058,10670,-0.00588714,0.000305935,-0.999983,2
4926,3698,37,434,3602,43,255,12995,1527,14522,-0.00593535,-0.00370785,-0.999976,2
4187,3391,27,420,3270,30,246,11571,1238,12809,0.00407057,-0.00920187,-0.999949,2
4119,3324,28,379,3239,46,218,11353,1206,12559,-0.00322005,-0.00369791,-0.999988,2
5094,3982,34,477,4368,53,357,14365,1504,15869,0.0100538,-0.0152427,-0.999834,2
3525,2698,24,324,2724,30,183,9508,1038,10546,-0.00268612,0.0040018,-0.999989,2
4987,3723,29,422,3796,33,306,13296,1332,14628,0.00705256,-0.00384349,-0.999968,2
4593,3772,40,565,3713,34,276,12993,1379,14372,0.00555936,-0.00359958,-0.999978,2
3341,2633,22,354,2584,24,185,9143,959,10102,-0.000101245,-0.0029441,-0.999996,2
4327,3296,28,381,3242,36,216,11526,1232,12758,0.00842784,-0.00671566,-0.999942,2
4607,3715,39,451,4008,45,247,13112,1353,14465,0.0106946,-0.0105621,-0.999887,2
4969,3568,31,420,3516,34,271,12809,1207,14016,0.012546,-0.00700715,-0.999897,2
3202,2613,27,309,2599,32,176,8958,1007,9965,0.00753245,-0.00279442,-0.999968,2
6145,3960,41,515,3973,48,281,14963,1508,16471,0.00873135,-0.0039834,-0.999954,2
4705,4257,23,301,2533,27,166,12012,993,13005,0.00913279,-0.00738402,-0.999931,2
6089,3852,31,466,3789,39,302,14568,1461,16029,0.00536612,-0.00582463,-0.999969,2
3268,2624,23,347,2548,26,195,9031,954,9985,0.0025023,-0.012991,-0.999913,2
4604,3715,31,430,3625,35,241,12681,1405,14086,-0.000312021,0.00184119,-0.999998,2
4775,3579,35,434,3695,34,238,12790,1412,14202,-0.0091285,0.00264605,-0.999955,2
4568,3678,31,479,4312,36,242,13346,1306,14652,0.0030287,-0.00900138,-0.999955,2
3484,2665,21,300,2511,23,192,9196,941,10137,-0.00623096,-0.00316987,-0.999976,2
4975,3242,27,385,3384,41,224,12278,1339,13617,0.00146032,-0.00743367,-0.999971,2
4102,3348,28,374,3234,30,212,11328,1251,12579,0.00581333,-0.0066777,-0.999961,2
3417,2567,25,287,2356,22,156,8830,882,9712,-0.00128198,-0.00297861,-0.999995,2
4706,3804,36,435,3534,46,249,12810,1387,14197,0.00771082,-0.00759059,-0.999942,2
5390,3523,31,476,3533,34,271,13258,1455,14713,0.0038658,-0.0174174,-0.999841,2
4508,3704,44,470,3670,35,276,12707,1372,14079,0.0128709,-0.0100538,-0.999867,2
3759,2719,21,301,2574,26,169,9569,943,10512,0.00654482,-0.0073774,-0.999951,2
5629,4086,37,464,3980,33,320,14549,1624,16173,-0.00667696,-0.00232682,-0.999975,2
5249,4018,33,490,3777,29,181,13777,1083,14860,-0.00201269,-0.00481525,-0.999986,2
5133,3724,33,524,3477,24,189,13104,947,14051,0.00371846,-0.00516983,-0.99998,2
2580,1969,17,261,2048,22,139,7036,760,7796,0.00139259,-0.010944,-0.999939,2
5280,3743,32,430,3600,32,235,13352,1355,14707,-0.00434064,-0.00299848,-0.999986,2
4535,3619,29,467,4082,38,268,13038,1135,14173,0.00338678,-0.00171886,-0.999993,2
3355,2642,23,333,2530,29,195,9107,940,10047,-0.0017745,0.00425178,-0.99999,2
4645,3814,35,481,3618,49,268,12910,1331,14241,0.0102572,0.00296635,-0.999943,2
4722,3791,31,482,3379,23,187,12615,1251,13866,0.00337248,0.000174758,-0.999994,2
5506,3735,31,430,3641,31,240,13614,1400,15014,-0.00520717,-0.00617755,-0.999967,2
4564,3829,32,486,3733,22,199,12865,953,13818,0.000591028,-0.0224171,-0.999749,2
3129,2582,22,323,2493,23,162,8734,905,9639,-0.000376585,-0.0183248,-0.999832,2
5239,4214,33,497,4214,68,322,14587,1543,16130,0.00982778,-0.0160703,-0.999823,2
4656,3645,30,440,3595,35,279,12680,1272,13952,-0.00777659,-0.00746247,-0.999942,2
4191,3328,29,391,3213,31,217,11400,1246,12646,-0.00486662,0.00974995,-0.99994,2
4814,3699,38,488,3601,45,291,12976,1394,14370,0.00669864,0.012982,-0.999894,2
5115,4050,34,544,4075,46,311,14175,1568,15743,-0.00234916,0.0482624,-0.998832,2
3548,2550,18,281,2173,22,163,8755,814,9569,0.00250318,0.0484997,-0.99882,2
2264,1846,14,228,1793,16,132,6293,637,6930,-0.0048623,0.0451989,-0.998966,2
2964,2378,20,301,2401,40,174,8278,892,9170,-0.0122415,0.0548397,-0.99842,2
5206,4112,29,423,3692,50,242,13754,1822,15576,-0.00542336,0.0513783,-0.998665,2
4839,3901,28,410,3288,38,166,12670,1353,14023,0.0124207,0.0515867,-0.998591,2
2557,1831,15,202,1804,20,114,6543,981,7524,0.00311017,0.054675,-0.998499,2
4935,3218,28,367,3314,53,207,12122,1563,13685,0.00596443,0.0589159,-0.998245,2
4810,2913,32,353,2643,32,218,11001,1139,12140,0.00284316,0.0429002,-0.999075,2
5006,2949,33,355,2473,37,160,11013,1579,12592,-0.00683175,0.16283,-0.986631,2
5184,2246,26,311,2350,31,203,10351,1503,11854,-0.00320534,0.167666,-0.985839,2
2485,1148,16,147,1110,32,83,5021,706,5727,0.00135061,0.0892558,-0.996008,2
1621,729,13,91,711,16,53,3234,576,3810,0.0017705,0.0809735,-0.996715,2
4330,1654,32,252,1609,35,116,8028,1386,9414,-0.00087333,0.0691201,-0.997608,2
5024,1736,29,211,1692,41,135,8868,1497,10365,0.00590095,0.0712465,-0.997441,2
5159,1445,28,178,1426,35,110,8381,1387,9768,0.0155769,0.0765518,-0.996944,2
4272,1158,26,157,1143,38,86,6880,1638,8518,0.0260472,0.0783708,-0.996584,2
4245,1159,26,168,1040,40,86,6764,1624,8388,0.0210809,0.0638193,-0.997739,2
4557,1076,26,134,976,45,101,6915,1592,8507,0.0207576,0.0847901,-0.996183,2
4066,826,27,124,836,34,85,5998,1389,7387,0.0211839,0.0918059,-0.995552,2
4424,772,27,120,734,40,66,6183,1545,7728,0.0125898,0.0858141,-0.996232,2
4441,663,30,118,652,42,62,6008,1768,7776,-0.00361845,0.101879,-0.99479,2
4275,552,29,93,560,37,57,5603,1600,7203,-0.0284914,0.0939739,-0.995167,2
4349,519,29,90,433,35,47,5502,1681,7183,0.000315037,0.0694052,-0.997588,2
4140,464,30,95,469,38,52,5288,1590,6878,-0.0177989,0.120848,-0.992512,2
4228,476,33,94,415,39,62,5347,1606,6953,-0.0316829,0.0936507,-0.995101,2
3971,481,38,108,444,67,60,5169,1559,6728,-0.0197305,0.0484506,-0.998631,2
4233,624,36,111,636,53,73,5766,1520,7286,-0.0303759,0.130934,-0.990926,2
4130,839,43,179,701,64,82,6038,1497,7535,-0.0102818,0.0932974,-0.995585,2
4186,871,35,141,910,64,76,6283,1527,7810,0.00498292,0.116362,-0.993195,2
4467,986,28,192,943,42,85,6743,1488,8231,0.0036502,0.0887479,-0.996048,2
4085,1095,27,183,1013,60,85,6548,1342,7890,0.00757998,0.058061,-0.998284,2
4364,1486,36,244,1372,40,145,7687,1607,9294,0.0191892,0.079735,-0.996631,2
4283,1999,29,292,1887,54,179,8723,1557,10280,0.00687089,0.0788055,-0.996866,2
4572,2397,25,289,2244,27,115,9669,949,10618,-0.000705875,0.0886076,-0.996066,2
4244,2923,23,353,2885,31,202,10661,1227,11888,-0.00172838,0.0722158,-0.997387,2
4495,3731,28,484,3725,56,246,12765,1282,14047,-0.00414197,0.0820945,-0.996616,2
3587,3283,19,367,3102,31,225,10614,1132,11746,-0.00709326,0.126629,-0.991925,2
4654,4247,26,502,4181,64,290,13964,1229,15193,-0.0295283,0.127434,-0.991407,2
5616,3509,21,424,2881,43,200,12694,744,13438,-0.0348366,0.142124,-0.989236,2
2088,1956,13,223,2210,24,129,6643,550,7193,-0.04376,0.154072,-0.98709,2
5366,4924,28,557,5273,53,317,16518,1739,18257,-0.022141,0.127805,-0.991552,2
5611,4398,29,524,3623,55,209,14449,980,15429,-0.00623715,0.108434,-0.994084,2
5230,3727,29,447,3309,38,263,13043,1053,14096,-0.0156214,0.0949342,-0.995361,2
3554,2277,20,265,2228,46,154,8544,890,9434,-0.0117091,0.0827246,-0.996504,2
5092,3213,31,393,3119,109,266,12223,1357,13580,-0.0247251,0.074781,-0.996893,2
5052,2889,25,403,3157,53,231,11810,1437,13247,-0.0306861,0.0730166,-0.996859,2
3032,1792,16,189,1578,22,106,6735,819,7554,-0.0217113,0.0710664,-0.997235,2
5627,3011,31,454,2997,41,241,12402,1948,14350,-0.0623017,0.0959949,-0.99343,2
4965,2613,31,385,2467,51,196,10708,1985,12693,-0.0487815,0.115184,-0.992146,2
4838,2256,31,307,2186,47,188,9853,2050,11903,-0.0506056,0.136838,-0.9893,2
4143,1926,28,279,1895,45,175,8491,2230,10721,-0.049348,0.162383,-0.985493,2
4336,1900,30,281,1905,48,154,8654,1999,10653,-0.0944175,0.189796,-0.977273,2
4227,1852,25,272,1770,44,154,8344,1695,10039,-0.108729,0.281071,-0.953508,2
3927,1801,26,246,1801,50,185,8036,1755,9791,-0.105257,0.266334,-0.958117,2
3238,1178,22,228,1179,25,85,5955,855,6810,-0.0984679,0.175854,-0.979479,2
2381,1000,18,149,972,19,72,4611,1036,5647,-0.0627272,0.199264,-0.977936,2
3632,1474,24,206,1443,35,112,6926,1373,8299,-0.0730395,0.195309,-0.978018,2
4133,1740,26,232,1663,37,126,7957,1528,9485,-0.0739347,0.235072,-0.969162,2
4025,1683,27,212,1615,37,151,7750,1580,9330,-0.0733655,0.242269,-0.967431,2
6245,2028,25,238,1694,32,125,10387,1506,11893,-0.0499421,0.24802,-0.967467,2
4311,2012,33,249,1878,50,145,8678,1468,10146,-0.0465623,0.241877,-0.969189,2
4197,2498,35,290,2234,45,165,9464,1487,10951,-0.030505,0.23796,-0.970796,2
4482,2874,41,350,2813,50,207,10817,1570,12387,-0.0143879,0.25232,-0.967537,2
4834,3855,36,441,3780,45,253,13244,1716,14960,-0.00522255,0.257799,-0.966184,2
4447,3898,55,622,3827,55,290,13194,1499,14693,-0.0161386,0.248654,-0.968458,2
4465,4155,38,523,3900,41,229,13351,949,14300,-0.0331987,0.255484,-0.966243,2
3612,3245,27,398,3188,42,239,10751,957,11708,-0.0264622,0.235169,-0.971594,2
5630,5237,38,646,5631,46,237,17465,1030,18495,-0.0603865,0.260072,-0.963699,2
3315,2414,19,258,2348,32,150,8536,769,9305,-0.049509,0.22353,-0.973439,2
5153,3787,34,431,4146,65,351,13967,1709,15676,-0.0751036,0.231829,-0.969853,2
5247,3287,35,476,3367,51,245,12708,1355,14063,-0.0624393,0.189026,-0.979985,2
4047,1961,24,236,1882,34,144,8328,1095,9423,-0.0394645,0.16343,-0.985765,2
4558,2178,33,279,2135,50,170,9403,1909,11312,-0.0450561,0.165875,-0.985117,2
4458,1662,35,244,1736,38,140,8313,1957,10270,-0.0327614,0.187555,-0.981707,2
4042,1325,28,177,1179,43,110,6904,2155,9059,-0.0262948,0.150254,-0.988298,2
4171,1195,29,173,1119,32,93,6812,5216,12028,-0.0225038,0.146646,-0.988933,2
4197,1301,32,191,1281,63,98,7163,6361,13524,0.0657411,0.12787,-0.98961,2
3912,1220,28,189,1158,37,118,6662,5776,12438,0.0269785,0.149248,-0.988432,2
4750,1547,36,200,1463,39,112,8147,5353,13500,-0.00435116,0.17727,-0.984153,2
3236,1067,19,213,1031,25,100,5691,1620,7311,-0.112294,0.148329,-0.982542,2
4476,1253,25,170,1283,37,129,7373,1632,9005,-0.0823906,0.153411,-0.984722,2
4726,1395,28,237,1356,35,130,7907,1667,9574,-0.0340949,0.132394,-0.990611,2
4479,1212,28,183,1199,40,99,7240,1827,9067,-0.079061,0.138217,-0.987241,2
4927,1208,60,228,1122,44,106,7695,1638,9333,-0.0585761,0.124233,-0.990522,2
4483,1134,34,169,1052,56,119,7047,1632,8679,-0.048579,0.12783,-0.990606,2
4639,1055,25,154,935,42,85,6935,1689,8624,0.0188349,0.0614086,-0.997935,2
4489,968,42,145,942,34,97,6717,1581,8298,-0.066775,0.117068,-0.990876,2
4771,915,29,149,861,37,75,6837,1799,8636,0.116589,0.128459,-0.984838,2
4386,955,35,168,907,56,91,6598,2155,8753,0.099254,0.122029,-0.987551,2
2471,488,14,86,469,21,51,3600,948,4548,0.117004,0.0810362,-0.98982,2
4586,1017,28,150,835,46,99,6761,1672,8433,0.120586,0.0798045,-0.98949,2
4444,1002,50,183,917,38,110,6744,1656,8400,0.135096,0.09045,-0.986696,2
4834,976,28,148,985,63,92,7126,1682,8808,0.0867582,0.105055,-0.990675,2
4356,1216,100,212,1119,39,93,7135,1595,8730,-0.0242721,0.163866,-0.986184,2
4624,1406,33,209,1292,46,115,7725,1520,9245,-0.00974744,0.100956,-0.994843,2
4554,1674,27,232,1728,39,128,8382,1512,9894,0.0167634,0.124575,-0.992069,2
4725,2083,48,252,2155,38,150,9451,1552,11003,0.00186318,0.141513,-0.989935,2
4912,2802,26,334,2403,41,174,10692,1625,12317,0.0165901,0.130064,-0.991367,2
5069,3271,77,479,2912,45,238,12091,1507,13598,0.000481327,0.163502,-0.986543,2
3252,1757,20,227,1850,28,142,7276,663,7939,-0.00360963,0.116132,-0.993227,2
1849,1314,10,154,1177,13,88,4605,465,5070,-0.00255718,0.073912,-0.997262,2
5540,4362,27,580,4192,46,280,15027,1066,16093,-0.00316319,0.0940854,-0.995559,2
3513,3103,17,375,2986,27,226,10247,896,11143,-0.0091835,0.0756846,-0.99709,2
4140,3771,20,436,3831,34,245,12477,1108,13585,-0.0229056,0.0739094,-0.997002,2
6730,5252,26,583,4212,27,247,17077,973,18050,-0.0345041,0.100386,-0.99435,2
2989,3058,13,365,3041,25,203,9694,779,10473,-0.0318515,0.0887336,-0.995546,2
3604,3578,17,421,3525,40,236,11421,992,12413,-0.0342355,0.0938276,-0.995,2
5888,5868,24,795,6185,54,269,19083,969,20052,-0.0315384,0.0929365,-0.995173,2
4120,4100,17,483,3601,27,209,12557,743,13300,-0.012102,0.0833743,-0.996445,2
3608,3719,16,425,3676,38,243,11725,839,12564,-0.00536386,0.0747129,-0.99719,2
5794,6127,23,703,4337,46,277,17307,945,18252,-0.016018,0.110825,-0.993711,2
3129,3604,15,402,3346,25,213,10734,787,11521,-0.0333996,0.065095,-0.99732,2
3712,4036,16,467,3998,28,259,12516,904,13420,-0.0176884,0.0291127,-0.99942,2
4719,5017,22,560,4908,36,235,15497,852,16349,-0.0231108,0.031798,-0.999227,2
3496,3719,16,412,3664,45,236,11588,827,12415,-0.0163609,0.0649416,-0.997755,2
6371,6266,23,692,5059,26,269,18706,946,19652,-0.0325396,0.0779162,-0.996429,2
3122,3250,15,362,3319,33,208,10309,743,11052,-0.0199769,0.0678619,-0.997495,2
6074,5850,25,645,5707,55,392,18748,1096,19844,-0.0297562,0.08456,-0.995974,2
4119,3950,17,458,3896,32,256,12728,967,13695,-0.0292418,0.0732317,-0.996886,2
6241,5872,25,672,4584,34,269,17697,1013,18710,-0.0407873,0.0866463,-0.995404,2
3219,3128,15,332,3028,24,186,9932,792,10724,-0.032564,0.0574869,-0.997815,2
6057,5105,27,636,4399,30,221,16475,947,17422,-0.0266859,0.0415178,-0.998782,2
3004,2657,14,307,2646,35,179,8842,812,9654,-0.0255271,0.0207889,-0.999458,2
6194,5548,41,721,4635,43,221,17403,1007,18410,-0.02407,-0.000510704,-0.99971,2
6258,5347,30,688,5691,53,290,18357,1030,19387,-0.03289,0.00247997,-0.999456,2
3078,2272,11,254,2166,21,120,7922,533,8455,-0.0348638,0.0127713,-0.99931,2
1887,1502,7,172,1517,16,101,5202,422,5624,-0.0359272,0.00137902,-0.999353,2
1654,1467,8,165,1436,12,93,4835,435,5270,-0.024554,0.00642469,-0.999678,2
5447,4614,24,590,4849,76,335,15935,1396,17331,-0.0337335,0.0058357,-0.999414,2
7007,5380,26,687,5299,35,273,18707,1021,19728,-0.0352881,0.0145942,-0.999271,2
3052,2282,11,259,2537,33,156,8330,677,9007,-0.0394786,0.0148827,-0.99911,2
1886,1640,9,199,1635,15,113,5497,466,5963,-0.0305279,0.00164947,-0.999533,2
5980,4701,26,528,4513,34,213,15995,989,16984,-0.0348771,0.00598892,-0.999374,2
3851,3340,32,380,3345,27,217,11192,936,12128,-0.0325339,0.00711686,-0.999446,2
5481,4805,22,551,4676,41,302,15878,1330,17208,-0.0372737,-0.00302745,-0.999301,2
4042,3419,17,431,3476,45,245,11675,1072,12747,-0.0335585,0.00558983,-0.999421,2
4912,4384,23,489,4333,76,294,14511,1297,15808,-0.0327689,0.00500839,-0.99945,2
3572,3288,16,385,3244,29,225,10759,942,11701,-0.0305198,0.0060717,-0.999516,2
5521,4831,26,590,4847,59,344,16218,1335,17553,-0.0256202,-1.21214e-05,-0.999672,2
6350,5197,24,588,5148,43,334,17684,1332,19016,-0.0314681,0.0146526,-0.999397,2
2971,2562,11,246,2184,25,152,8151,699,8850,-0.0254912,-6.16165e-05,-0.999675,2
3535,2630,15,328,2288,32,161,8989,629,9618,-0.0240308,0.00443455,-0.999701,2
1831,1626,8,204,1587,14,113,5383,448,5831,-0.0251092,-2.33837e-05,-0.999684,2
4471,4098,20,448,3964,41,265,13307,1263,14570,-0.0301973,0.00235856,-0.999541,2
6151,5223,24,535,4270,38,223,16464,965,17429,-0.0349114,0.00139738,-0.99939,2
3031,2626,14,343,2698,25,170,8907,741,9648,-0.0295483,0.008519,-0.999527,2
6281,5287,34,573,4232,30,264,16701,978,17679,-0.0300037,0.00715693,-0.999524,2
3907,3466,18,446,3431,37,216,11521,985,12506,-0.0320443,0.00377115,-0.99948,2
3935,3641,17,392,3407,43,218,11653,974,12627,-0.0265894,0.00117433,-0.999646,2
6147,5051,26,537,4172,35,218,16186,978,17164,-0.0285247,-0.00676355,-0.99957,2
3000,2653,13,298,2673,36,192,8865,768,9633,-0.0263537,-0.00707456,-0.999628,2
6067,4953,24,602,4716,35,246,16643,981,17624,-0.0212766,-0.00881233,-0.999735,2
4378,3443,17,396,3383,28,230,11875,975,12850,-0.035189,-0.00219026,-0.999378,2
4915,4574,29,493,4404,39,296,14750,1341,16091,-0.0344248,-0.00180843,-0.999406,2
3663,3189,20,360,3198,26,205,10661,957,11618,-0.033536,-0.00397796,-0.99943,2
6130,5448,28,617,5388,56,351,18018,1043,19061,-0.0256236,0.00472311,-0.999661,2
3476,2351,11,286,2166,34,141,8465,538,9003,-0.0305892,0.00692784,-0.999508,2
1862,1557,7,181,1464,14,100,5185,424,5609,-0.0240238,-0.00186117,-0.99971,2
2055,1744,9,213,1725,15,126,5887,499,6386,-0.0355292,0.00103206,-0.999368,2
5845,5090,24,725,4975,40,395,17094,1074,18168,-0.0178338,-0.0211705,-0.999617,2
3880,3678,17,493,3554,32,284,11938,1034,12972,-0.0334019,0.000822198,-0.999442,2
6170,5584,24,674,4728,32,232,17444,1012,18456,-0.0323139,0.00841055,-0.999443,2
3013,2756,14,362,2807,29,221,9202,776,9978,-0.034902,0.00744366,-0.999363,2
6170,5287,22,656,4947,41,391,17514,1072,18586,-0.0393705,0.00547047,-0.99921,2
3919,3603,17,430,3605,44,245,11863,986,12849,-0.039095,0.00363446,-0.999229,2
6195,5706,27,737,5952,50,397,19064,1480,20544,-0.0412877,0.00796038,-0.999116,2
5816,3948,19,471,3794,33,282,14363,1101,15464,-0.0335471,0.00626391,-0.999418,2
4004,3213,17,483,3134,23,195,11069,718,11787,-0.0258928,0.00373957,-0.999658,2
5490,5229,23,602,4670,29,226,16269,1012,17281,-0.030876,-0.00198113,-0.999521,2
