Downsample[ns],BuildFilTree[ns],SearchFil[ns],DeleteFil[ns],BuildTreeSub[ns],SearchSub[ns],DeleteSub[ns],PreProcTotal[ns],Plane[ns],Total[ns],nx,ny,nz,planeCount
6213,4285,90,502,4089,57,273,15509,1587,17096,0.00853718,0.0348667,-0.999356,0
6083,4073,35,479,3436,28,189,14323,1080,15403,0.00487361,0.0335215,-0.999426,0
3130,2162,16,251,2115,21,140,7835,784,8619,0.00615167,0.0336672,-0.999414,0
6029,4077,31,478,4065,46,273,14999,1591,16590,0.00424883,0.0291919,-0.999565,0
4091,2908,21,325,2797,41,191,10374,1025,11399,-0.00188865,0.0238055,-0.999715,0
6096,4077,33,480,3687,37,184,14594,1139,15733,-0.001669,0.0343045,-0.99941,0
4226,2817,21,328,2771,33,187,10383,1095,11478,0.0023082,0.0288082,-0.999582,0
5391,3680,31,433,3588,53,246,13422,1422,14844,0.0041309,0.0304609,-0.999527,0
6043,4095,33,480,4112,70,271,15104,1273,16377,0.000449509,0.0370816,-0.999312,0
4123,2772,21,325,2759,56,187,10243,1119,11362,0.0034424,0.0369329,-0.999312,0
6298,4106,33,510,4031,61,233,15272,1114,16386,0.00436757,0.0431293,-0.99906,0
4241,2842,22,324,2897,54,187,10567,1049,11616,0.000823803,0.0503747,-0.99873,0
4224,2842,26,438,2897,42,185,10654,1059,11713,0.0067208,0.0498064,-0.998736,0
4298,2820,22,329,3130,63,222,10884,1098,11982,0.00470118,0.050083,-0.998734,0
4506,2902,23,353,2851,47,188,10870,1045,11915,0.000829877,0.0429277,-0.999078,0
4557,3222,22,331,2970,41,190,11333,1027,12360,0.00650406,0.0524502,-0.998602,0
4117,2832,21,328,2772,41,184,10295,1006,11301,0.00210902,0.0644464,-0.997919,0
6349,4470,32,505,4401,53,278,16088,1463,17551,-0.00351336,0.0645436,-0.997909,0
4269,3007,22,358,3043,65,297,11061,1240,12301,0.0073821,0.0567417,-0.998362,0
4210,2988,23,365,2915,52,206,10759,1066,11825,0.0108242,0.0575435,-0.998284,0
4383,3255,31,345,2773,82,182,11051,993,12044,0.00767529,0.0605902,-0.998133,0
4230,2799,22,317,2646,39,179,10232,1070,11302,-0.000548921,0.0683418,-0.997661,0
5442,3613,30,413,3563,61,272,13394,1186,14580,0.00358834,0.0843393,-0.996431,0
4041,2639,21,319,2521,31,216,9788,1029,10817,-0.00120075,0.0838424,-0.996478,0
3847,2677,20,301,2598,40,186,9669,933,10602,0.00452831,0.0792276,-0.996846,0
5765,3464,27,384,3392,50,219,13301,1228,14529,0.0113517,0.0759544,-0.997047,0
5282,3457,28,400,2744,48,160,12119,857,12976,0.0130086,0.0703618,-0.997437,0
3422,2346,18,262,2331,28,166,8573,775,9348,0.0126462,0.0893548,-0.99592,0
6177,4018,28,412,3537,42,266,14480,911,15391,0.0126069,0.0963629,-0.995266,0
6264,3873,28,307,2580,49,175,13276,1039,14315,0.0130483,0.0786987,-0.996813,0
5847,3775,32,445,2594,44,172,12909,1029,13938,0.0150543,0.0843873,-0.996319,0
3027,1917,17,225,1861,37,127,7211,785,7996,0.0146579,0.0805731,-0.996641,0
5752,3466,46,420,3416,60,228,13388,1522,14910,0.0177606,0.112885,-0.993449,0
3900,2358,20,290,2278,41,157,9044,1016,10060,0.0155028,0.0902525,-0.995798,0
5656,3254,38,405,3176,61,223,12813,1533,14346,0.00946895,0.0942229,-0.995506,0
5406,3066,30,369,3009,74,206,12160,1456,13616,0.00629691,0.0933126,-0.995617,0
4734,2741,27,318,2535,55,180,10590,1300,11890,0.000805669,0.0973945,-0.995246,0
5858,2809,30,341,2758,61,193,12050,1464,13514,-0.000326553,0.0872761,-0.996185,0
5517,2676,31,328,2628,60,185,11425,1396,12821,0.00418887,0.0893904,-0.995988,0
5051,2488,27,291,2290,55,190,10392,1286,11678,0.0135477,0.0795625,-0.996738,0
4736,2262,26,279,2156,47,186,9692,1471,11163,0.0171608,0.0780587,-0.996801,0
5372,2444,29,307,2442,53,173,10820,1405,12225,0.0120954,0.0857905,-0.99624,0
5612,2677,31,350,2485,39,183,11377,1497,12874,0.0156071,0.073384,-0.997182,0
3777,1861,19,226,1840,40,127,7890,989,8879,0.0216738,0.06952,-0.997345,0
5021,2281,26,312,2297,56,166,10159,1236,11395,0.0237229,0.0780983,-0.996663,0
4917,2188,24,295,2333,85,220,10062,1527,11589,0.0216095,0.0663277,-0.997564,0
5328,2380,30,314,2376,57,174,10659,1368,12027,0.0202016,0.0719163,-0.997206,0
5427,2427,34,304,2312,52,169,10725,1447,12172,0.0184147,0.0778936,-0.996792,0
5740,2296,29,293,1881,36,110,10385,1090,11475,0.0113368,0.0812278,-0.996631,0
3668,1393,20,184,1435,34,104,6838,1086,7924,-0.00998486,0.0836848,-0.996442,0
5636,1960,28,245,1749,45,139,9802,1925,11727,-0.0178421,0.105402,-0.99427,0
5494,1804,31,238,1745,42,131,9485,2422,11907,0.0164152,0.0795254,-0.996698,0
5652,1561,29,217,1487,41,119,9106,2340,11446,0.0187814,0.0702492,-0.997353,0
5417,1500,29,208,1474,37,118,8783,1575,10358,0.0214211,0.0906528,-0.995652,0
3727,1134,19,177,988,25,79,6149,1260,7409,0.0191921,0.086899,-0.996032,0
5403,1562,27,252,1527,37,141,8949,1541,10490,0.024682,0.0868032,-0.99592,0
5855,1885,28,230,1621,25,90,9734,1259,10993,0.0308155,0.0462332,-0.998455,0
3764,1430,21,222,1336,30,116,6919,1069,7988,0.023993,0.0884323,-0.995793,0
5601,2271,28,297,2366,42,210,10815,3253,14068,0.028303,0.101611,-0.994422,0
3917,1725,20,222,1731,28,124,7767,2318,10085,0.0345678,0.0745219,-0.99662,0
5092,2498,26,312,2480,37,182,10627,3377,14004,0.0723266,0.00993097,-0.997332,0
3685,1974,17,237,2029,29,137,8108,1359,9467,0.0250025,0.0789634,-0.996564,0
4785,2934,26,429,2740,40,197,11151,1284,12435,0.0270821,0.0417956,-0.998759,0
4856,2700,30,322,2657,31,179,10775,1118,11893,0.0291017,0.0572345,-0.997937,0
4576,2519,21,301,2538,27,174,10156,1069,11225,0.0179136,0.0678179,-0.997537,0
4552,2516,22,354,2541,27,177,10189,1048,11237,0.0153269,0.0640661,-0.997828,0
4578,2495,23,308,2455,26,175,10060,1057,11117,0.0101407,0.0560097,-0.998379,0
6338,3504,30,452,3607,61,240,14232,1226,15458,0.0127303,0.0593979,-0.998153,0
3358,1869,17,241,1972,21,131,7609,771,8380,0.0231175,0.0585825,-0.998015,0
6043,3766,31,451,3759,39,262,14351,1430,15781,0.0470049,0.157024,-0.986476,0
3184,1937,14,231,1692,15,118,7191,617,7808,0.0376438,0.130028,-0.990796,0
2188,1391,11,155,1293,10,89,5137,454,5591,0.0330599,0.0852008,-0.995815,0
2549,1831,13,218,1805,17,123,6556,616,7172,0.0518864,0.0904876,-0.994545,0
6195,4575,31,529,4503,53,332,16218,1542,17760,0.0499907,0.10348,-0.993374,0
6175,4608,32,531,4165,46,209,15766,1322,17088,0.0133263,0.17666,-0.984182,0
3038,1959,21,226,1882,27,107,7260,744,8004,0.0289042,0.121329,-0.992192,0
1894,1382,11,158,1388,24,89,4946,765,5711,0.0285393,0.115302,-0.992921,0
3229,2343,15,262,2247,23,149,8268,1066,9334,0.0384703,0.0838139,-0.995739,0
6325,4438,28,504,3559,30,197,15081,1282,16363,0.0292119,0.0828677,-0.996132,0
3310,2256,14,256,2180,22,145,8183,925,9108,0.0102079,0.0863745,-0.996211,0
5080,3385,23,393,3393,70,229,12573,1158,13731,0.00346426,0.0954167,-0.995431,0
6340,4028,27,480,3979,66,263,15183,943,16126,0.00320349,0.113421,-0.993542,0
4429,2880,19,347,2984,83,290,11032,1140,12172,-0.0279746,0.114307,-0.993052,0
6415,4284,29,492,4136,58,284,15698,1404,17102,0.0140919,0.0867862,-0.996128,0
4399,2936,19,337,2899,36,194,10820,961,11781,0.0241587,0.0540845,-0.998244,0
6363,4192,28,485,4144,61,282,15555,1165,16720,0.0450999,0.0406488,-0.998155,0
4363,2879,20,329,2856,45,189,10681,1462,12143,0.0319703,0.0246088,-0.999186,0
6282,4056,33,483,3661,39,201,14755,1380,16135,0.0222623,0.0341854,-0.999167,0
4376,2814,21,319,2806,49,218,10603,1353,11956,0.018374,0.00320213,-0.999826,0
6305,4233,32,478,3919,49,184,15200,1455,16655,0.019186,0.0425408,-0.998911,0
4318,2807,23,322,2694,46,211,10421,1158,11579,0.0200401,0.06071,-0.997955,0
6514,4069,31,470,3970,66,270,15390,2289,17679,0.00926322,0.0376609,-0.999248,0
4371,2774,22,340,2596,45,182,10330,1411,11741,0.00174587,0.0416008,-0.999133,0
5699,3410,28,444,3352,58,236,13227,1987,15214,-0.00266133,0.0609761,-0.998136,0
4016,2426,17,295,2785,42,172,9753,1419,11172,-0.00664927,0.0732717,-0.99729,0
3938,2417,18,292,2392,39,185,9281,1393,10674,-0.0154595,0.0754359,-0.997031,0
6219,3875,27,458,3849,62,291,14781,1924,16705,-0.0157074,0.130091,-0.991378,0
4286,2706,18,337,2675,38,188,10248,1227,11475,-0.0136831,0.114796,-0.993295,0
4018,2635,17,319,2620,34,181,9824,947,10771,-0.0166032,0.141789,-0.989758,0
4025,2628,15,319,2962,25,202,10176,892,11068,-0.00639056,0.141666,-0.989894,0
6421,4465,25,602,4473,55,328,16369,1509,17878,0.0105842,0.196161,-0.980515,0
4169,3215,17,404,3181,44,215,11245,1110,12355,0.0151161,0.182706,-0.983051,0
4181,3218,18,378,3257,47,214,11313,1129,12442,0.0252362,0.201731,-0.979116,0
3230,2499,13,294,2711,47,209,9003,896,9899,0.0163638,0.203947,-0.978845,0
3108,2565,14,297,2554,34,172,8744,1062,9806,0.0139077,0.212368,-0.977091,0
6002,5107,25,607,4970,67,331,17109,1752,18861,0.00793586,0.270067,-0.962809,0
4591,3566,20,404,3482,45,224,12332,1109,13441,0.000415199,0.254407,-0.967097,0
4091,3359,18,401,3374,60,360,11663,1450,13113,-0.0102947,0.27391,-0.9617,0
4196,3316,22,448,3354,39,219,11594,1125,12719,-0.0139494,0.241545,-0.970289,0
6303,4950,34,548,4277,53,222,16387,1041,17428,-0.0160901,0.228869,-0.973325,0
3984,2926,20,318,2878,48,185,10359,1026,11385,-0.0171119,0.224351,-0.974358,0
5135,3554,26,405,3493,66,228,12907,1272,14179,-0.0141915,0.246957,-0.968923,0
3829,2676,19,297,2634,36,170,9661,992,10653,-0.00412613,0.221682,-0.97511,0
6159,4507,31,515,3584,51,201,15048,1066,16114,-0.00305695,0.206551,-0.978431,0
3278,2520,18,292,2422,30,164,8724,828,9552,-0.00457855,0.199588,-0.979869,0
6267,4848,30,573,4759,63,334,16874,1287,18161,-0.00185693,0.203141,-0.979148,0
3399,2806,19,353,3125,38,194,9934,767,10701,0.004477,0.154715,-0.987949,0
6299,5354,36,626,5316,49,239,17919,1024,18943,0.00061313,0.154857,-0.987936,0
4371,3549,23,429,3463,47,256,12138,840,12978,0.00328192,0.136909,-0.990578,0
3909,3183,20,371,3115,36,211,10845,927,11772,0.00578568,0.128681,-0.991669,0
6119,4843,28,587,4642,36,224,16479,1011,17490,0.00462287,0.113513,-0.993526,0
3167,2553,15,306,2589,45,171,8846,773,9619,0.00786807,0.0890761,-0.995994,0
5972,4831,30,578,4903,52,325,16691,1470,18161,0.00789555,0.0672797,-0.997703,0
4268,3444,33,394,3356,53,239,11787,1138,12925,0.00694486,0.0523811,-0.998603,0
5367,4426,28,541,4264,60,288,14974,1558,16532,0.00758302,0.0459119,-0.998917,0
3909,3037,19,375,3007,43,206,10596,1050,11646,0.00782687,0.0501171,-0.998713,0
6097,4838,29,568,4762,75,317,16686,1210,17896,0.0114584,0.0737858,-0.997208,0
4066,3419,20,399,3304,50,220,11478,1029,12507,0.00402517,0.102211,-0.994754,0
5311,4339,26,511,4224,63,282,14756,1116,15872,0.000371346,0.13824,-0.990399,0
3847,3086,19,356,2989,48,219,10564,1036,11600,-0.00738408,0.149034,-0.988805,0
5881,4662,28,543,4687,61,314,16176,1512,17688,0.00776404,0.180264,-0.983588,0
4046,4039,50,584,4632,56,315,13722,1200,14922,0.0151709,0.181349,-0.983302,0
3073,2350,15,282,2299,32,176,8227,735,8962,0.016644,0.159708,-0.987024,0
6045,4330,28,575,4417,61,305,15761,1410,17171,-0.00462725,0.172019,-0.985083,0
4118,3060,20,363,2961,38,203,10763,878,11641,-0.014539,0.142849,-0.989638,0
5725,4337,28,518,4241,55,284,15188,1378,16566,-0.00931821,0.139144,-0.990228,0
3912,2955,45,337,2818,36,193,10296,1002,11298,-0.00439624,0.127617,-0.991814,0
5728,3989,28,467,4012,52,267,14543,1396,15939,0.00167448,0.18772,-0.982221,0
4038,1990,16,232,1917,27,133,8353,798,9151,0.00223557,0.181125,-0.983458,0
2045,1230,10,151,1010,15,71,4532,562,5094,0.00673824,0.147372,-0.989058,0
2132,1086,11,135,1093,23,78,4558,884,5442,0.00761115,0.140023,-0.990119,0
5695,2567,32,385,2464,76,188,11407,2100,13507,0.00278295,0.150056,-0.988674,0
5519,2194,27,285,2143,46,169,10383,2363,12746,0.00343085,0.142528,-0.989785,0
5200,1760,24,236,1778,54,137,9189,2439,11628,0.00203382,0.142235,-0.989831,0
5431,1993,36,345,1895,57,143,9900,2095,11995,0.00168673,0.159481,-0.9872,0
5725,1812,28,260,1711,56,135,9727,1990,11717,0.00322389,0.153247,-0.988183,0
4350,1338,19,172,1256,38,97,7270,1312,8582,0.00366255,0.148955,-0.988837,0
3925,1491,18,193,1473,38,112,7250,1539,8789,-0.00370525,0.142613,-0.989772,0
5438,2127,24,281,2118,44,159,10191,1741,11932,0.0136165,0.152326,-0.988236,0
5093,2385,32,420,2440,42,172,10584,1682,12266,0.0213028,0.11753,-0.992841,0
5392,2472,26,312,2383,36,179,10800,1536,12336,0.0270516,0.098909,-0.994729,0
5857,2839,31,365,2881,40,207,12220,1565,13785,0.022028,0.11481,-0.993143,0
5985,3001,31,381,3004,36,219,12657,1416,14073,0.0228893,0.0970401,-0.995017,0
4276,2320,21,279,2212,25,159,9292,990,10282,0.0176907,0.103493,-0.994473,0
6027,3302,28,413,3251,58,283,13362,1608,14970,0.017587,0.14978,-0.988563,0
4945,2414,20,287,1757,22,124,9569,1429,10998,0.0221702,0.0959853,-0.995136,0
2322,1267,14,166,1234,13,88,5104,504,5608,0.0249254,0.0871326,-0.995885,0
6278,3632,31,441,3718,35,173,14308,979,15287,0.0302801,0.11359,-0.993066,0
3185,1502,11,187,1489,17,105,6496,592,7088,0.0302031,0.0727692,-0.996891,0
5908,3828,41,554,3581,49,249,14210,1577,15787,0.0318439,0.102329,-0.994241,0
4000,2470,21,295,2424,36,167,9413,1249,10662,0.0244693,0.104575,-0.994216,0
6091,3452,30,413,3436,56,237,13715,1862,15577,0.0348264,0.0900631,-0.995327,0
4129,2464,21,278,2354,45,171,9462,1306,10768,0.024951,0.031176,-0.999203,0
6087,3412,30,406,3360,52,265,13612,2083,15695,0.00929638,0.0673296,-0.997688,0
4225,2333,21,312,2276,37,174,9378,1413,10791,0.0180338,0.0984143,-0.994982,0
5552,3128,25,381,3092,56,208,12442,1971,14413,0.00133982,0.142813,-0.989749,0
6159,3384,27,403,3302,60,265,13600,2097,15697,0.00755033,0.13172,-0.991258,0
4319,2385,20,291,2315,35,161,9526,1293,10819,0.0133213,0.0771536,-0.99693,0
6335,3768,27,450,3594,86,268,14528,1688,16216,0.00589213,0.0833469,-0.996503,0
4305,2700,18,310,2607,47,186,10173,1227,11400,0.00134793,0.0502193,-0.998737,0
6542,4074,28,502,4651,101,324,16222,1856,18078,0.0386332,0.0623846,-0.997304,0
3390,1784,11,208,1781,36,118,7328,656,7984,0.0285113,0.00914859,-0.999552,0
1952,1297,9,154,1264,24,86,4786,486,5272,0.0172211,-0.0877887,-0.99599,0
2844,1760,14,211,1963,49,124,6965,1025,7990,0.00110318,-0.0993556,-0.995051,0
6237,3763,27,484,3926,62,357,14856,2642,17498,-0.0268262,-0.0213124,-0.999413,0
4342,2530,20,303,2505,32,174,9906,2326,12232,-0.012855,-0.0834675,-0.996428,0
5014,2838,26,339,2855,41,198,11311,1982,13293,-0.0241694,0.025599,-0.99938,0
5084,2757,25,380,2675,42,194,11157,1835,12992,-0.0285141,0.0401028,-0.998789,0
3743,2343,21,249,1985,31,136,8508,2162,10670,-0.0796738,0.198844,-0.976787,0
4607,2623,23,319,2559,36,176,10343,2562,12905,-0.0439246,0.127447,-0.990872,0
6315,3519,30,449,3481,48,227,14069,3385,17454,-0.0301489,0.054621,-0.998052,0
3283,1749,16,213,1705,78,123,7167,2377,9544,-0.0307867,0.102223,-0.994285,0
5127,2661,25,341,2667,54,190,11065,4694,15759,-0.0538285,0.0703248,-0.996071,0
4960,2700,22,351,2739,55,202,11029,4445,15474,-0.02179,0.168057,-0.985537,0
3695,1942,16,234,1919,29,135,7970,4577,12547,-0.0276494,0.152505,-0.987916,0
4465,2492,20,299,2514,50,188,10028,3608,13636,-0.0451007,0.106546,-0.993285,0
4913,3360,21,340,2716,60,208,11618,3111,14729,0.00491369,0.19467,-0.980857,0
3281,2163,15,257,2119,27,164,8026,1600,9626,0.00399047,0.172456,-0.985009,0
4360,3090,30,442,2901,37,195,11055,1028,12083,0.00484503,0.212238,-0.977206,0
5524,4022,23,501,4389,42,212,14713,960,15673,-0.00078135,0.240337,-0.970689,0
3802,2959,17,349,2937,37,199,10300,933,11233,-0.00599032,0.238738,-0.971066,0
4840,4170,23,445,3690,51,246,13465,1233,14698,-0.00432993,0.222466,-0.974931,0
4800,3687,22,429,3589,74,224,12825,913,13738,-0.006186,0.197137,-0.980357,0
3505,2675,17,306,2686,45,206,9440,931,10371,-0.00378694,0.171626,-0.985155,0
4511,3256,20,398,3170,60,240,11655,1199,12854,-0.0046134,0.158176,-0.9874,0
4384,3191,20,395,3087,50,215,11342,1240,12582,-0.00582048,0.152682,-0.988258,0
4237,3125,20,366,3083,50,213,11094,1104,12198,-0.00653794,0.147649,-0.989018,0
5741,4085,28,489,4027,68,278,14716,1191,15907,-0.0106596,0.135247,-0.990755,0
3896,2795,19,328,2741,47,191,10017,998,11015,-0.00647587,0.127525,-0.991814,0
5753,3946,28,468,3942,65,269,14471,1441,15912,-0.002823,0.14091,-0.990019,0
5148,3515,25,419,3445,59,238,12849,1336,14185,-0.000671274,0.132428,-0.991192,0
5709,3806,29,499,3734,67,267,14111,1455,15566,-0.000293201,0.135347,-0.990799,0
5614,3771,26,446,3107,48,178,13190,1002,14192,-0.0040473,0.126157,-0.992003,0
3632,2406,19,285,2316,44,161,8863,931,9794,-0.00600434,0.113343,-0.993538,0
5752,3632,28,440,3560,68,248,13728,1510,15238,-0.0101769,0.114733,-0.993344,0
5820,3710,28,436,3601,72,250,13917,1485,15402,-0.0106014,0.105916,-0.994319,0
5584,3619,29,439,3168,47,174,13060,1039,14099,-0.00743175,0.0975798,-0.9952,0
3909,2550,20,303,2463,47,196,9488,980,10468,-0.0059403,0.107456,-0.994192,0
5642,3681,29,449,3591,70,255,13717,1557,15274,-0.00467233,0.105279,-0.994432,0
5676,3695,28,450,3558,45,177,13629,987,14616,-0.0074253,0.114666,-0.993376,0
3915,2568,21,328,2483,47,175,9537,1022,10559,-0.006169,0.116789,-0.993137,0
4068,2619,20,312,2469,45,192,9725,1004,10729,-0.00472004,0.118093,-0.992991,0
5910,3775,29,485,3663,65,206,14133,1032,15165,-0.00321509,0.107574,-0.994192,0
4057,2599,19,326,2471,45,176,9693,1027,10720,-0.00576424,0.0937235,-0.995582,0
5995,3648,28,437,3873,68,268,14317,1443,15760,-0.00552128,0.110042,-0.993912,0
3282,1930,13,232,1564,27,107,7155,607,7762,-0.00713256,0.102451,-0.994713,0
2058,1308,12,159,1297,24,90,4948,541,5489,-0.00693965,0.107914,-0.994136,0
8834,5236,37,682,5101,67,256,20213,1286,21499,-0.00422096,0.113874,-0.993486,0
1774,1097,9,134,1087,19,77,4197,488,4685,-0.00546209,0.105224,-0.994433,0
5686,3541,27,452,3491,62,250,13509,1442,14951,-0.00715379,0.12086,-0.992644,0
6481,3531,28,465,2906,44,172,13627,1075,14702,-0.00993876,0.106934,-0.994217,0
3044,1868,26,231,1858,34,130,7191,760,7951,-0.0052068,0.112266,-0.993665,0
5909,3596,28,440,3509,65,251,13798,1448,15246,-0.00464195,0.0855956,-0.99632,0
5728,3611,30,437,3503,76,270,13655,1383,15038,-0.00876037,0.123263,-0.992335,0
5724,3499,29,481,3520,63,251,13567,1178,14745,-0.00755609,0.123243,-0.992348,0
3942,2429,20,302,2506,46,174,9419,998,10417,-0.00965152,0.116151,-0.993185,0
5652,3569,28,436,3489,63,246,13483,1509,14992,-0.00903049,0.110021,-0.993888,0
3966,2437,19,316,2407,43,172,9360,968,10328,-0.00887648,0.110529,-0.993833,0
5730,3487,29,454,3456,64,243,13463,1502,14965,-0.0127191,0.120113,-0.992679,0
4058,2480,22,344,2592,45,173,9714,1029,10743,-0.0119943,0.107641,-0.994118,0
6639,3619,29,430,3116,45,172,14050,1033,15083,-0.00656068,0.121101,-0.992618,0
3991,2373,20,313,2425,45,166,9333,1044,10377,-0.00748624,0.12709,-0.991863,0
5886,3436,29,441,3385,68,241,13486,1460,14946,-0.00563739,0.125971,-0.992018,0
3974,2380,19,289,2290,47,162,9161,982,10143,-0.00856519,0.137416,-0.990476,0
5364,3096,25,376,3033,61,224,12179,1248,13427,-0.0117555,0.128094,-0.991692,0
5954,3091,43,370,3071,61,214,12804,1307,14111,-0.00855236,0.122874,-0.992385,0
5944,3496,48,447,3504,68,234,13741,1310,15051,-0.00414577,0.122355,-0.992478,0
4158,2517,25,294,2337,62,177,9570,1021,10591,-0.00478683,0.112063,-0.99369,0
3663,2253,18,261,2165,46,153,8559,1037,9596,-0.008447,0.10485,-0.994452,0
6081,3578,28,413,3762,71,246,14179,1418,15597,-0.00898003,0.11289,-0.993567,0
4596,2334,20,286,2363,47,162,9808,1014,10822,-0.00943522,0.119092,-0.992838,0
5663,3358,29,411,3308,65,236,13070,1450,14520,-0.00982337,0.11298,-0.993549,0
5909,3463,29,411,3642,103,294,13851,1079,14930,-0.00995415,0.115301,-0.993281,0
5945,3568,30,454,2447,48,163,12655,955,13610,-0.0111702,0.126442,-0.991911,0
2879,1753,14,223,1650,33,170,6722,713,7435,-0.00880289,0.101437,-0.994803,0
4228,2565,23,327,2526,50,180,9899,1046,10945,-0.00817819,0.0951047,-0.995434,0
4510,2606,20,354,2598,49,181,10318,1065,11383,-0.0112761,0.107088,-0.994186,0
4016,2512,19,287,2289,59,164,9346,979,10325,-0.0128583,0.103773,-0.994518,0
5405,3143,24,379,3094,59,239,12343,1073,13416,-0.00877935,0.0992968,-0.995019,0
3635,2331,19,280,2176,41,155,8637,961,9598,-0.010894,0.10243,-0.994681,0
4838,2957,23,351,2749,52,196,11166,1256,12422,-0.00880362,0.105606,-0.994369,0
6384,3143,25,358,2767,54,198,12929,1209,14138,-0.00871158,0.125051,-0.992112,0
6642,3550,27,428,3460,66,246,14419,1303,15722,-0.00863313,0.136863,-0.990553,0
3876,2368,19,288,2340,45,163,9099,970,10069,-0.00876514,0.107682,-0.994147,0
5895,3668,28,421,3492,92,245,13841,1492,15333,-0.00884065,0.12136,-0.992569,0
3922,2374,19,302,2305,46,163,9131,945,10076,-0.00923562,0.082023,-0.996588,0
5777,3553,27,438,3413,68,252,13528,1515,15043,-0.00840379,0.113513,-0.993501,0
5784,3519,28,428,2728,58,173,12718,1033,13751,-0.0086878,0.122924,-0.992378,0
3060,1897,16,223,1866,35,127,7224,793,8017,-0.00980618,0.119466,-0.99279,0
5789,3541,50,423,3477,69,243,13592,1413,15005,-0.014756,0.109731,-0.993852,0
5565,3472,27,420,3431,66,243,13224,1429,14653,-0.0101878,0.104756,-0.994446,0
3911,2362,20,291,2364,47,165,9160,970,10130,-0.00960757,0.114793,-0.993343,0
5760,3526,30,420,3495,68,243,13542,1490,15032,-0.0109672,0.122526,-0.992405,0
3912,2386,20,289,2386,46,167,9206,1026,10232,-0.00983389,0.124181,-0.992211,0
5941,3487,29,430,3401,79,238,13605,1504,15109,-0.00989897,0.129059,-0.991588,0
5679,3482,28,441,3189,47,180,13046,1033,14079,-0.0118731,0.122689,-0.992374,0
4156,2443,21,304,2295,47,180,9446,991,10437,-0.00913304,0.128738,-0.991637,0
5850,3486,28,422,3412,66,267,13531,1460,14991,-0.0107148,0.100978,-0.994831,0
5694,3412,28,412,2830,45,172,12593,961,13554,-0.0147481,0.106578,-0.994195,0
3963,2387,18,290,2302,45,161,9166,1000,10166,-0.00855107,0.0983229,-0.995118,0
5711,3388,29,411,3378,67,264,13248,1439,14687,-0.0107785,0.124753,-0.992129,0
5972,3417,35,425,3162,54,171,13236,996,14232,-0.0090336,0.129185,-0.991579,1
3957,2343,44,285,2358,49,163,9199,1045,10244,-0.00660636,0.127416,-0.991828,1
5688,3389,28,429,3380,74,234,13222,1440,14662,-0.0112275,0.12716,-0.991819,1
5869,3454,27,410,3151,53,164,13128,1059,14187,-0.0154499,0.109749,-0.993839,1
3873,2288,19,280,2308,55,159,8982,998,9980,-0.01746,0.128044,-0.991615,1
5815,3340,28,436,3400,119,363,13501,1418,14919,-0.0134751,0.117228,-0.993014,1
3185,1749,14,213,1558,38,99,6856,605,7461,-0.00913068,0.129034,-0.991598,1
2029,1223,11,145,1157,27,81,4673,509,5182,0.00286933,0.0656027,-0.997842,1
4056,2317,21,276,2209,52,156,9087,971,10058,-0.00791892,0.126426,-0.991944,1
5704,3343,27,431,3541,78,235,13359,1452,14811,-0.0102834,0.117813,-0.992983,1
5769,3255,29,460,2260,52,158,11983,979,12962,-0.010512,0.113288,-0.993507,1
3024,1733,15,206,1710,38,117,6843,750,7593,-0.00919913,0.111542,-0.993718,1
5738,3283,28,396,3217,77,228,12967,1454,14421,-0.0119301,0.12597,-0.991962,1
5822,3266,29,396,3162,52,157,12884,988,13872,-0.00661889,0.119976,-0.992755,1
3953,2231,19,301,2193,53,158,8908,967,9875,0.00603621,0.0585092,-0.998269,1
5880,3176,28,391,3194,77,224,12970,1449,14419,-0.00607691,0.125979,-0.992014,1
6412,3201,27,391,2836,44,155,13066,988,14054,-0.00558128,0.117806,-0.993021,1
3890,2245,20,266,2154,50,166,8791,960,9751,-0.00618443,0.112297,-0.993656,1
6020,3271,28,388,3166,76,226,13175,1391,14566,-0.00578683,0.133979,-0.990968,1
3905,2186,19,266,2151,49,153,8729,998,9727,-0.00680812,0.124874,-0.992149,1
8093,3213,28,385,3322,82,229,15352,1021,16373,0.00458802,0.0687237,-0.997625,1
3003,1652,15,204,1618,39,114,6645,797,7442,-0.0034117,0.0805338,-0.996746,1
5634,3146,29,382,3088,64,217,12560,1407,13967,-0.00618009,0.135326,-0.990782,1
5935,3179,29,383,3126,77,219,12948,1407,14355,-0.00446396,0.135862,-0.990718,1
3836,2154,20,259,2093,42,149,8553,969,9522,-0.00282719,0.127411,-0.991846,1
5398,2788,27,335,2715,57,202,11522,1230,12752,-0.00454423,0.126712,-0.991929,1
5726,2766,27,342,2752,95,196,11904,1260,13164,-0.000740216,0.127686,-0.991814,1
3625,1979,18,234,1884,39,133,7912,911,8823,-0.00120042,0.128788,-0.991672,1
5633,3047,45,373,2982,78,215,12373,1416,13789,-0.00246718,0.122497,-0.992466,1
5697,3032,30,369,3041,71,212,12452,1284,13736,-0.0022928,0.120899,-0.992662,1
4171,2079,43,251,2041,46,144,8775,966,9741,-0.00263485,0.126782,-0.991927,1
6847,2955,28,416,2940,64,206,13456,1238,14694,0.00609679,0.148277,-0.988927,1
3936,2021,20,256,1936,41,135,8345,971,9316,-0.000669264,0.13644,-0.990648,1
5873,2820,31,368,2878,64,204,12238,1388,13626,-0.000115448,0.144046,-0.989571,1
5719,2831,31,344,3160,84,201,12370,1135,13505,0.00203157,0.112959,-0.993598,1
5362,2570,27,313,2516,70,179,11037,1280,12317,-0.00289206,0.0631351,-0.998001,1
5106,2894,29,346,2536,63,178,11152,1288,12440,-0.000912211,0.127918,-0.991784,1
5901,2835,28,343,2821,86,193,12207,1431,13638,0.00260926,0.094599,-0.995512,1
5226,2619,35,316,2474,59,177,10906,1246,12152,0.000568239,0.126729,-0.991937,1
5736,2822,31,343,2760,66,195,11953,1635,13588,-0.00259258,0.146961,-0.989139,1
4007,1944,22,227,1834,61,126,8221,957,9178,0.0035483,0.151183,-0.9885,1
6029,2615,31,333,2533,66,181,11788,1479,13267,-0.00189888,0.164879,-0.986312,1
6056,2577,31,362,2580,43,181,11830,994,12824,0.000764218,0.160422,-0.987048,1
6015,2680,31,329,2646,47,185,11933,1454,13387,0.0106307,0.207689,-0.978137,1
3792,1476,16,180,1466,37,122,7089,760,7849,0.0145539,0.168465,-0.9856,1
2074,1146,14,180,1089,22,76,4601,506,5107,-0.00659088,0.110845,-0.993816,1
6304,3129,31,380,3115,55,214,13228,1534,14762,-0.0177499,0.0868195,-0.996066,1
6175,3276,34,392,3227,56,166,13326,958,14284,0.00296995,0.00547031,-0.999981,1
4597,2355,23,279,2266,60,157,9737,996,10733,0.0103587,-0.00657266,-0.999925,1
4163,2398,25,327,2346,51,167,9477,978,10455,0.0137256,-0.00709145,-0.999881,1
6074,3740,34,489,3710,49,252,14348,1407,15755,0.0224968,0.00954462,-0.999701,1
4210,2647,22,326,2619,38,183,10045,1012,11057,0.0293857,-0.00178641,-0.999567,1
5993,4081,31,496,3991,32,188,14812,981,15793,0.0315133,0.00503298,-0.999491,1
4106,2843,21,329,2759,35,190,10283,995,11278,0.0267287,0.00433398,-0.999634,1
5956,4024,31,482,3931,60,274,14758,1320,16078,0.0166208,0.0238742,-0.999577,1
4107,2735,21,336,2628,40,181,10048,995,11043,0.0209682,0.00710822,-0.999755,1
5786,3929,31,471,3880,54,260,14411,1427,15838,0.00274507,0.0141855,-0.999896,1
4252,2595,20,303,2547,31,189,9937,958,10895,0.00279621,-0.0100328,-0.999946,1
4058,2686,24,317,2521,35,240,9881,1035,10916,-0.000726783,-0.0299351,-0.999551,1
5110,3229,25,427,3326,46,220,12383,1599,13982,-0.00476281,0.0117452,-0.99992,1
8144,3924,33,405,3358,47,228,16139,1560,17699,0.00175728,-0.000729022,-0.999998,1
3703,2473,17,276,2305,30,159,8963,853,9816,0.0177832,0.0377869,-0.999128,1
5906,3458,27,426,3607,70,264,13758,2072,15830,0.012026,0.0470871,-0.998818,1
5941,3332,29,435,3077,54,164,13032,1636,14668,-0.0105201,0.0336943,-0.999377,1
5238,2905,26,373,2760,40,209,11551,2460,14011,-0.0240387,0.0326243,-0.999179,1
5144,2597,26,341,2700,42,205,11055,2906,13961,-0.0117734,0.0522162,-0.998566,1
4582,1955,23,248,1974,34,147,8963,4421,13384,-0.00956859,0.0546652,-0.998459,1
4486,1445,24,211,1375,32,108,7681,5603,13284,0.0522869,0.161892,-0.985422,1
4553,1177,24,169,1124,28,91,7166,3374,10540,0.00419485,0.0538789,-0.998539,1
4359,1134,22,159,1114,31,90,6909,6204,13113,0.0684101,0.223453,-0.972311,1
5286,1487,29,213,1440,37,118,8610,3573,12183,-0.0270352,0.0486848,-0.998449,1
5575,2273,38,370,2147,43,154,10600,3247,13847,-0.00631615,0.105147,-0.994437,1
4106,1645,20,227,1559,28,120,7705,2215,9920,-0.0280592,0.013288,-0.999518,1
4128,1917,25,365,2232,28,135,8830,1754,10584,-0.0158428,0.103325,-0.994522,1
5817,2915,30,362,2799,60,186,12169,2488,14657,-0.00838815,0.118419,-0.992928,1
4070,2047,22,260,2037,51,170,8657,1256,9913,-0.00639441,0.00182427,-0.999978,1
5376,2777,29,378,2990,79,295,11924,1960,13884,0.0106629,0.0776771,-0.996922,1
3987,1976,20,266,1962,35,137,8383,1756,10139,0.0234292,0.066421,-0.997517,1
5750,3487,30,343,2668,73,201,12552,2260,14812,0.0112366,0.03417,-0.999353,1
3806,1835,24,233,1846,37,132,7913,1245,9158,0.0141271,0.0577771,-0.99823,1
4863,2280,25,289,2231,50,160,9898,1766,11664,0.0262429,0.0781447,-0.996597,1
4740,2159,25,277,2085,49,154,9489,1675,11164,-0.00391339,0.118525,-0.992944,1
5891,2529,28,316,2446,58,179,11447,2621,14068,-0.00749935,0.12015,-0.992727,1
5165,2137,23,268,2098,74,151,9916,2006,11922,-0.00103528,0.166785,-0.985993,1
5836,2330,27,293,2316,46,167,11015,2772,13787,0.0359604,0.134368,-0.990279,1
4092,1591,19,201,1542,50,114,7609,2491,10100,0.0303526,0.141995,-0.989402,1
5867,2190,22,256,2130,43,145,10653,2113,12766,-0.0393052,0.0104624,-0.999173,1
5457,2210,31,276,2175,69,158,10376,2112,12488,-0.0337027,-0.0230079,-0.999167,1
5407,2506,24,293,2362,48,168,10808,1480,12288,-0.0159856,-0.0119239,-0.999801,1
6099,2847,24,315,2822,55,183,12345,1282,13627,0.0280397,-0.0010516,-0.999606,1
5561,2692,24,319,2677,50,185,11508,1265,12773,-0.00437117,-0.0536013,-0.998553,1
5378,2705,25,331,2656,39,190,11324,1294,12618,-0.0161105,-0.0663738,-0.997665,1
4957,2454,24,300,2430,35,172,10372,1172,11544,-0.00702862,-0.0921218,-0.995723,1
5939,2993,28,373,2880,56,208,12477,1671,14148,-0.0104786,-0.096015,-0.995325,1
4131,1996,21,246,1947,38,142,8521,1175,9696,-0.0164436,-0.104208,-0.99442,1
5926,2764,30,343,2793,60,196,12112,1528,13640,-0.00898846,-0.0547519,-0.99846,1
5826,2609,28,333,2563,52,185,11596,1113,12709,-0.00853788,-0.00446599,-0.999954,1
4120,1689,32,218,1643,31,121,7854,1130,8984,-0.0210036,-0.0434719,-0.998834,1
5849,2441,29,376,2383,43,176,11297,2116,13413,-0.0391946,-0.0328788,-0.99869,1
5826,2454,28,309,2321,28,122,11088,2110,13198,-0.0329677,0.0511412,-0.998147,1
3869,1585,18,204,1545,31,116,7368,2707,10075,-0.0369154,0.0390035,-0.998557,1
5845,2403,32,298,2267,33,155,11033,4156,15189,-0.022679,0.0983036,-0.994898,1
5630,2157,25,282,1849,48,110,10101,1762,11863,-0.0197333,0.0769434,-0.99684,1
2872,1337,13,175,1188,28,91,5704,1132,6836,-0.0743178,0.0791428,-0.994089,1
4369,2103,19,262,1978,44,151,8926,1390,10316,-0.0104753,0.0840008,-0.996411,1
4352,2208,43,278,2720,52,164,9817,1174,10991,-0.0118311,0.0970657,-0.995208,1
4413,2364,19,297,2311,41,169,9614,1112,10726,-0.0157845,0.0557616,-0.998319,1
4946,2589,20,306,2363,43,173,10440,1197,11637,-0.0120893,0.0559914,-0.998358,1
4195,2381,19,316,2382,39,167,9499,1427,10926,-0.01748,0.074019,-0.997104,1
4215,2379,19,313,2244,36,197,9403,1196,10599,-0.0164927,0.0675805,-0.997578,1
4938,2713,23,545,3400,46,203,11868,1325,13193,-0.0171511,0.0742218,-0.997094,1
5300,2655,23,336,2778,46,213,11351,1293,12644,-0.0175895,0.0623526,-0.997899,1
3462,1809,17,229,1768,31,131,7447,903,8350,-0.0169881,0.0623645,-0.997909,1
5516,2516,23,305,2316,44,175,10895,1271,12166,-0.0420365,0.0873803,-0.995288,1
5546,2601,32,351,2546,80,186,11342,1430,12772,-0.0458785,0.0803271,-0.995712,1
5722,2468,29,313,2460,66,181,11239,1482,12721,-0.031586,0.0582797,-0.997801,1
4014,1795,20,216,1670,63,123,7901,1037,8938,-0.0111836,0.0506006,-0.998657,1
5741,2330,31,293,2317,67,184,10963,1428,12391,0.00145374,0.0647466,-0.997901,1
5735,2272,31,284,2372,70,166,10930,1480,12410,-0.013011,0.0417337,-0.999044,1
5744,2567,32,316,2401,83,175,11318,1452,12770,-0.0331666,0.0406356,-0.998623,1
3971,1871,21,229,1815,46,131,8084,1006,9090,-0.0444587,0.00864199,-0.998974,1
5855,2779,30,367,2710,45,197,11983,1513,13496,-0.0397748,0.0456131,-0.998167,1
5842,2903,29,380,2877,64,205,12300,1217,13517,-0.0220935,0.0175742,-0.999601,1
3986,2161,21,260,2101,46,145,8720,994,9714,-0.00874938,0.0349722,-0.99935,1
5519,3171,29,398,3097,57,215,12486,1636,14122,0.00999482,0.0461904,-0.998883,1
5693,3022,29,362,3142,68,207,12523,1409,13932,0.0249017,0.171949,-0.984792,1
5497,2080,20,268,2022,40,140,10067,781,10848,0.0163628,0.130526,-0.99131,1
2320,1270,11,153,1233,24,74,5085,566,5651,0.019758,0.0472124,-0.99869,1
5412,3013,27,360,2913,54,218,11997,1895,13892,-0.0159429,0.0829403,-0.996427,1
5512,2627,26,335,2628,46,195,11369,1862,13231,-0.026406,0.111106,-0.993458,1
3473,1886,18,232,1889,33,129,7660,1238,8898,-0.0124059,0.0722484,-0.99731,1
5554,2789,29,358,2869,55,206,11860,2474,14334,-0.0243547,0.101903,-0.994496,1
4923,2637,27,298,2128,39,163,10215,4073,14288,-0.0261846,0.0913344,-0.995476,1
3621,1367,19,200,1348,28,105,6688,4002,10690,-0.0131111,0.0839079,-0.996387,1
5552,1914,31,270,1807,39,130,9743,5379,15122,-0.0151247,0.0729389,-0.997222,1
5410,1712,28,233,1622,37,131,9173,9116,18289,-0.0410157,0.181105,-0.982608,1
2331,655,13,94,619,16,51,3779,2663,6442,-0.000213242,0.0330187,-0.999455,1
5339,1443,30,212,1431,58,142,8655,6345,15000,0.00311439,0.0512649,-0.99868,1
5424,1629,29,232,1616,42,158,9130,5216,14346,0.0154172,0.0106798,-0.999824,1
3849,1342,20,224,1280,36,101,6852,2876,9728,0.0332789,0.025178,-0.999129,1
5103,2013,26,275,1976,50,155,9598,5630,15228,-0.0581956,0.0329176,-0.997762,1
5312,2296,27,300,2199,50,164,10348,4072,14420,-0.0411516,0.042078,-0.998267,1
4773,2264,26,291,2215,50,194,9813,1805,11618,-0.0687518,0.0339454,-0.997056,1
5684,2964,32,376,2787,65,206,12114,2016,14130,-0.0630618,0.0513676,-0.996687,1
5661,2878,30,368,2816,53,233,12039,1979,14018,-0.0852316,0.0294824,-0.995925,1
5735,2864,30,365,2818,42,206,12060,1912,13972,-0.0351921,0.0227526,-0.999122,1
4014,1904,22,241,1871,32,137,8221,1339,9560,-0.0363242,0.0112045,-0.999278,1
5720,2615,30,328,2532,74,196,11495,1831,13326,0.00129733,0.0416573,-0.999131,1
5651,2515,28,309,2420,46,175,11144,1631,12775,0.000230378,-0.0203064,-0.999794,1
5804,2405,27,301,2320,54,172,11083,1824,12907,0.0331167,-0.0234662,-0.999176,1
5290,2050,24,256,1951,77,143,9791,1726,11517,0.00567809,0.00353535,-0.999978,1
5308,1946,30,249,1886,78,141,9638,1657,11295,0.00822748,-0.019836,-0.99977,1
5726,2115,25,276,2053,52,154,10401,1695,12096,0.0228433,-0.0426248,-0.99883,1
5828,2227,25,281,2197,60,162,10780,1439,12219,0.0116786,-0.0284563,-0.999527,1
5777,2225,25,332,2223,69,165,10816,1448,12264,0.0239384,-0.00611535,-0.999695,1
5750,2271,26,283,2261,61,168,10820,1423,12243,0.0205637,-0.0164953,-0.999653,1
3938,1952,19,222,1523,60,114,7828,960,8788,0.0270969,-0.0423592,-0.998735,1
6297,2120,27,286,2054,49,173,11006,1436,12442,-0.00595572,0.032512,-0.999454,1
5778,2098,29,275,1672,32,106,9990,1352,11342,-0.0120103,-0.01335,-0.999839,1
2821,802,11,104,791,22,61,4612,723,5335,-0.0144518,-0.0932712,-0.995536,1
2659,840,13,113,817,24,63,4529,986,5515,-0.00258618,-0.112852,-0.993608,1
5944,1667,30,222,1549,44,124,9580,1756,11336,-0.0292753,-0.0776089,-0.996554,1
5460,1408,29,192,1321,41,106,8557,2252,10809,-0.0309734,-0.0886118,-0.995585,1
3838,914,20,143,880,45,70,5910,2866,8776,-0.092953,-0.0577017,-0.993997,1
5505,1351,28,188,1306,45,107,8530,6881,15411,-0.0179158,-0.068328,-0.997502,1
5517,1455,32,202,1529,47,119,8901,5520,14421,-0.110979,-0.0389521,-0.993059,1
2867,868,14,124,820,27,79,4799,3658,8457,-0.108423,-0.0705299,-0.9916,1
5558,1796,25,243,1732,41,141,9536,7527,17063,-0.090065,0.00580315,-0.995919,1
3811,1374,20,207,1411,29,109,6961,-1000,-1000,-1,-1,-1,1
2372,967,10,129,971,17,74,4540,2222,6762,-0.0754624,0.0231032,-0.996881,1
5647,2626,25,335,2481,46,193,11353,4171,15524,-0.0611996,0.076515,-0.995189,1
5553,2748,24,361,2703,44,207,11640,2497,14137,-0.0828086,0.0719157,-0.993967,1
3765,1968,17,254,1966,31,145,8146,1617,9763,-0.0536702,0.0854551,-0.994896,1
5323,2831,25,364,2810,44,212,11609,1768,13377,-0.0086764,0.134706,-0.990848,1
5349,2715,25,358,2709,45,205,11406,1457,12863,-0.00975828,0.127926,-0.991736,1
3694,1844,18,240,1841,34,139,7810,952,8762,-0.0155591,0.0986691,-0.994999,1
5271,2448,26,329,2497,59,191,10821,1359,12180,-0.0120759,0.107835,-0.994096,1
5261,2265,26,305,2242,54,177,10330,1453,11783,-0.00867936,0.0922416,-0.995699,1
5390,2045,28,281,2061,67,161,10033,1571,11604,-0.0183363,0.0936131,-0.99544,1
5583,1948,30,264,2068,101,224,10218,1817,12035,-0.0260927,0.0723633,-0.997037,1
5578,1324,21,177,1296,49,99,8544,1104,9648,-0.0429054,0.0671266,-0.996822,1
6030,1800,32,238,1767,68,136,10071,1518,11589,-0.0296678,0.0431639,-0.998627,1
5539,1825,31,235,1674,61,130,9495,1492,10987,-0.0320468,0.0349636,-0.998875,1
5822,1947,31,251,1850,68,139,10108,1460,11568,-0.0395404,0.0702429,-0.996746,1
5615,1939,38,273,1753,47,98,9763,1076,10839,-0.0285877,0.0456367,-0.998549,1
5162,1753,27,227,1758,68,133,9128,1317,10445,-0.0295243,0.0380776,-0.998839,1
5699,2639,36,256,1858,102,146,10736,1396,12132,-0.0144115,0.0327662,-0.999359,1
5617,1879,29,249,1938,70,153,9935,1411,11346,-0.0181837,0.0193043,-0.999648,1
6247,1838,29,237,1767,74,141,10333,1435,11768,-0.00539412,-0.000220572,-0.999986,1
5085,1818,27,241,1696,69,135,9071,1461,10532,0.00766558,-0.00569329,-0.999955,1
5117,1947,27,254,1964,65,145,9519,1372,10891,0.00715014,0.0372755,-0.99928,1
4945,2005,26,266,1949,63,149,9403,1415,10818,0.00555753,0.0170166,-0.99984,1
4989,2176,27,284,2488,56,167,10187,1369,11556,0.0153298,0.100501,-0.994819,1
5071,1649,18,214,1565,36,121,8674,956,9630,0.0119609,0.0493072,-0.998712,1
2706,1319,13,171,1295,29,98,5631,784,6415,0.00991078,0.0116886,-0.999882,1
5253,2520,26,332,2522,48,193,10894,1685,12579,-0.000211891,0.0194877,-0.99981,1
5134,2336,29,313,2284,37,175,10308,6302,16610,-0.047148,0.0174741,-0.998735,1
3786,1449,19,197,1436,26,111,7024,4753,11777,-0.0500078,0.00546028,-0.998734,1
5229,1759,29,242,1651,36,137,9083,7829,16912,-0.0229233,-0.0153448,-0.999619,1
3696,1112,20,147,993,36,82,6086,4762,10848,-0.100966,0.0462375,-0.993815,1
5309,1303,28,188,1249,57,108,8242,6826,15068,-0.0717919,0.0229172,-0.997156,1
3604,811,18,119,757,36,65,5410,3957,9367,-0.0594507,0.0226888,-0.997973,1
5700,1170,27,165,1091,52,93,8298,10500,18798,-0.0684722,0.0722899,-0.995031,1
3631,778,25,114,706,25,63,5342,5321,10663,-0.0416142,0.0677259,-0.996836,1
5216,1253,28,173,1046,38,93,7847,7276,15123,-0.0186253,0.0490122,-0.998624,1
3809,812,19,144,783,35,70,5672,5998,11670,-0.0168477,0.0925698,-0.995564,1
5222,1337,46,208,1269,38,110,8230,8380,16610,-0.0395016,0.0135832,-0.999128,1
3676,1095,19,182,1130,26,90,6218,3919,10137,0.00902967,0.00249577,-0.999956,1
5538,1832,27,254,1837,40,146,9674,3604,13278,0.00830512,0.0487097,-0.998779,1
5548,2057,28,276,2007,47,153,10116,2429,12545,0.00700222,0.0107343,-0.999918,1
3937,1533,20,205,1540,24,117,7376,2053,9429,0.0133058,-0.0121996,-0.999837,1
5799,2201,26,290,2540,43,198,11097,2150,13247,0.0145803,0.0265193,-0.999542,1
5151,2338,26,329,2273,39,174,10330,1859,12189,0.00639302,0.0258767,-0.999645,1
3639,1717,19,268,1722,28,131,7524,1250,8774,0.00516017,-0.00972904,-0.99994,1
5857,2998,30,366,2790,57,213,12311,2220,14531,-0.00754187,0.0326535,-0.999438,1
5831,2780,28,381,2983,31,149,12183,1352,13535,-0.0115474,-0.0050677,-0.999921,1
3021,1439,14,187,1415,23,105,6204,1101,7305,0.00472671,-0.0143149,-0.999887,1
5869,2747,28,370,2583,41,197,11835,1942,13777,-0.0303246,-0.0320595,-0.999026,1
5834,2735,38,542,3264,54,207,12674,1352,14026,0.00989065,-0.0261055,-0.99961,1
5757,2540,31,327,2419,54,183,11311,1636,12947,0.0206957,-0.0407682,-0.998954,1
5570,2511,29,315,2368,86,216,11095,1698,12793,0.0127885,-0.0324956,-0.99939,1
3084,1202,15,163,1171,30,91,5756,1430,7186,0.00459328,-0.0480224,-0.998836,1
5902,2622,31,399,2395,87,171,11607,2597,14204,-0.0235411,-0.0414597,-0.998863,1
4288,1801,20,224,1460,45,115,7953,1676,9629,-0.015343,-0.0392488,-0.999112,1
2599,942,12,121,879,25,69,4647,886,5533,0.000506817,-0.063344,-0.997992,1
2039,761,10,102,739,27,58,3736,813,4549,0.00521488,-0.0912058,-0.995818,1
5741,2170,26,282,2134,55,163,10571,2333,12904,0.0105733,-0.052709,-0.998554,1
5842,2227,28,303,2125,52,160,10737,2210,12947,-0.0307764,-0.128629,-0.991215,1
4001,1484,18,190,1446,35,108,7282,2087,9369,-0.0322083,-0.101754,-0.994289,1
5820,2173,27,277,2272,89,165,10823,2569,13392,-0.00835579,-0.14461,-0.989454,1
5893,2207,28,295,2531,137,214,11305,2478,13783,0.00589754,-0.193677,-0.981048,1
4005,1523,18,192,1474,45,106,7363,1548,8911,0.0205955,-0.0815073,-0.99646,1
5933,2073,25,312,2144,55,159,10701,2164,12865,0.0657739,-0.114716,-0.991218,1
5998,2112,32,312,2142,50,160,10806,2218,13024,0.0210013,-0.0816466,-0.99644,1
4024,1503,19,191,1414,33,125,7309,1415,8724,0.03896,-0.0903876,-0.995145,1
5913,2088,27,271,2425,74,208,11006,1505,12511,0.0186604,-0.0896019,-0.995803,1
5961,2219,26,309,2069,71,187,10842,1523,12365,0.00475062,-0.0981414,-0.995161,1
4333,1477,24,197,1409,42,108,7590,974,8564,0.00389287,-0.102582,-0.994717,1
4052,1419,19,200,1412,43,108,7253,990,8243,0.0194906,-0.0982846,-0.994967,1
5205,1881,31,261,1967,77,141,9563,1295,10858,0.00357084,-0.101224,-0.994857,1
5728,2162,26,245,1849,82,161,10253,1603,11856,0.025554,-0.0645826,-0.997585,1
4623,1697,21,217,1632,57,124,8371,1311,9682,0.00221075,-0.0973264,-0.99525,1
5747,2035,25,264,2009,80,191,10351,1458,11809,-0.00144126,-0.0978249,-0.995202,1
5713,2034,28,261,1918,89,147,10190,1230,11420,0.00434159,-0.0944802,-0.995517,1
5660,2009,28,260,1942,82,175,10156,1443,11599,0.00646335,-0.0982963,-0.995136,1
5689,1927,27,256,1928,98,146,10071,1691,11762,-0.00567046,-0.0921857,-0.995726,1
5660,2045,27,252,1925,79,144,10132,1820,11952,-0.00845622,-0.103371,-0.994607,1
6104,1822,28,246,1809,57,142,10208,2786,12994,0.013385,-0.131337,-0.991247,1
5894,1882,28,271,1840,79,144,10138,2100,12238,-0.0249386,-0.171416,-0.984883,1
3953,1258,20,164,1183,51,95,6724,1722,8446,-0.0369714,-0.129376,-0.990906,1
5888,1709,52,233,1656,71,132,9741,3011,12752,-0.0104338,-0.236599,-0.971551,1
5782,1600,30,259,1410,48,87,9216,1866,11082,-0.00157897,-0.168799,-0.985649,1
3862,1091,20,197,1070,49,86,6375,1571,7946,-0.00666235,-0.17701,-0.984187,1
5679,1506,31,228,1570,81,126,9221,2176,11397,-0.00703548,-0.161806,-0.986798,1
5709,1518,31,226,1559,78,121,9242,2589,11831,-0.0110713,-0.151063,-0.988462,1
5606,1478,29,211,1409,78,117,8928,2377,11305,-0.00604063,-0.157638,-0.987479,1
5824,1463,30,209,1426,54,118,9124,2679,11803,-0.00492574,-0.152711,-0.988259,1
3787,1048,20,143,1156,48,116,6318,1681,7999,-0.0114639,-0.112933,-0.993536,1
5708,1489,29,210,1440,54,118,9048,2326,11374,-0.0197268,-0.107145,-0.994048,1
5584,1487,29,256,1469,67,156,9048,2735,11783,-0.0272396,-0.0961917,-0.99499,1
3889,1076,21,149,1024,38,83,6280,2163,8443,-0.0234967,-0.146693,-0.988903,1
4804,1299,23,181,1249,44,101,7701,3207,10908,-0.0197052,-0.104562,-0.994323,1
6019,1722,30,236,1794,65,134,10000,4479,14479,-0.0275223,-0.0107381,-0.999564,1
5573,1688,28,235,1640,56,134,9354,3266,12620,-0.0127362,0.0232374,-0.999649,1
3904,1163,18,162,1133,37,96,6513,3069,9582,0.00890085,-0.00206367,-0.999958,1
3825,1292,17,168,1227,36,104,6669,1961,8630,0.00725718,0.00522572,-0.99996,1
5641,2058,25,296,1954,51,157,10182,2566,12748,-0.00585711,0.161278,-0.986892,1
5232,1564,17,204,1514,35,118,8684,1116,9800,-0.0102125,0.0960311,-0.995326,1
2442,1036,11,137,1023,21,78,4748,787,5535,-0.0108629,0.0655115,-0.997793,1
5709,2704,25,360,2984,62,240,12084,1615,13699,-0.0277519,0.100159,-0.994584,1
5532,2928,24,376,2829,47,207,11943,1846,13789,-0.0274852,0.112727,-0.993246,1
5609,2910,25,369,2840,48,212,12013,1328,13341,-0.0426243,0.0770206,-0.996118,1
3806,1931,17,252,1984,34,144,8168,984,9152,-0.0309954,0.0941165,-0.995079,1
5355,2706,25,350,2641,50,205,11332,1399,12731,-0.0152069,0.129731,-0.991433,1
5269,2552,25,337,2511,54,185,10933,1385,12318,-0.00911055,0.112476,-0.993613,1
5237,2305,26,307,2234,55,173,10337,1471,11808,0.00467907,0.105431,-0.994416,1
5297,2046,29,305,2071,57,162,9967,1519,11486,0.00990843,0.0956638,-0.995364,1
5368,1915,30,260,1866,62,150,9651,1628,11279,-0.00116029,0.0669304,-0.997757,1
5518,1892,30,260,1782,69,143,9694,1690,11384,-0.0106393,0.0457005,-0.998899,1
5541,1666,31,225,1625,64,127,9279,1653,10932,0.000327534,0.0306799,-0.999529,1
5472,1614,32,239,1655,69,129,9210,1547,10757,-0.0176399,0.0303302,-0.999384,1
5644,1830,31,249,1758,76,137,9725,1498,11223,-0.00982883,0.016059,-0.999823,1
5525,1786,32,243,1765,72,143,9566,1464,11030,-0.00596908,0.0364048,-0.999319,1
5896,1951,31,271,1886,92,147,10274,1454,11728,0.0054234,0.0454137,-0.998954,1
6540,2143,31,300,2015,92,188,11309,1540,12849,0.00621013,0.0687922,-0.997612,1
3934,1447,24,185,1421,55,108,7174,986,8160,0.0221278,0.0382513,-0.999023,1
4929,1821,27,243,1786,58,139,9003,1323,10326,0.0244638,0.0333105,-0.999146,1
5300,1987,27,263,1918,42,150,9687,1461,11148,0.0174126,0.00681279,-0.999825,1
5344,2039,30,293,2016,56,153,9931,1401,11332,0.00682877,0.0142507,-0.999875,1
6025,1977,29,296,1964,55,154,10500,1436,11936,0.00852419,-0.00141851,-0.999962,1
3620,1375,20,183,1321,44,106,6669,999,7668,0.010125,-0.00791748,-0.999918,1
6202,2002,29,315,1890,60,149,10647,1425,12072,0.0151874,-0.00140211,-0.999884,1
5151,1985,28,266,1949,58,153,9590,1248,10838,0.0181764,-0.00500242,-0.999823,1
4643,1940,25,260,1835,50,142,8895,1438,10333,0.0170064,-0.020937,-0.999636,1
5152,2109,28,295,2013,60,155,9812,1571,11383,0.00586657,0.0170776,-0.999837,1
5144,2073,28,280,2062,62,160,9809,1438,11247,0.000324433,1.72448e-05,-1,1
5265,2158,28,287,2080,47,162,10027,1776,11803,-0.00506377,0.00388086,-0.999979,1
5834,2513,32,297,2083,47,163,10969,2630,13599,-0.00852644,0.03584,-0.999321,1
4462,1449,19,199,1429,28,110,7696,3348,11044,-0.0169647,0.0200539,-0.999655,1
4842,1862,24,247,1742,36,141,8894,3728,12622,-0.0321047,0.0480962,-0.998327,1
5002,1679,26,232,1601,37,131,8708,5739,14447,-0.0204451,0.0935486,-0.995405,1
5402,1566,30,228,1527,40,144,8937,3763,12700,-0.0159573,0.0931074,-0.995528,1
3686,906,20,132,882,27,76,5729,9184,14913,-0.0238682,0.0745889,-0.996929,1
3031,735,17,108,709,26,61,4687,4468,9155,-0.100854,0.0839039,-0.991357,1
5383,1122,28,165,1052,57,91,7898,-1000,-1000,-1,-1,-1,1
2535,697,15,82,528,25,48,3930,-1000,-1000,-1,-1,-1,1
2075,489,11,72,464,23,40,3174,4094,7268,-0.124107,0.0686991,-0.989888,1
5297,1413,27,213,1286,60,108,8404,5953,14357,0.00283384,0.0663151,-0.997795,1
5710,1764,30,226,1488,56,124,9398,4073,13471,-0.0799016,0.0834695,-0.993302,1
3546,1078,19,153,1041,32,85,5954,7735,13689,0.000200156,0.0445129,-0.999009,1
4601,1597,29,256,1529,34,122,8168,4295,12463,0.00734579,0.0649286,-0.997863,1
5866,2378,36,298,2130,42,167,10917,5263,16180,-0.0059702,0.0252181,-0.999664,1
3902,1649,20,215,1579,25,122,7512,2485,9997,0.0109805,0.0802732,-0.996713,1
5914,2680,29,334,2584,51,191,11783,3051,14834,0.0131782,0.0847871,-0.996312,1
3920,1849,22,244,1802,28,148,8013,1875,9888,0.0112315,0.0641724,-0.997876,1
5307,2461,26,323,2367,36,181,10701,2051,12752,0.00253289,0.0586157,-0.998277,1
5186,2517,28,367,2587,49,211,10945,1775,12720,0.00526093,0.0611051,-0.998118,1
3734,1735,23,229,1664,24,126,7535,1025,8560,0.0159897,0.0153623,-0.999754,1
4273,1640,19,266,1576,28,125,7927,1114,9041,0.02131,0.0112644,-0.999709,1
5791,2497,29,319,2402,67,260,11365,1684,13049,0.0190414,-0.0297114,-0.999377,1
5394,2153,26,280,2039,42,159,10093,1460,11553,0.0219375,-0.00951434,-0.999714,1
4689,1904,23,247,1815,63,172,8913,1940,10853,0.026318,0.00271142,-0.99965,1
4802,1820,22,241,1768,56,140,8849,1524,10373,0.0226173,-0.00530126,-0.99973,1
5405,1811,24,239,1755,35,143,9412,2258,11670,0.0112298,0.0132685,-0.999849,1
5761,1882,23,245,2435,100,147,10593,2000,12593,0.0243362,-0.0132496,-0.999616,1
5262,1859,38,235,1787,60,165,9406,1660,11066,0.00614466,-0.00976503,-0.999934,1
3613,1342,17,166,1239,64,96,6537,1220,7757,0.00917805,-0.0367559,-0.999282,1
5677,2037,25,295,2058,86,152,10330,1502,11832,-0.00907231,-0.0323605,-0.999435,1
5646,2033,24,269,2006,58,105,10141,989,11130,-0.0144918,-0.0268264,-0.999535,1
6168,2017,26,261,1918,93,155,10638,1386,12024,-0.0380233,0.0490298,-0.998073,1
5779,2010,25,255,2047,105,151,10372,1382,11754,-0.0325411,0.0313017,-0.99898,1
2770,796,12,105,776,32,61,4552,765,5317,-0.00217254,-0.0462231,-0.998929,1
2692,832,14,112,819,29,64,4562,978,5540,-0.00578089,-0.0974227,-0.995227,1
6167,1739,30,239,1832,109,137,10253,2428,12681,0.00878488,-0.100657,-0.994883,1
5772,1682,30,232,1637,78,132,9563,2845,12408,-0.00335593,-0.0900011,-0.995936,1
5658,1656,50,224,1679,116,165,9548,2062,11610,0.00844592,-0.119091,-0.992847,1
5432,1546,28,224,1678,90,169,9167,2225,11392,-0.0125265,-0.0706118,-0.997425,1
5446,1492,31,213,1436,61,117,8796,2372,11168,-0.0160022,-0.0757881,-0.996996,1
5521,1523,31,214,1506,67,118,8980,2024,11004,-0.0361804,-0.0646981,-0.997249,1
5776,1507,30,215,1449,62,114,9153,1926,11079,-0.046807,-0.0579685,-0.99722,1
5587,1496,30,216,1736,80,124,9269,2934,12203,-0.0608712,-0.0623424,-0.996197,1
5541,1730,27,238,1578,60,134,9308,3199,12507,-0.0582067,-0.0421919,-0.997412,1
3843,1172,18,164,1278,40,98,6613,1975,8588,-0.0622897,-0.0700096,-0.9956,1
4975,1704,23,248,1643,40,134,8767,2875,11642,-0.0481305,-0.046531,-0.997757,1
5622,1988,25,276,1881,44,151,9987,2105,12092,-0.0327185,-0.00273278,-0.999461,1
5521,2127,25,289,2068,55,164,10249,2323,12572,-0.02323,0.0293134,-0.9993,1
5017,2106,45,279,1992,47,158,9644,1699,11343,-0.0199808,-0.0053945,-0.999786,1
5001,2268,22,294,2234,52,173,10044,1796,11840,-0.02574,0.0482749,-0.998502,1
4953,2412,21,309,2296,27,149,10167,1251,11418,-0.0275664,0.0274298,-0.999243,1
3462,1820,15,229,1833,29,134,7522,953,8475,-0.0352234,0.00741208,-0.999352,1
5864,2893,27,407,3004,44,244,12483,1449,13932,-0.0372928,0.0502793,-0.998038,1
5301,2809,27,385,2711,42,204,11479,1552,13031,-0.0200341,0.0329308,-0.999257,1
5230,2721,27,353,2647,38,202,11218,2474,13692,-0.0172562,0.0378239,-0.999135,1
5354,2556,27,338,2516,37,192,11020,2661,13681,-0.0715767,0.179308,-0.981186,1
3318,1282,14,169,1240,19,94,6136,748,6884,-0.0654645,0.122854,-0.990263,1
1860,791,7,90,660,11,50,3469,439,3908,-0.0541551,0.0616406,-0.996628,1
3428,1243,17,168,1192,30,95,6173,933,7106,-0.0767207,0.105213,-0.991486,1
5459,1872,30,252,1780,75,143,9611,1516,11127,-0.0477558,0.234302,-0.97099,1
5709,1970,42,357,1655,67,98,9898,963,10861,-0.0292154,0.170012,-0.985009,1
2941,678,12,94,664,29,53,4471,627,5098,-0.0227587,0.0669697,-0.997495,1
2624,771,14,106,742,30,60,4347,713,5060,-0.0299595,0.0683203,-0.997214,1
5712,1764,30,235,1664,68,131,9604,1560,11164,-0.0492581,0.0597622,-0.996997,1
5571,1790,31,260,1659,85,132,9528,1503,11031,-0.0319461,0.0366793,-0.998817,1
5735,1687,29,230,1624,71,127,9503,1540,11043,0.00502592,0.0924049,-0.995709,1
5400,1676,29,233,1600,63,133,9134,1512,10646,0.00815715,0.0965194,-0.995298,1
3175,955,15,127,925,32,71,5300,749,6049,-0.00306773,0.0378287,-0.99928,1
1889,651,11,92,640,22,56,3361,527,3888,-0.00258399,0.0127074,-0.999916,1
6366,2058,34,288,1997,57,153,10953,1474,12427,-0.00780576,0.0538973,-0.998516,1
5344,2149,27,284,2119,62,162,10147,1367,11514,-0.00923694,0.0487232,-0.99877,1
4357,1622,18,251,1616,41,118,8023,945,8968,-0.00942627,0.0473599,-0.998833,1
4890,2142,24,281,2164,59,164,9724,1445,11169,-0.00615642,0.0726839,-0.997336,1
4838,2098,23,277,2072,46,161,9515,1803,11318,0.000616116,0.0547878,-0.998498,1
5469,2217,26,301,2186,47,169,10415,2833,13248,-0.00210015,0.0744586,-0.997222,1
6064,2409,26,285,2091,41,159,11075,3423,14498,-0.0203532,0.0826316,-0.996372,1
3827,1344,16,143,1056,22,81,6489,2180,8669,-0.00656336,0.04999,-0.998728,1
2179,638,11,97,617,15,51,3608,2045,5653,-0.0131676,0.0307026,-0.999442,1
1853,556,11,77,535,18,44,3094,2385,5479,-0.0180185,0.00622081,-0.999819,1
5532,1478,30,258,1466,47,116,8927,5856,14783,0.0147178,-0.00278362,-0.999888,1
5558,1255,28,185,1195,50,103,8374,6412,14786,-0.0147752,0.0359819,-0.999243,1
4030,800,18,119,799,41,66,5873,6548,12421,-0.0613491,0.0651419,-0.995988,1
2962,563,15,105,547,31,48,4271,8377,12648,-0.0294831,0.0332651,-0.999012,1
2873,531,16,84,515,23,45,4087,-1000,-1000,-1,-1,-1,1
5252,1017,29,156,993,41,87,7575,-1000,-1000,-1,-1,-1,1
2139,407,10,60,375,21,32,3044,-1000,-1000,-1,-1,-1,1
1426,316,7,47,302,13,25,2136,1415,3551,0.00251602,-0.01077,-0.999939,1
1859,564,10,78,536,12,44,3103,1549,4652,0.00855671,0.0213693,-0.999735,1
5812,1967,29,272,1925,48,154,10207,5680,15887,-0.0174826,0.0703559,-0.997369,1
5816,2284,30,308,2312,54,263,11067,3019,14086,-0.0277241,0.0631178,-0.997621,1
6149,2665,36,370,2474,40,195,11929,3610,15539,-0.0133082,0.114341,-0.993352,1
3304,1375,16,182,1339,21,113,6350,1531,7881,-0.0310211,0.0643265,-0.997447,1
2024,994,12,128,966,15,72,4211,771,4982,-0.00679748,-0.00448451,-0.999967,1
5738,2742,54,360,2741,45,204,11884,2034,13918,-0.0390028,0.0135637,-0.999147,1
5923,2617,31,344,2606,44,198,11763,2265,14028,0.00220773,-0.00187101,-0.999996,1
3941,1713,20,225,1733,33,128,7793,1498,9291,-0.0217349,-0.0169989,-0.999619,1
5662,2651,32,314,2430,50,205,11344,2360,13704,0.00590555,0.0254631,-0.999659,1
5737,2254,28,299,2188,87,168,10761,2102,12863,0.0132913,0.0122779,-0.999836,1
6270,2224,28,322,1941,36,115,10936,1982,12918,-0.0739653,-0.057379,-0.995609,1
3976,1466,18,190,1455,68,110,7283,1698,8981,0.0421224,-0.0350764,-0.998497,1
5716,2073,27,264,2043,76,154,10353,2084,12437,0.0114614,0.0453174,-0.998907,1
5729,1994,26,256,1663,53,103,9824,1074,10898,0.00371565,0.0369126,-0.999312,1
2716,845,11,108,792,23,61,4556,657,5213,0.00183911,-0.0272056,-0.999628,1
2034,696,10,89,660,23,51,3563,547,4110,0.00791932,-0.0542486,-0.998496,1
5729,1928,26,245,1851,83,140,10002,1509,11511,0.0143578,-0.0345765,-0.999299,1
5831,2020,32,374,2170,71,141,10639,1619,12258,0.0117801,-0.0262325,-0.999587,1
5718,1825,27,230,1732,75,141,9748,1929,11677,-0.00318644,-0.0832585,-0.996523,1
5693,1702,27,234,1647,75,130,9508,1990,11498,-0.0101291,-0.132613,-0.991116,1
6301,1653,29,226,1526,83,124,9942,1864,11806,-0.0160316,-0.127217,-0.991745,1
5720,1644,27,225,1527,75,127,9345,2701,12046,-0.031733,-0.163591,-0.986018,1
5047,1538,27,206,1469,69,117,8473,2628,11101,-0.0212285,-0.14324,-0.98946,1
5781,1742,30,232,1631,74,151,9641,2254,11895,-0.0250358,-0.125603,-0.991765,1
5592,1820,30,236,1656,60,134,9528,2609,12137,-0.0126925,-0.13928,-0.990172,1
4920,1541,26,209,1870,57,124,8747,1929,10676,-0.0176971,-0.0890282,-0.995872,1
5739,1736,29,236,1621,66,131,9558,2486,12044,-0.00751225,0.0425366,-0.999067,1
5334,1183,20,161,1151,42,95,7986,2023,10009,-0.0148562,-0.00769488,-0.99986,1
2169,643,11,84,606,22,46,3581,1281,4862,-0.0202499,-0.062056,-0.997867,1
2395,722,11,96,697,19,54,3994,1408,5402,-0.00936245,-0.0501142,-0.9987,1
5922,1935,35,301,1824,52,146,10215,5231,15446,-0.00233243,-0.0144045,-0.999894,1
5519,1901,28,291,1796,51,147,9733,6748,16481,0.00518519,0.0107023,-0.999929,1
5869,2036,28,279,1952,49,155,10368,5247,15615,-0.0213847,0.0231364,-0.999504,1
6759,2078,26,287,2063,58,113,11384,3625,15009,-0.0779117,0.093877,-0.992531,1
2584,983,10,135,956,21,75,4764,2790,7554,-0.0486155,0.0538064,-0.997367,1
1727,762,8,104,747,26,56,3430,1393,4823,-0.0202208,0.0337602,-0.999225,1
4381,2208,21,276,2098,46,157,9187,2513,11700,-0.0172131,0.050961,-0.998552,1
6383,2950,28,395,2744,65,229,12794,3021,15815,-0.00960047,0.0361001,-0.999302,1
5407,2850,26,364,1979,41,143,10810,1882,12692,-0.019522,0.0725466,-0.997174,1
2900,1464,14,219,1423,23,109,6152,1498,7650,-0.0259628,0.0477116,-0.998524,1
5398,2629,24,316,2762,41,229,11399,1388,12787,-0.0409159,0.0506346,-0.997879,1
5307,2642,25,345,2574,42,204,11139,1379,12518,-0.0396864,0.0414876,-0.998351,1
5448,2830,33,447,2633,43,192,11626,1392,13018,-0.0373431,0.0498837,-0.998057,1
5313,2305,25,305,1805,42,122,9917,1014,10931,-0.0318167,0.0493136,-0.998277,1
4814,1905,35,255,1839,52,147,9047,1334,10381,-0.0233839,0.0356733,-0.99909,1
5524,2035,26,267,1917,58,151,9978,1572,11550,-0.0168476,0.0613491,-0.997975,1
5496,1886,29,256,1892,60,149,9768,1740,11508,-0.00992397,0.0676061,-0.997663,1
5668,1891,30,253,1892,63,143,9940,1644,11584,-0.00688967,0.0491007,-0.99877,1
5551,1763,30,234,1718,68,134,9498,1599,11097,-0.00772528,0.0329019,-0.999428,1
5645,1634,31,223,1578,73,127,9311,1589,10900,-0.0301852,0.0239865,-0.999257,1
5716,1702,29,228,1616,79,127,9497,1611,11108,-0.0429063,0.0372029,-0.998386,1
5691,1590,28,237,1600,69,123,9338,1607,10945,-0.0433987,0.0814534,-0.995732,1
3860,859,16,129,781,36,62,5743,796,6539,-0.0261747,0.0231439,-0.999389,1
2411,644,13,89,618,26,49,3850,696,4546,-0.0227566,0.00328108,-0.999736,1
5597,1484,29,211,1440,76,119,8956,1658,10614,0.00978061,0.0139616,-0.999855,1
5299,1593,36,247,1559,68,127,8929,1489,10418,0.0280307,0.0222848,-0.999359,1
5325,1733,27,257,1713,75,135,9265,1385,10650,0.0209822,0.00552341,-0.999765,1
4644,1689,25,237,1675,53,128,8451,1256,9707,0.0132935,-0.00839033,-0.999877,1
5257,2062,26,280,2031,54,156,9866,1388,11254,-0.00484275,0.0677363,-0.997692,1
3365,1240,14,158,1147,27,88,6039,778,6817,0.00311461,0.035109,-0.999379,1
2250,1046,11,135,1009,22,76,4549,674,5223,-0.00494661,-0.00859353,-0.999951,1
5356,2585,25,341,2598,51,196,11152,1715,12867,-0.00325348,0.0751476,-0.997167,1
3671,1591,13,183,1362,26,103,6949,781,7730,0.00412801,0.0307895,-0.999517,1
2309,1165,12,150,1121,16,84,4857,841,5698,0.00218432,-0.00983393,-0.999949,1
6127,2792,29,351,2566,40,196,12101,2536,14637,0.013049,0.0155033,-0.999795,1
5502,2515,27,332,1970,32,131,10509,2638,13147,0.0114277,0.0236739,-0.999654,1
5505,2326,28,322,2252,45,192,10670,4813,15483,-0.0159062,0.0721506,-0.997267,1
5458,1413,18,193,1393,45,110,8630,2942,11572,-0.0106139,0.0589269,-0.998206,1
2066,655,11,85,618,16,48,3499,2234,5733,-0.00608165,0.0170655,-0.999836,1
1639,458,9,64,441,18,36,2665,4085,6750,-0.00284505,-0.0173834,-0.999845,1
3438,808,18,117,755,36,64,5236,-1000,-1000,-1,-1,-1,1
2631,549,14,82,591,34,47,3948,-1000,-1000,-1,-1,-1,1
2132,439,12,67,443,16,38,3147,-1000,-1000,-1,-1,-1,1
2957,709,17,122,664,21,59,4549,5336,9885,-0.0645726,0.0970996,-0.993178,1
7647,2429,38,376,2380,82,206,13158,14881,28039,-0.0358717,0.072813,-0.9967,1
1702,598,8,75,515,10,41,2949,1861,4810,-0.0420903,0.036582,-0.998444,1
2493,961,13,130,945,21,74,4637,2546,7183,-0.0471332,0.0685025,-0.996537,1
5733,2551,31,334,2401,35,188,11273,6737,18010,-0.054227,0.0549095,-0.997018,1
3040,1389,16,186,1338,21,104,6094,3040,9134,0.0192313,-0.0196538,-0.999622,1
5901,2849,30,369,2705,41,205,12100,3884,15984,-0.0429413,0.00454238,-0.999067,1
5661,2761,32,398,3211,66,236,12365,2492,14857,-0.00868494,0.0794262,-0.996803,1
3873,1526,17,187,1385,19,104,7111,1899,9010,-0.043021,0.0135296,-0.998983,1
2424,1080,14,143,929,14,67,4671,725,5396,-0.00593529,-0.0319896,-0.99947,1
3047,1221,17,162,1188,27,95,5757,1036,6793,-0.000779319,-0.00776333,-0.999969,1
5794,2361,30,298,2225,53,172,10933,1727,12660,-0.00114141,-0.0156574,-0.999877,1
5725,2214,27,286,2062,65,162,10541,1917,12458,-0.0197508,0.0120061,-0.999733,1
6006,2142,28,286,2080,53,169,10764,1961,12725,-0.00603256,0.0140596,-0.999883,1
4035,1461,20,199,1421,42,113,7291,1865,9156,-0.075356,-0.0812488,-0.993841,1
5377,2036,24,249,1887,69,140,9782,1754,11536,0.006037,-0.0158806,-0.999856,1
5323,1823,23,235,1833,85,140,9462,1782,11244,0.0229162,-0.0564856,-0.99814,1
5794,1962,24,256,1904,76,145,10161,2088,12249,0.0158702,-0.0412934,-0.999021,1
5706,2353,34,371,2059,78,135,10736,1323,12059,0.00275922,-0.0410665,-0.999153,1
3935,1296,17,168,1258,51,93,6818,1216,8034,0.0178518,-0.0523776,-0.998468,1
6617,1802,26,232,1694,99,130,10600,1642,12242,0.00441212,-0.0428163,-0.999073,1
5682,1675,26,221,1730,120,171,9625,1310,10935,0.0025765,-0.0234448,-0.999722,1
5231,1424,26,185,1347,68,106,8387,1687,10074,-0.0028786,-0.0874406,-0.996165,1
6341,1428,26,194,1390,81,110,9570,1938,11508,-0.00736257,-0.0669363,-0.99773,1
5946,1432,27,192,1373,86,118,9174,2606,11780,-0.0144518,-0.135972,-0.990607,1
5743,1427,29,197,1336,74,107,8913,1860,10773,-0.0227912,-0.141826,-0.989629,1
3880,1039,20,138,962,48,79,6166,1704,7870,-0.0101742,-0.128907,-0.991605,1
5716,1503,28,213,1529,94,141,9224,2115,11339,-0.00974021,-0.147723,-0.988981,1
5665,2103,31,237,1708,75,131,9950,1323,11273,-0.0100022,-0.135428,-0.990737,1
3817,1246,21,163,1145,47,90,6529,1314,7843,-0.0260285,-0.107278,-0.993888,1
5630,1802,31,238,1696,55,134,9586,2325,11911,-0.0368779,-0.0659115,-0.997144,1
5531,1751,30,237,1678,69,134,9430,2610,12040,-0.0254891,-0.0566278,-0.99807,1
5041,1768,27,216,1535,51,120,8758,3033,11791,-0.00951802,-0.0883611,-0.996043,1
5012,1747,35,285,1589,74,146,8888,2850,11738,-0.0120657,-0.0360007,-0.999279,1
5233,1612,26,210,1516,38,118,8753,4076,12829,-0.0322423,-0.037191,-0.998788,1
5377,1649,26,211,1520,39,120,8942,6322,15264,-0.0125118,-0.0141902,-0.999821,1
3675,1116,18,150,1066,36,85,6146,4058,10204,-0.016545,-0.047127,-0.998752,1
4575,1451,22,196,1795,64,137,8240,6576,14816,-0.0180569,-0.0377784,-0.999123,1
3880,1359,19,194,1336,41,105,6934,8963,15897,-0.0236741,-0.0420194,-0.998836,1
5819,1969,27,263,1851,55,149,10133,6574,16707,-0.01575,-0.0146075,-0.999769,1
2971,1047,13,143,1040,27,88,5329,2343,7672,-0.0200855,-0.0281503,-0.999402,1
5733,2183,25,292,2170,53,172,10628,3528,14156,-0.0388045,0.0222702,-0.998999,1
2379,1345,12,133,983,28,76,4956,1427,6383,-0.0355619,0.0111564,-0.999305,1
4171,1903,19,246,1916,31,139,8425,1451,9876,-0.025761,0.0457565,-0.99862,1
5397,2576,25,334,2520,42,193,11087,1519,12606,-0.0293763,0.0262775,-0.999223,1
5373,2675,24,344,2614,42,191,11263,1525,12788,-0.0262425,0.0339663,-0.999078,1
5181,2914,24,355,2087,37,151,10749,972,11721,-0.0181511,0.0677474,-0.997538,1
4245,2225,21,284,2157,34,164,9130,1192,10322,-0.0248691,0.0399135,-0.998894,1
5414,2569,24,362,2515,39,196,11119,1463,12582,-0.0406015,0.0560436,-0.997603,1
3468,1721,17,243,1725,27,129,7330,1028,8358,-0.0317245,0.0482385,-0.998332,1
5050,2361,27,318,2393,40,183,10372,1435,11807,-0.0420771,0.0513677,-0.997793,1
5131,2102,32,306,2042,38,160,9811,1412,11223,-0.0334615,0.0497489,-0.998201,1
5782,2127,36,344,1880,49,155,10373,1436,11809,-0.037617,0.0468033,-0.998196,1
5356,1867,26,250,1790,52,140,9481,1440,10921,-0.0423331,0.0502989,-0.997837,1
5561,2363,28,267,1724,58,137,10138,1532,11670,-0.0363046,0.0716898,-0.996766,1
5579,2277,38,295,1736,85,138,10148,1592,11740,-0.0435995,0.0637264,-0.997015,1
5485,1637,30,259,1560,71,127,9169,1540,10709,-0.0318267,0.0492875,-0.998277,1
5720,1577,30,220,1536,59,131,9273,1540,10813,-0.0347702,0.0470576,-0.998287,1
5598,1639,29,220,1541,61,121,9209,1479,10688,-0.0317621,0.0332063,-0.998944,1
5789,1545,29,214,1462,63,117,9219,1377,10596,-0.00757697,0.0164709,-0.999836,1
5838,1497,28,200,1441,86,139,9229,1638,10867,0.00112553,0.00772799,-0.999969,1
5412,1378,28,190,1314,68,106,8496,1380,9876,-0.013781,0.00220388,-0.999903,1
6032,1480,30,207,1350,69,111,9279,1355,10634,0.0197827,0.0107932,-0.999746,1
5226,1599,27,226,1566,56,125,8825,1390,10215,0.0243048,0.0323701,-0.99918,1
5257,2299,35,283,1941,55,144,10014,1459,11473,0.0215739,0.0459019,-0.998713,1
5215,2212,26,292,2126,51,163,10085,1850,11935,0.00765293,0.0479513,-0.99882,1
5258,2420,28,320,2411,39,183,10659,1970,12629,-0.0082807,0.0768745,-0.997007,1
5207,2606,27,338,2549,51,191,10969,3018,13987,0.00408752,0.165773,-0.986156,1
5388,2460,26,328,2433,39,189,10863,4440,15303,-0.0240057,0.126004,-0.99174,1
5728,2436,27,319,2273,40,176,10999,4484,15483,0.00547793,0.116858,-0.993134,1
2787,1048,15,141,1028,20,81,5120,3629,8749,-0.0101178,0.0974279,-0.995191,1
5383,1628,30,219,1484,39,121,8904,7551,16455,-0.00828824,0.128292,-0.991702,1
3619,810,19,118,773,29,68,5436,5362,10798,-0.0427303,0.112511,-0.992732,1
5295,1104,29,162,1038,41,90,7759,3585,11344,-0.0288064,0.111312,-0.993368,1
5593,1283,30,171,1074,41,101,8293,7668,15961,-0.0110763,0.0872231,-0.996127,1
2772,650,15,98,640,21,56,4252,-1000,-1000,-1,-1,-1,1
2853,830,15,118,778,21,65,4680,7610,12290,0.0329466,0.049476,-0.998232,1
5604,1995,29,270,1803,39,179,9919,7171,17090,-0.000510039,0.0700212,-0.997546,1
5864,2171,30,296,2145,39,168,10713,8030,18743,0.0422616,0.184742,-0.981878,1
3035,1120,13,137,965,16,74,5360,3265,8625,0.00511672,0.11352,-0.993523,1
1732,786,10,103,757,11,57,3456,1263,4719,-0.00571064,0.0830206,-0.996532,1
2141,964,11,129,927,14,72,4258,2964,7222,0.0171851,0.0462848,-0.99878,1
5672,3031,33,357,2762,102,259,12216,2974,15190,-0.0206773,0.0716367,-0.997216,1
5694,2619,31,344,2521,44,195,11448,2608,14056,-0.0489144,0.0481803,-0.99764,1
3005,1289,19,222,1459,24,98,6116,1449,7565,-0.0100343,0.0603445,-0.998127,1
5728,2323,43,316,2214,64,170,10858,2124,12982,-0.00283895,0.0457262,-0.99895,1
5596,2191,29,326,2212,98,169,10621,1635,12256,0.00545766,0.0532957,-0.998564,1
3834,1388,18,187,1374,68,128,6997,1248,8245,-0.0335083,-0.0115581,-0.999372,1
5823,2053,26,272,1967,63,155,10359,1673,12032,-0.0116282,0.0248393,-0.999624,1
5982,2156,26,276,2061,122,160,10783,1661,12444,0.00590209,0.00718169,-0.999957,1
5838,2102,28,278,2033,63,139,10481,1507,11988,0.0194771,0.0044582,-0.9998,1
6162,2047,27,268,1980,51,137,10672,1284,11956,0.0497491,-0.00156909,-0.99876,1
6098,2288,37,266,1987,58,149,10883,1377,12260,0.032438,-0.00442236,-0.999464,1
6481,1976,29,258,2049,75,151,11019,1403,12422,-0.0539764,0.033273,-0.997988,1
3986,1224,19,208,1295,42,76,6850,766,7616,-0.0550977,0.000584068,-0.998481,1
2513,777,11,100,755,28,57,4241,576,4817,-0.0128873,-0.0195271,-0.999726,1
6215,1784,25,231,1865,65,134,10319,1539,11858,-0.0103473,-0.00811704,-0.999914,1
6567,2080,29,225,1733,64,154,10852,1262,12114,-0.01285,-0.0341083,-0.999336,1
4029,1254,20,161,1183,59,92,6798,1140,7938,-0.0109203,-0.0673953,-0.997667,1
5874,1814,33,266,1945,69,142,10143,2112,12255,-0.0161958,-0.0998631,-0.99487,1
5761,1950,30,258,1862,73,145,10079,2880,12959,-0.0237753,0.0376759,-0.999007,1
6113,1930,30,258,1968,73,168,10540,2097,12637,-0.0061774,0.00881584,-0.999942,1
2938,993,14,135,868,26,60,5034,974,6008,-0.00292021,-0.0429452,-0.999073,1
1955,640,12,97,615,21,49,3389,706,4095,-0.00376171,-0.0508233,-0.998701,1
5558,1740,38,254,1606,61,129,9386,2265,11651,-0.00671405,-0.0714498,-0.997422,1
5779,1488,30,212,1504,65,121,9199,2883,12082,-0.0044136,-0.0108274,-0.999932,1
3942,1085,19,146,1000,31,81,6304,2948,9252,-0.0100016,0.00431943,-0.999941,1
5455,1539,28,218,1476,58,148,8922,4565,13487,-0.0105234,-0.00352589,-0.999939,1
5658,1602,27,222,1523,42,124,9198,4391,13589,-0.0198421,-0.152087,-0.988168,1
3486,1109,17,151,1077,62,86,5988,2663,8651,-0.0175873,-0.0619214,-0.997926,1
5594,1924,26,254,1802,38,143,9781,2735,12516,-0.0654486,0.10919,-0.991864,1
4315,1420,16,191,1267,24,83,7316,1482,8798,-0.0582388,0.0946355,-0.993807,1
2292,948,11,137,788,14,62,4252,1115,5367,-0.0462336,0.0183513,-0.998762,1
3359,1570,15,209,1567,24,116,6860,1947,8807,-0.0379172,0.0666445,-0.997056,1
5311,2604,24,345,2613,39,200,11136,2818,13954,-0.0390261,0.126262,-0.991229,1
5286,2701,25,350,2664,46,200,11272,2796,14068,-0.040242,0.138829,-0.989498,1
3573,1785,17,276,1756,32,136,7575,2041,9616,-0.0392046,0.132577,-0.990397,1
5119,2515,24,332,2443,49,191,10673,1535,12208,-0.0411091,0.113318,-0.992708,1
5136,2297,27,309,2201,39,175,10184,1438,11622,-0.0364287,0.118122,-0.992331,1
5216,1987,28,287,2003,51,159,9731,1456,11187,-0.0378716,0.0985747,-0.994409,1
5398,1842,28,246,1818,51,145,9528,1411,10939,-0.0256421,0.0723086,-0.997053,1
5557,1877,36,354,2072,59,157,10112,1527,11639,-0.0268714,0.201562,-0.979107,1
3818,1163,17,125,920,33,71,6147,803,6950,-0.0250049,0.156311,-0.987391,1
2199,569,11,79,551,27,44,3480,550,4030,-0.0213823,0.0629745,-0.997786,1
2295,635,12,85,645,31,65,3768,584,4352,-0.0325313,0.025694,-0.999141,1
5758,1518,33,200,1539,87,115,9250,1404,10654,-0.013363,0.0803752,-0.996675,1
6721,1479,29,226,1332,71,109,9967,1236,11203,-0.0171819,0.0748441,-0.997047,1
6425,1457,29,230,1397,68,127,9733,1432,11165,-0.00621951,0.193103,-0.981159,1
5587,1627,28,222,1407,50,85,9006,991,9997,-0.0129513,0.156761,-0.987552,1
2716,792,11,117,775,26,59,4496,602,5098,0.000682638,0.0697135,-0.997567,1
2143,884,11,114,831,24,63,4070,592,4662,-0.00546426,0.034814,-0.999379,1
5121,2369,28,345,2285,42,194,10384,1518,11902,-0.0162591,0.051798,-0.998525,1
5208,2508,27,332,2443,39,184,10741,1591,12332,-0.0205836,0.0363966,-0.999125,1
6039,2572,27,345,2635,44,200,11862,1780,13642,-0.0133257,0.0400622,-0.999109,1
3574,1858,19,279,1762,31,135,7658,1257,8915,-0.00138712,0.012205,-0.999925,1
5486,2517,26,332,2517,54,189,11121,2035,13156,-0.00877959,0.0387558,-0.99921,1
5263,2471,25,334,2415,47,191,10746,2298,13044,0.00849595,0.00519646,-0.99995,1
5442,2408,27,318,2327,71,130,10723,1384,12107,-0.000508981,0.0201948,-0.999796,1
4757,2062,28,316,2062,44,161,9430,2828,12258,-0.00244194,0.0363125,-0.999338,1
5473,2009,29,280,1957,53,158,9959,3601,13560,-0.016977,0.0670279,-0.997607,1
5385,1753,35,265,1510,38,92,9078,2347,11425,-0.00463089,0.0224814,-0.999737,1
2832,799,15,110,747,28,61,4592,1792,6384,-0.00195618,0.0043867,-0.999988,1
5405,1253,46,217,1222,55,105,8303,5711,14014,-0.0190447,0.0947609,-0.995318,1
5277,1114,27,171,1067,52,93,7801,7652,15453,-0.0282045,0.118625,-0.992539,1
2933,564,15,86,532,25,46,4201,10698,14899,-0.0146273,0.0451178,-0.998875,1
2146,431,12,65,396,17,35,3102,3831,6933,-0.016208,0.0407753,-0.999037,1
5329,1151,29,172,1063,40,92,7876,16426,24302,-0.040897,0.0945614,-0.994679,1
2251,554,13,81,516,20,44,3479,3550,7029,0.00631996,0.0562553,-0.998397,1
3642,1024,19,143,1003,35,80,5946,6479,12425,-0.00630326,0.00398386,-0.999972,1
5453,1549,30,220,1450,41,123,8866,9150,18016,-0.00381921,0.0377423,-0.99928,1
2840,957,16,144,870,22,71,4920,7110,12030,0.00341629,0.00737626,-0.999967,1
3363,1155,18,159,1101,24,89,5909,8672,14581,-0.017079,0.142008,-0.989718,1
3452,1215,17,171,1240,24,99,6218,4016,10234,0.00281789,-0.00779887,-0.999966,1
5914,2219,33,318,2173,38,174,10869,5817,16686,0.00465995,0.0368089,-0.999311,1
4034,1739,21,227,1698,25,129,7873,3083,10956,0.0159801,0.0467208,-0.99878,1
4881,2150,26,283,2065,32,157,9594,3951,13545,0.0247292,0.0383587,-0.998958,1
4672,2191,26,293,2130,30,165,9507,3369,12876,0.0178923,0.0396634,-0.999053,1
3597,1597,18,209,1613,22,121,7177,1898,9075,0.00553044,0.036141,-0.999331,1
5785,2588,36,373,2389,40,188,11399,2840,14239,-0.0577833,0.0249015,-0.998019,1
3933,1571,20,211,1563,28,119,7445,1966,9411,0.00116295,0.0327673,-0.999463,1
5961,2245,31,294,2085,45,165,10826,2859,13685,-0.0087963,0.0346296,-0.999361,1
5702,1994,30,270,1918,75,104,10093,1789,11882,-0.0125543,0.0332063,-0.99937,1
4004,1377,18,203,1414,40,108,7164,3130,10294,-0.00418437,-0.00600179,-0.999973,1
6077,2062,26,313,2019,54,159,10710,3367,14077,-0.00735832,-0.147439,-0.989044,1
5753,2041,28,262,2041,79,171,10375,2356,12731,0.0381199,-0.0169608,-0.999129,1
4050,1380,41,177,1372,40,102,7162,2100,9262,0.0140367,-0.0191755,-0.999718,1
5808,1841,28,238,1871,79,147,10012,3862,13874,0.00801113,-0.0167338,-0.999828,1
5836,1672,27,217,1662,79,139,9632,1538,11170,0.0370346,0.022366,-0.999064,1
5858,1345,27,202,1275,50,101,8858,2979,11837,-0.00288413,-0.0441508,-0.999021,1
5135,1108,25,150,1068,74,85,7645,1612,9257,-0.0104472,-0.0447336,-0.998945,1
5822,1267,30,176,1272,70,101,8738,1812,10550,0.00140918,-0.0868156,-0.996224,1
5611,1264,28,171,1205,51,96,8426,4152,12578,-0.0331306,-0.0733611,-0.996755,1
5904,1331,32,183,1318,60,134,8962,2619,11581,-0.0163926,-0.13163,-0.991163,1
5617,1292,29,180,1249,59,99,8525,3154,11679,-0.0303056,-0.0792115,-0.996397,1
5695,1259,31,169,1100,64,91,8409,3028,11437,-0.00975624,-0.14477,-0.989417,1
5075,908,34,139,938,60,76,7230,3219,10449,-0.0771598,-0.0787411,-0.993905,1
3673,643,19,94,581,40,50,5100,2191,7291,0.000312011,-0.0973034,-0.995255,1
5556,952,29,142,851,55,83,7668,4028,11696,0.00114656,-0.0422642,-0.999106,1
5233,983,30,138,889,53,76,7402,3624,11026,-0.0145471,-0.10207,-0.994671,1
3680,687,18,98,637,36,65,5221,2042,7263,-0.0110359,-0.112373,-0.993605,1
5631,1087,46,153,964,43,85,8009,8240,16249,-0.0119466,-0.198203,-0.980088,1
2867,568,14,82,563,27,46,4167,3568,7735,-0.0121797,-0.110748,-0.993774,1
5654,1149,29,167,1084,62,95,8240,6336,14576,-0.00984252,-0.12438,-0.992186,1
3849,844,20,120,835,29,67,5764,4207,9971,-0.00984346,-0.123523,-0.992293,1
3800,915,19,130,946,27,73,5910,3914,9824,-0.0206354,-0.207586,-0.977999,1
4434,1000,19,163,993,27,81,6717,4188,10905,-0.0280348,-0.115821,-0.992874,1
4913,1521,22,198,1475,34,114,8277,5524,13801,-0.0242077,-0.196957,-0.980113,1
5832,1823,23,243,1888,39,150,9998,6590,16588,-0.0227654,-0.18593,-0.982299,1
3757,1382,16,181,1422,26,104,6888,5090,11978,-0.0293221,-0.0816562,-0.996229,1
4961,1983,22,253,1902,33,144,9298,4654,13952,-0.0228315,-0.0946601,-0.995248,1
3533,1512,18,194,1511,26,113,6907,2548,9455,-0.0295324,-0.076115,-0.996662,1
5487,2395,25,318,2368,37,179,10809,3455,14264,-0.0118254,-0.0850532,-0.996307,1
5577,2513,26,324,2425,36,186,11087,2741,13828,-0.0394016,-0.0871006,-0.99542,1
5343,2539,30,391,2018,26,132,10479,1648,12127,-0.0447435,-0.0697694,-0.996559,1
2796,1416,13,182,1357,22,102,5888,1750,7638,-0.0405711,-0.0896267,-0.995149,1
5661,2740,25,350,3120,49,199,12144,2466,14610,-0.0342771,-0.065803,-0.997244,1
5443,2737,25,382,2691,38,211,11527,2387,13914,-0.0253386,-0.079187,-0.996538,1
5297,2850,31,396,2707,41,203,11525,1941,13466,-0.0290843,-0.0761243,-0.996674,1
3676,1975,18,266,1915,29,144,8023,1732,9755,-0.0295906,-0.0808978,-0.996283,1
5272,2844,29,446,2910,47,213,11761,1541,13302,-0.027437,-0.0691306,-0.99723,1
5250,2929,27,375,2903,45,219,11748,1479,13227,-0.0221136,-0.0662547,-0.997558,1
8217,4315,31,582,3249,32,153,16579,1005,17584,-0.0129559,-0.0573676,-0.998269,1
5392,3005,30,404,2954,45,230,12060,987,13047,-0.00827267,-0.0426031,-0.999058,1
3654,2042,18,287,2053,33,152,8239,943,9182,-0.00164262,-0.0373486,-0.999301,1
5293,2695,24,367,2615,56,198,11248,1258,12506,0.00487767,-0.0287161,-0.999576,1
5363,2981,44,402,2965,52,228,12035,1466,13501,-0.0017392,-0.0327263,-0.999463,1
5395,2984,27,406,3052,76,225,12165,1421,13586,0.0160524,-0.0158605,-0.999745,1
3608,1999,18,259,2283,55,154,8376,1166,9542,0.0201093,-0.0191951,-0.999614,1
5364,2945,27,388,2920,78,216,11938,1608,13546,0.0432442,-0.0182507,-0.998898,1
5503,3096,27,393,2874,57,210,12160,1310,13470,0.0462285,-0.0208244,-0.998714,1
3620,1957,20,256,1842,55,135,7885,1211,9096,0.0607162,-0.0175969,-0.998,1
5391,2767,29,366,2779,49,193,11574,1724,13298,0.0749248,-0.0162143,-0.997058,1
6077,2557,29,326,2469,50,178,11686,1338,13024,0.0798962,-0.0202497,-0.996597,1
3927,1778,19,216,1690,37,125,7792,1217,9009,0.0793239,-0.02569,-0.996518,1
5808,2510,30,302,2310,49,172,11181,1626,12807,0.107967,-0.0410888,-0.993305,1
5782,2299,32,292,2584,53,168,11210,1262,12472,0.105243,-0.0608132,-0.992585,1
4006,1610,22,218,1427,31,106,7420,1070,8490,0.102445,-0.0737999,-0.991997,1
5836,2022,29,282,1949,48,150,10316,1427,11743,0.093288,-0.0775895,-0.992611,1
5830,1941,31,300,1883,54,144,10183,1476,11659,0.101943,-0.0956792,-0.990178,1
3920,1272,27,194,1221,43,95,6772,990,7762,0.0779038,-0.0967911,-0.992251,1
5786,1741,29,236,1688,60,135,9675,1517,11192,0.0938064,-0.0928926,-0.991248,1
5826,1775,29,235,1704,59,131,9759,1202,10961,0.0894007,-0.0790611,-0.992853,1
4229,1291,20,172,1250,46,97,7105,1053,8158,0.0727697,-0.0837566,-0.993826,1
5595,1866,30,269,1845,65,142,9812,1437,11249,0.0770859,-0.0882725,-0.993109,1
5716,2006,29,259,1934,62,146,10152,1495,11647,0.0765881,-0.110336,-0.990939,1
5837,2148,31,304,2278,117,231,10946,1329,12275,0.0772574,-0.124706,-0.989181,1
4003,1596,20,198,1506,87,132,7542,955,8497,0.0780202,-0.133421,-0.987984,1
5771,3153,38,311,2360,83,178,11894,1436,13330,0.100337,-0.147353,-0.983982,1
5634,2428,30,354,2366,52,173,11037,1410,12447,0.0985556,-0.155895,-0.982845,1
5828,2374,29,299,1738,52,117,10437,967,11404,0.106374,-0.16254,-0.980951,1
2846,1230,15,155,1149,37,88,5520,721,6241,0.091052,-0.151298,-0.984286,1
5408,2182,35,304,2042,67,159,10197,1441,11638,0.0947856,-0.159522,-0.982633,1
5355,2140,29,312,2490,61,229,10616,1490,12106,0.0801111,-0.151736,-0.985169,1
3623,1491,20,195,1447,31,111,6918,1015,7933,0.064895,-0.150771,-0.986436,1
5443,2006,26,260,1962,45,148,9890,1293,11183,0.0561002,-0.157219,-0.985969,1
4666,2006,24,255,1865,52,141,9009,1305,10314,0.0518711,-0.161336,-0.985535,1
5358,2112,28,280,2023,63,172,10036,1506,11542,0.0492275,-0.170039,-0.984207,1
5047,1992,28,267,1918,53,150,9455,1462,10917,0.0539164,-0.184427,-0.981366,1
5098,1905,29,256,1828,57,142,9315,1498,10813,0.0438822,-0.183989,-0.981948,1
5042,1917,28,262,1857,51,149,9306,1746,11052,0.0373796,-0.18888,-0.981289,1
5132,1935,34,259,1782,50,143,9335,1948,11283,0.0357757,-0.187257,-0.981659,1
5094,1917,27,261,1811,49,146,9305,2812,12117,0.0496766,-0.199911,-0.978554,1
4321,1400,21,190,1248,29,78,7287,1788,9075,0.0543122,-0.199054,-0.978482,1
2103,946,14,129,913,28,73,4206,903,5109,0.0414531,-0.192912,-0.98034,1
5076,1849,28,279,1871,52,149,9304,2188,11492,0.0533694,-0.20639,-0.977013,1
5397,1961,27,263,1854,49,170,9721,2514,12235,0.0456839,-0.192135,-0.980305,1
3491,1310,19,174,1316,30,100,6440,1696,8136,0.0342302,-0.185399,-0.982067,1
5407,1891,29,253,1804,45,144,9573,3382,12955,0.037978,-0.196813,-0.979706,1
5168,1841,28,249,1818,48,143,9295,3240,12535,0.0578829,-0.234786,-0.970322,1
3519,1179,19,167,1179,32,93,6188,3074,9262,0.0683755,-0.237745,-0.968918,1
5208,1605,28,223,1614,47,129,8854,3599,12453,0.0702495,-0.223896,-0.972078,1
5138,1523,34,254,1442,48,119,8558,4386,12944,0.0790441,-0.249961,-0.965025,1
4743,1228,25,179,1196,59,99,7529,3516,11045,0.0563153,-0.2126,-0.975515,1
4706,1278,46,228,1118,55,96,7527,5199,12726,0.0469378,-0.194043,-0.979869,1
4787,1175,32,168,1106,56,93,7417,5194,12611,0.0313383,-0.20444,-0.978377,1
3295,857,19,128,786,38,67,5190,2874,8064,0.0313096,-0.209137,-0.977385,1
5159,1235,29,180,1150,57,103,7913,4822,12735,0.114349,-0.242609,-0.963361,1
5156,1126,29,197,1072,49,93,7722,6212,13934,0.0064414,-0.19385,-0.98101,1
5215,1107,28,166,1072,45,92,7725,4442,12167,0.0553202,-0.21461,-0.975132,1
5101,1056,28,161,996,42,89,7473,4498,11971,0.042811,-0.196759,-0.979517,1
5368,1070,32,162,1085,46,92,7855,4188,12043,0.045105,-0.196043,-0.979557,1
3555,777,19,113,748,28,63,5303,4084,9387,0.0406623,-0.196284,-0.979704,1
4791,1120,25,160,1096,36,95,7323,7592,14915,0.0887235,-0.207948,-0.974108,1
3411,963,18,129,893,23,71,5508,2915,8423,0.0850546,-0.202884,-0.975502,1
5202,1583,34,252,1722,54,171,9018,5863,14881,0.0698057,-0.209016,-0.975418,1
5445,1821,29,280,1820,40,145,9580,3615,13195,0.0831306,-0.207599,-0.974676,1
2832,1021,15,136,1048,24,79,5155,1756,6911,0.0830688,-0.206894,-0.974831,1
5388,2137,30,284,2070,44,161,10114,5337,15451,0.081924,-0.205492,-0.975224,1
5599,2330,43,311,2187,45,171,10686,3778,14464,0.0829615,-0.205313,-0.975174,1
2965,1281,15,168,1264,24,95,5812,2389,8201,0.068001,-0.228271,-0.97122,1
5704,2499,28,330,2767,46,192,11566,6580,18146,0.065746,-0.208076,-0.9759,1
2993,1393,14,182,1816,64,105,6567,3555,10122,0.0725374,-0.141732,-0.987244,1
3734,1810,17,229,1808,29,133,7760,4835,12595,0.061294,-0.215258,-0.974632,1
5865,2866,35,424,3223,46,217,12676,5557,18233,-0.040501,-0.0582857,-0.997478,1
3005,1526,15,197,1523,23,112,6401,3321,9722,0.0781003,-0.1938,-0.977927,1
4886,2431,29,325,2443,39,180,10333,8022,18355,0.0620977,-0.190657,-0.979691,1
6215,3165,30,395,2853,32,153,12843,3094,15937,0.0974436,-0.234232,-0.967285,1
3194,1624,16,204,1591,26,114,6769,5044,11813,0.0613956,-0.216678,-0.974311,1
3917,1944,18,249,2019,30,144,8321,2717,11038,0.0350667,-0.219036,-0.975087,1
3741,1999,19,248,1973,30,156,8166,2888,11054,0.0537573,-0.223455,-0.973231,1
4286,2248,22,283,2211,49,172,9271,2144,11415,0.0373748,-0.211657,-0.976629,1
4252,2261,23,280,2117,36,154,9123,2191,11314,0.057776,-0.22886,-0.971743,1
4570,2207,27,275,2047,36,150,9312,1330,10642,-0.00859352,-0.227596,-0.973718,1
5744,2661,29,344,2684,50,198,11710,2062,13772,0.00627722,-0.237581,-0.971347,1
5638,2668,38,420,2394,47,182,11387,1875,13262,0.0170729,-0.206593,-0.978278,1
4074,1530,20,205,1447,36,124,7436,1066,8502,0.0161303,-0.205795,-0.978463,1
4004,1614,24,277,1505,33,104,7561,1015,8576,0.0123852,-0.204641,-0.978759,1
5756,1756,23,253,1780,49,125,9742,1418,11160,0.0278458,-0.223096,-0.974399,1
6080,1828,19,163,1237,63,122,9512,979,10491,0.0210348,-0.204666,-0.978606,1
6185,1878,25,241,1792,68,134,10323,1435,11758,-0.000682951,-0.312525,-0.949909,1
4312,1332,18,171,1001,30,73,6937,733,7670,-0.00337228,-0.253558,-0.967314,1
2413,698,9,90,667,24,51,3952,510,4462,-0.00768002,-0.187545,-0.982226,1
3039,1049,14,135,1032,32,77,5378,794,6172,0.0141878,-0.213396,-0.976863,1
5261,1802,24,253,1784,99,144,9367,1270,10637,0.0334574,-0.252565,-0.967001,1
5046,1647,24,221,1604,66,128,8736,1347,10083,0.025549,-0.191549,-0.98115,1
5704,1596,30,227,1607,81,128,9373,1627,11000,0.0399924,-0.215527,-0.975679,1
5881,1365,30,193,1263,50,108,8890,1623,10513,0.0412428,-0.252762,-0.966649,1
3692,802,23,115,746,30,63,5471,1037,6508,0.0372138,-0.20859,-0.977295,1
5435,1060,31,158,993,70,91,7838,1639,9477,0.0394704,-0.199767,-0.979048,1
5472,1022,30,155,961,42,82,7764,1955,9719,0.0364646,-0.213929,-0.976168,1
5652,1252,28,178,1165,43,104,8422,1835,10257,0.0223356,-0.213534,-0.97668,1
5611,1603,27,210,1521,46,118,9136,1954,11090,0.0219866,-0.235354,-0.971661,1
5648,1956,26,253,1770,39,95,9787,2012,11799,0.0147392,-0.268111,-0.963275,1
2890,1126,14,147,1113,22,92,5404,1161,6565,0.00818573,-0.255135,-0.966871,1
5591,2406,25,314,2360,48,179,10923,2461,13384,0.0208196,-0.223689,-0.974438,1
5646,2701,25,345,2607,44,211,11579,3495,15074,0.0263796,-0.305778,-0.951738,1
4008,1942,16,251,1907,30,140,8294,3959,12253,0.143567,-0.191126,-0.97101,1
5654,2899,26,369,2287,31,146,11412,1978,13390,0.028089,-0.320747,-0.946748,1
3282,1988,17,239,1609,28,117,7280,2113,9393,0.070805,-0.249507,-0.965781,1
4458,2449,19,315,2353,44,175,9813,3100,12913,0.0644421,-0.304135,-0.950447,1
6190,2903,25,376,2893,59,216,12662,4147,16809,0.0103211,-0.331762,-0.943307,1
3812,2029,17,275,2083,32,148,8396,2440,10836,0.0728783,-0.296392,-0.952282,1
3685,2078,19,254,2050,42,148,8276,1499,9775,0.0432859,-0.30063,-0.952758,1
5691,2502,23,317,2452,51,181,11217,1729,12946,0.00523712,-0.314257,-0.949324,1
5540,2627,26,325,2693,74,233,11518,1508,13026,-0.0151042,-0.442518,-0.896632,1
3327,1231,15,157,1152,22,87,5991,740,6731,-0.000982631,-0.416178,-0.909282,1
2181,697,10,104,672,15,52,3731,536,4267,-0.00146216,-0.34104,-0.940048,1
2415,756,14,99,699,28,55,4066,701,4767,0.00652407,-0.314974,-0.949078,1
5874,1551,29,212,1473,64,116,9319,1586,10905,0.00795764,-0.434454,-0.900659,1
4563,1012,22,138,962,46,75,6818,844,7662,-0.0050588,-0.392474,-0.919749,1
2487,543,12,76,532,25,40,3715,528,4243,0.00225804,-0.327819,-0.944738,1
2460,684,13,94,665,31,54,4001,659,4660,-0.000937603,-0.293015,-0.956107,1
8380,1636,31,240,1630,81,125,12123,1401,13524,-0.0138244,-0.278611,-0.960305,1
6536,1696,30,235,1671,66,111,10345,1061,11406,-0.0315421,-0.285787,-0.957774,1
3863,1230,22,191,1167,51,114,6638,1008,7646,-0.0297572,-0.24842,-0.968195,1
5962,1811,29,261,1789,55,166,10073,1611,11684,-0.121832,-0.371665,-0.920338,1
5342,1688,19,196,1356,37,105,8743,1007,9750,-0.110269,-0.344602,-0.93225,1
2487,949,11,124,895,24,69,4559,619,5178,-0.074476,-0.266843,-0.960858,1
5496,2453,33,484,2655,49,175,11345,1474,12819,-0.0833991,-0.283198,-0.955429,1
6192,3139,30,367,2250,42,175,12195,1446,13641,-0.0877882,-0.406366,-0.909483,1
5310,1563,19,213,1522,26,117,8770,896,9666,-0.0725432,-0.364715,-0.928289,1
2061,753,11,103,729,12,57,3726,914,4640,-0.0404335,-0.268332,-0.962477,1
2384,773,17,106,753,17,62,4112,1853,5965,-0.0400318,-0.293364,-0.955162,1
6305,1363,30,191,1378,51,160,9478,4580,14058,-0.0655555,-0.304884,-0.950131,1
5680,1009,29,154,948,35,83,7938,4491,12429,-0.0471415,-0.321455,-0.94575,1
3578,744,18,113,696,33,62,5244,3983,9227,-0.0350241,-0.306561,-0.951206,1
5290,1444,26,209,1400,54,133,8556,3597,12153,-0.039398,-0.310382,-0.949795,1
5366,1878,49,259,1879,67,148,9646,3370,13016,-0.021109,-0.335273,-0.941885,1
3758,1573,21,208,1573,33,118,7284,2141,9425,0.0160605,-0.31102,-0.950268,1
6391,2567,29,353,2547,82,185,12154,2736,14890,-0.0363788,-0.292574,-0.955551,1
3890,2040,26,348,2103,59,159,8625,2044,10669,-0.0111961,-0.296753,-0.954888,1
5064,2526,25,320,2468,50,180,10633,2434,13067,-0.0192868,-0.284351,-0.958526,1
5400,2553,26,326,2510,54,185,11054,2022,13076,-0.00651861,-0.264499,-0.964364,1
5614,2819,28,357,3088,66,208,12180,1665,13845,-0.0195062,-0.253118,-0.967239,1
4024,1858,19,240,1832,36,136,8145,1434,9579,-0.0233592,-0.243441,-0.969634,1
6503,2660,27,339,2677,52,194,12452,1732,14184,0.0181452,-0.239729,-0.97067,1
3926,1774,19,234,1716,33,127,7829,1456,9285,0.0470836,-0.229411,-0.97219,1
5668,2440,38,314,2399,44,179,11082,2282,13364,0.000474502,-0.219198,-0.97568,1
3921,1714,19,214,1621,30,121,7640,1566,9206,0.0229526,-0.214084,-0.976546,1
5672,2243,28,296,2212,45,169,10665,1830,12495,0.0766644,-0.219625,-0.972567,1
5695,2124,28,296,2052,50,159,10404,2109,12513,0.011585,-0.234709,-0.971997,1
3944,1357,20,179,1285,32,100,6917,1266,8183,0.0389766,-0.245308,-0.968661,1
6193,1778,28,230,1614,67,130,10040,1895,11935,0.0138997,-0.240376,-0.97058,1
4093,1279,19,153,1098,33,85,6760,1334,8094,-0.00810678,-0.221511,-0.975124,1
7169,1909,31,273,1691,63,129,11265,1888,13153,-0.0287375,-0.254673,-0.9666,1
6753,2047,31,309,2100,59,156,11455,1612,13067,-0.0552248,-0.390675,-0.918871,1
4373,1441,14,137,1054,28,81,7128,880,8008,-0.0403707,-0.341002,-0.939196,1
2586,736,11,98,704,17,55,4207,627,4834,-0.0172388,-0.247366,-0.968769,1
2153,700,10,95,687,17,55,3717,669,4386,-0.000422093,-0.22707,-0.973879,1
6303,1921,30,266,1905,75,155,10655,3036,13691,0.00191093,-0.261363,-0.965239,1
5581,1787,30,274,1759,56,144,9631,2567,12198,-0.00484479,-0.194416,-0.980907,1
4034,1173,26,173,1084,33,90,6613,2725,9338,0.0266877,-0.201497,-0.979126,1
3949,1072,22,154,983,33,98,6311,3681,9992,0.0321906,-0.182013,-0.982769,1
4871,1198,28,209,1463,43,100,7912,4384,12296,0.0849549,-0.219013,-0.972016,1
3730,796,20,116,781,30,65,5538,5089,10627,0.0495601,-0.196735,-0.979203,1
3780,903,18,128,879,31,91,5830,4568,10398,0.0454554,-0.232191,-0.971608,1
5652,1847,28,250,1746,50,140,9713,8131,17844,0.0462291,-0.296654,-0.953866,1
3007,1196,14,157,1164,24,88,5650,3277,8927,0.0284992,-0.269888,-0.96247,1
5724,2541,25,332,2504,48,190,11364,3386,14750,0.0162941,-0.322963,-0.946271,1
5108,2568,21,322,2449,41,183,10692,2879,13571,0.042183,-0.306054,-0.951079,1
5551,2876,29,456,2900,43,216,12071,1671,13742,0.00429013,-0.351559,-0.936156,1
4888,2594,22,330,2614,41,195,10684,2275,12959,0.0062866,-0.379204,-0.925291,1
4771,3303,23,336,2622,47,200,11302,995,12297,0.0111,-0.375064,-0.926932,1
5219,2865,25,366,2819,57,218,11569,1371,12940,0.0172479,-0.353123,-0.935418,1
5310,2786,25,367,2785,48,205,11526,1366,12892,0.0267134,-0.354962,-0.934499,1
5055,2541,27,329,2518,50,190,10710,1426,12136,0.0324568,-0.346593,-0.937454,1
5420,2209,28,316,2199,60,169,10401,1477,11878,0.0397963,-0.342278,-0.938756,1
5398,1806,26,246,1807,61,145,9489,1438,10927,0.0450161,-0.327917,-0.943634,1
5518,1614,28,217,1586,56,139,9158,1529,10687,0.047936,-0.359666,-0.931849,1
5716,1591,28,211,1653,60,124,9383,1593,10976,0.0530137,-0.365132,-0.929445,1
5875,1574,30,208,1610,56,117,9470,1515,10985,0.0382598,-0.341293,-0.939178,1
3928,1145,64,153,1122,49,86,6547,1044,7591,0.0388804,-0.294368,-0.954901,1
5686,1689,30,232,1702,54,134,9527,1460,10987,0.0182114,-0.298479,-0.954242,1
5711,1787,29,241,1697,54,133,9652,1550,11202,0.0130793,-0.317528,-0.948159,1
5812,1889,21,178,1249,44,102,9295,995,10290,0.00763209,-0.343131,-0.939257,1
2766,1059,15,145,1001,27,80,5093,805,5898,0.0102682,-0.302761,-0.953012,1
5376,2148,29,295,2035,41,164,10088,1397,11485,0.0185237,-0.278602,-0.960228,1
5313,2333,30,317,2331,45,181,10550,1446,11996,0.0103806,-0.271466,-0.962392,1
5329,2449,33,369,1888,43,127,10238,1093,11331,-0.00189757,-0.256189,-0.966625,1
3650,1694,19,223,1606,27,127,7346,1186,8532,-0.00613887,-0.244046,-0.969744,1
5324,2306,26,304,2154,39,194,10347,2120,12467,-0.029845,-0.337346,-0.940908,1
3784,1075,16,171,1074,20,85,6225,1314,7539,-0.0289488,-0.252604,-0.967137,1
2164,756,12,104,714,16,58,3824,1982,5806,-0.0175729,-0.224187,-0.974388,1
5379,1542,28,217,1529,46,124,8865,5185,14050,-0.0253322,-0.42534,-0.904679,1
3677,926,19,133,1021,42,116,5934,4417,10351,0.0147057,-0.25924,-0.965701,1
4922,1113,25,173,1002,55,86,7376,6173,13549,-0.0104858,-0.257302,-0.966274,1
3486,748,18,111,714,27,61,5165,5994,11159,0.124307,-0.345515,-0.930143,1
4284,1021,22,147,967,31,83,6555,15653,22208,0.105399,-0.45681,-0.883298,1
2173,757,13,83,569,15,45,3655,2466,6121,0.0139692,-0.24286,-0.969961,1
5426,1781,29,243,1675,39,135,9328,4221,13549,0.0189792,-0.279858,-0.959854,1
5503,2121,47,313,2096,55,164,10299,4301,14600,0.0226085,-0.296039,-0.954908,1
7769,3211,34,431,2932,36,117,14530,2648,17178,0.0152592,-0.315167,-0.948914,1
2871,1369,14,173,1321,32,97,5877,2266,8143,0.04944,-0.284193,-0.957492,1
5711,2826,29,357,2718,65,202,11908,4822,16730,0.0614678,-0.284385,-0.956738,1
3798,1803,29,239,1861,42,138,7910,2206,10116,0.0508033,-0.328217,-0.943235,1
5024,2240,25,293,2182,40,167,9971,2677,12648,0.0255836,-0.309796,-0.950459,1
6178,2311,28,304,2263,46,174,11304,2718,14022,-0.00210451,-0.301542,-0.953451,1
3857,1472,19,192,1401,30,107,7078,1334,8412,-0.0128184,-0.291032,-0.956627,1
4076,1292,17,168,1275,43,97,6968,1448,8416,0.0357621,-0.207801,-0.977517,1
4082,1251,18,175,1165,35,91,6817,1652,8469,0.0227207,-0.252171,-0.967416,1
4029,1239,18,155,1182,31,90,6744,2087,8831,0.0314353,-0.177185,-0.983675,1
5222,1744,21,216,1640,42,124,9009,3497,12506,-0.0131308,-0.281592,-0.959445,1
5172,1778,22,230,1751,40,149,9142,3164,12306,-0.0240576,-0.257162,-0.966069,1
5803,2113,25,273,2058,48,155,10475,2596,13071,-0.0278753,-0.257785,-0.9658,1
6074,2216,29,287,2185,60,166,11017,1273,12290,-0.00658601,-0.19943,-0.97989,1
3016,1136,15,150,1127,24,86,5554,1035,6589,-0.00448491,-0.143024,-0.989709,1
5775,2114,28,281,2146,44,164,10552,1537,12089,0.0243071,-0.200362,-0.97942,1
5645,2075,31,286,2123,55,188,10403,2543,12946,0.0147784,-0.183249,-0.982955,1
5013,1786,27,238,1686,37,133,8920,2447,11367,0.0610464,-0.213517,-0.97503,1
5646,1706,31,238,1918,62,203,9804,2910,12714,0.0755682,-0.233577,-0.969397,1
3839,1039,23,146,1028,27,83,6185,1488,7673,0.0717219,-0.247952,-0.966114,1
5578,1329,30,191,1315,44,110,8597,3584,12181,0.0649582,-0.27873,-0.95817,1
5533,1397,29,198,1369,39,113,8678,3604,12282,0.0903448,-0.284053,-0.954543,1
5504,1651,29,255,1568,40,135,9182,5760,14942,0.0922963,-0.289255,-0.952792,1
5568,2113,27,279,2027,42,158,10214,5254,15468,0.0965555,-0.306835,-0.946852,1
2969,1238,14,163,1240,24,92,5740,3990,9730,0.0570581,-0.318748,-0.946121,1
5611,2532,30,337,2456,41,187,11194,4464,15658,0.0457314,-0.325122,-0.944566,1
5643,2585,46,319,2508,41,186,11328,1710,13038,0.00988088,-0.360869,-0.932564,1
3820,1825,16,256,1834,82,137,7970,1585,9555,0.00628284,-0.340094,-0.940371,1
4472,2379,20,320,2310,36,176,9713,1901,11614,0.00237657,-0.33971,-0.940527,1
5508,2861,25,367,2826,56,211,11854,1470,13324,0.0164729,-0.361972,-0.932043,1
6171,2778,25,358,2819,39,205,12395,1401,13796,0.0102262,-0.374225,-0.927282,1
3668,1807,21,251,1715,26,135,7623,991,8614,0.0245806,-0.368509,-0.929299,1
5986,2272,47,328,2223,63,171,11090,1394,12484,0.0367272,-0.358989,-0.932619,1
5216,2037,25,273,1972,39,153,9715,1402,11117,0.0430049,-0.33641,-0.940733,1
5257,1842,27,247,1780,50,138,9341,1496,10837,0.0333071,-0.313737,-0.948926,1
5515,1679,28,229,1629,49,131,9260,1472,10732,0.0303685,-0.306893,-0.951259,1
5494,1666,27,217,1572,64,129,9169,1443,10612,0.0306373,-0.299184,-0.953703,1
5707,1694,29,216,1619,59,125,9449,1608,11057,0.0202681,-0.290694,-0.956601,1
5761,1736,34,317,1462,51,100,9461,1014,10475,0.0273497,-0.285896,-0.957871,1
5732,1611,32,218,1576,55,124,9348,1534,10882,0.0332009,-0.278003,-0.960006,1
8299,2480,39,356,2385,82,191,13832,1421,15253,0.0282301,-0.293199,-0.955634,1
5284,1618,27,219,1528,58,120,8854,1330,10184,0.029369,-0.290067,-0.956555,1
5620,1906,35,259,1746,59,120,9745,1440,11185,0.0206594,-0.304896,-0.952162,1
5557,1882,29,249,1782,70,138,9707,1511,11218,0.0245841,-0.294901,-0.955212,1
5593,2000,30,269,1886,58,149,9985,1475,11460,0.0413398,-0.36222,-0.931175,1
5595,2106,28,287,2058,69,164,10307,1390,11697,0.027958,-0.327115,-0.944571,1
3754,1348,18,166,1089,24,87,6486,747,7233,0.0241564,-0.273703,-0.961511,1
2308,932,14,129,897,17,71,4368,654,5022,0.0297586,-0.2641,-0.964036,1
5826,2362,27,342,2267,38,180,11042,1896,12938,0.0190377,-0.273035,-0.961816,1
5524,2550,28,380,2437,49,197,11165,1961,13126,0.0287264,-0.250537,-0.967681,1
5247,2454,27,332,2262,26,129,10477,1618,12095,0.0122341,-0.249398,-0.968324,1
4039,1668,18,229,1653,25,125,7757,1408,9165,0.0369917,-0.255966,-0.965978,1
5826,2265,27,344,2296,41,183,10982,3101,14083,0.0805213,-0.302064,-0.949881,1
3682,1559,18,214,1498,26,120,7117,2862,9979,0.0368291,-0.280277,-0.959213,1
5429,2128,26,296,2158,42,170,10249,5699,15948,0.0307829,-0.284443,-0.958199,1
5384,1933,27,263,1861,43,150,9661,6883,16544,0.119426,-0.484984,-0.86633,1
5336,1619,27,229,1599,55,137,9002,11777,20779,0.118866,-0.457693,-0.881129,1
2262,587,12,82,570,18,46,3577,-1000,-1000,-1,-1,-1,1
2556,587,14,84,549,19,45,3854,3584,7438,0.0642475,-0.294756,-0.95341,1
5311,1282,27,209,1115,42,96,8082,11498,19580,0.0715979,-0.272965,-0.959356,1
3675,873,19,126,883,28,73,5677,12052,17729,0.00759443,-0.334824,-0.94225,1
2333,630,12,89,598,16,48,3726,3230,6956,0.0864822,-0.274068,-0.957814,1
5434,1796,27,272,1743,41,173,9486,19680,29166,0.133985,-0.347237,-0.928157,1
1865,649,9,86,639,12,49,3309,-1000,-1000,-1,-1,-1,1
1896,762,10,103,742,12,56,3581,5743,9324,0.0527083,-0.361378,-0.930928,1
5168,2331,27,307,2324,35,173,10365,5388,15753,0.045939,-0.281003,-0.958607,1
5779,2769,30,357,2711,46,200,11892,1917,13809,0.0259969,-0.257033,-0.966053,1
5370,3539,34,492,2499,41,181,12156,1488,13644,0.0158634,-0.250588,-0.967964,1
4716,2102,24,283,2110,38,160,9433,1436,10869,0.0634445,-0.230345,-0.971039,1
5772,2597,29,332,2337,41,174,11282,1345,12627,0.0175411,-0.253245,-0.967243,1
5379,2050,25,277,1995,39,159,9924,1782,11706,0.0628548,-0.275265,-0.959312,1
5764,2017,31,273,1960,46,153,10244,1851,12095,0.0729591,-0.364363,-0.928395,1
5607,1570,19,170,1208,32,94,8700,1115,9815,0.0572584,-0.367989,-0.928066,1
2354,714,12,96,676,23,53,3928,607,4535,0.0601104,-0.275461,-0.959431,1
5685,1528,26,210,1540,76,124,9189,1521,10710,0.0292986,-0.289931,-0.956599,1
5699,1631,26,219,1634,90,127,9426,1544,10970,0.0178945,-0.245396,-0.969258,1
5712,1776,25,231,1769,67,134,9714,2407,12121,0.0463072,-0.195129,-0.979684,1
5817,1902,27,243,1935,61,141,10126,1453,11579,-0.00822967,-0.239164,-0.970944,1
5790,1995,27,254,1946,59,148,10219,1501,11720,-0.00738058,-0.259197,-0.965796,1
5889,2056,33,299,1994,48,153,10472,1386,11858,0.0275298,-0.387453,-0.921478,1
3856,1083,15,145,1082,40,86,6307,775,7082,0.0265098,-0.286283,-0.957778,1
2019,651,9,86,633,16,49,3463,511,3974,0.0456884,-0.235178,-0.970878,1
1771,658,9,89,636,15,50,3228,568,3796,0.0279181,-0.163034,-0.986225,1
5703,2095,30,284,2097,52,164,10425,1973,12398,0.00771602,-0.184371,-0.982827,1
5599,1934,29,257,1851,67,151,9888,3160,13048,0.00804261,-0.205862,-0.978548,1
5486,1634,30,233,1679,41,132,9235,3903,13138,0.0475653,-0.25526,-0.965702,1
5540,1329,29,195,1329,40,112,8574,3513,12087,0.0920301,-0.296781,-0.950501,1
3936,806,20,120,785,28,67,5762,4759,10521,0.055064,-0.233818,-0.97072,1
5485,1288,28,187,1263,44,132,8427,6786,15213,0.0034762,-0.247845,-0.968794,1
3942,1131,19,157,1105,34,89,6477,9339,15816,0.0133809,-0.311918,-0.950015,1
4489,1659,20,220,1630,52,126,8196,6200,14396,0.0662589,-0.281599,-0.957242,1
5637,2331,24,306,2257,62,174,10791,6647,17438,0.122141,-0.291715,-0.948675,1
3879,1796,18,233,1796,29,134,7885,3318,11203,0.0577527,-0.323597,-0.944431,1
3054,1476,14,194,1425,20,108,6291,1422,7713,0.0164451,-0.351937,-0.935879,1
5498,2936,26,355,2806,58,206,11885,1923,13808,0.037467,-0.346992,-0.93712,1
5440,2781,24,363,2807,54,208,11677,2944,14621,0.0506561,-0.324231,-0.944621,1
5333,2742,24,347,2698,61,198,11403,1544,12947,0.0488142,-0.324451,-0.944642,1
5435,2567,26,326,2918,62,197,11531,1471,13002,0.0515102,-0.434626,-0.899137,1
3398,1163,14,168,1143,31,93,6010,714,6724,0.0577018,-0.339443,-0.938856,1
5340,2002,26,266,1893,43,145,9715,1508,11223,0.0504486,-0.33853,-0.939603,1
4877,1588,25,205,1439,40,116,8290,1248,9538,0.0242802,-0.346083,-0.93789,1
5575,1642,32,215,1496,47,118,9125,1481,10606,0.0214246,-0.474892,-0.879784,1
5761,1449,30,145,1114,39,82,8620,1013,9633,0.0197788,-0.449707,-0.892957,1
2581,679,13,91,633,23,50,4070,613,4683,0.0106295,-0.365409,-0.930786,1
2342,660,13,91,636,29,50,3821,622,4443,0.00711864,-0.321571,-0.946859,1
5610,1715,29,234,1658,57,129,9432,1477,10909,0.0138506,-0.325141,-0.945564,1
5634,1771,29,236,1746,59,137,9612,1412,11024,0.0195057,-0.302174,-0.953053,1
5554,1953,30,252,1893,63,144,9889,1467,11356,0.00905187,-0.301052,-0.953565,1
5399,1902,29,254,1802,71,144,9601,1532,11133,0.015248,-0.283524,-0.958844,1
5469,1904,31,264,1931,69,152,9820,1431,11251,0.0102752,-0.259125,-0.965789,1
5226,2074,29,277,1986,45,158,9795,1440,11235,0.0381436,-0.297303,-0.954021,1
5209,2343,29,298,2083,46,170,10178,1448,11626,0.0518798,-0.288863,-0.955964,1
5336,2464,28,360,2340,45,187,10760,1444,12204,0.0285027,-0.283235,-0.958627,1
5389,2503,26,340,2579,44,197,11078,1676,12754,0.0577697,-0.271633,-0.960665,1
5417,2260,24,303,2220,54,172,10450,1606,12056,0.043017,-0.280598,-0.958861,1
4784,2100,23,291,2105,32,164,9499,1707,11206,0.0277129,-0.257887,-0.965778,1
5314,2296,26,309,2228,38,179,10390,1923,12313,0.0304236,-0.265085,-0.963745,1
5408,2286,25,306,2228,43,234,10530,1624,12154,0.0364783,-0.27321,-0.961263,1
3729,1470,19,212,1474,28,118,7050,1860,8910,0.0335019,-0.26961,-0.962387,1
4948,1826,23,286,1884,35,143,9145,2872,12017,0.0388168,-0.285006,-0.957739,1
5396,1674,20,188,1261,27,101,8667,2248,10915,0.0575617,-0.307882,-0.949682,1
5584,1684,34,240,1514,39,130,9225,5763,14988,0.0609825,-0.300117,-0.951951,1
2817,749,15,108,722,20,60,4491,4669,9160,0.136755,-0.316342,-0.938736,1
5350,1372,29,192,1200,40,105,8288,4500,12788,0.0896112,-0.305749,-0.947886,1
5434,1209,28,172,1084,35,93,8055,4246,12301,0.0942342,-0.335225,-0.937414,1
3634,802,19,138,758,32,67,5450,3977,9427,0.117298,-0.30502,-0.945095,1
3896,862,20,126,816,28,69,5817,5288,11105,0.114567,-0.294369,-0.9488,1
4716,1255,24,183,1210,33,101,7522,9153,16675,0.039917,-0.295973,-0.954362,1
3409,1156,18,156,1082,26,122,5969,3138,9107,0.0302392,-0.30484,-0.951924,1
6757,2160,35,290,2653,47,165,12107,3873,15980,0.0336012,-0.304165,-0.952027,1
3993,1664,20,221,1671,31,122,7722,1551,9273,0.016515,-0.252336,-0.967499,1
4274,1822,21,230,1715,29,129,8220,2120,10340,0.0609655,-0.278584,-0.958475,1
3884,1785,20,253,1722,29,130,7823,1894,9717,0.0260222,-0.27774,-0.960304,1
5858,2606,27,331,2439,59,187,11507,2109,13616,0.0357843,-0.355003,-0.93418,1
4485,1375,16,165,1208,32,97,7378,1422,8800,0.0269394,-0.304819,-0.952029,1
2216,772,12,120,729,16,57,3922,942,4864,0.0261664,-0.258165,-0.965746,1
2446,869,14,117,841,21,66,4374,1223,5597,-0.00966355,-0.267079,-0.963626,1
5641,1785,29,240,1720,76,160,9651,2283,11934,-0.00958002,-0.278991,-0.960246,1
5750,2008,37,358,2088,58,138,10437,1526,11963,0.0194979,-0.25359,-0.967116,1
5506,1675,28,225,1653,53,130,9270,1527,10797,0.0251614,-0.222676,-0.974568,1
3958,1183,19,156,1149,41,88,6594,1172,7766,0.0203873,-0.215243,-0.976348,1
6625,1769,26,262,1782,58,137,10659,1928,12587,-0.00555239,-0.169731,-0.985475,1
5834,1872,26,281,1856,40,150,10059,1822,11881,-0.00277104,-0.178344,-0.983964,1
6079,1841,27,243,1873,51,161,10275,1515,11790,0.00295572,-0.18826,-0.982115,1
2955,999,14,130,970,22,84,5174,842,6016,0.00431884,-0.170877,-0.985283,1
5643,1998,25,248,1854,47,145,9960,1918,11878,-0.0101597,-0.156326,-0.987653,1
5583,2010,27,251,1858,48,145,9922,1868,11790,-0.0160576,-0.13888,-0.990179,1
5728,1901,26,278,2195,70,188,10386,1592,11978,-0.00860482,-0.108457,-0.994064,1
5746,1321,19,173,1296,38,98,8691,834,9525,-0.0135823,-0.110345,-0.9938,1
2375,816,10,113,806,23,60,4203,542,4745,-0.00520109,-0.125249,-0.992112,1
2601,911,13,119,878,29,67,4618,647,5265,-0.00796896,-0.138408,-0.990343,1
5800,1947,26,275,1970,63,181,10262,1360,11622,-0.002834,-0.163612,-0.986521,1
3973,1325,18,171,1362,40,99,6988,749,7737,0.0129174,-0.157366,-0.987456,1
2387,850,12,126,824,20,53,4272,524,4796,0.00352007,-0.140171,-0.990121,1
2174,791,10,99,744,21,56,3895,559,4454,0.0123265,-0.134164,-0.990882,1
5655,2008,27,251,1918,55,146,10060,1400,11460,0.00425952,-0.122464,-0.992464,1
5649,2123,28,258,2426,67,180,10731,1281,12012,-0.000152115,-0.119676,-0.992813,1
3936,1367,18,172,1365,40,102,7000,970,7970,0.00557896,-0.13343,-0.991042,1
5752,1913,27,266,1888,78,146,10070,1498,11568,0.0270899,-0.141779,-0.989528,1
5704,2020,26,248,2029,67,177,10271,1393,11664,0.0297927,-0.134274,-0.990497,1
3904,1294,17,185,1319,55,102,6876,1013,7889,-0.00456627,-0.120869,-0.992658,1
5844,1941,26,277,1884,60,144,10176,1436,11612,0.00471894,-0.125106,-0.992132,1
5732,1870,18,187,1257,35,98,9197,1011,10208,0.0155455,-0.0872328,-0.996066,1
2734,801,10,104,995,33,73,4750,632,5382,0.0117752,-0.154137,-0.98798,1
1937,674,10,85,662,25,49,3442,473,3915,0.00176451,-0.151578,-0.988444,1
5649,1908,27,253,1874,60,145,9916,1518,11434,-0.000126461,-0.149025,-0.988834,1
6516,2157,55,250,2142,66,166,11352,1485,12837,0.0164872,-0.144471,-0.989372,1
5618,1770,20,190,1295,37,99,9029,1116,10145,0.0140042,-0.173155,-0.984795,1
2694,830,13,107,788,22,69,4523,587,5110,0.00859358,-0.169496,-0.985493,1
1962,680,10,92,663,18,50,3475,549,4024,0.00200655,-0.171334,-0.985211,1
5827,1953,26,294,1904,59,151,10214,1820,12034,-0.00918168,-0.185227,-0.982653,1
5633,1975,25,291,1879,49,151,10003,2511,12514,0.00354712,-0.197532,-0.98029,1
5858,2087,25,264,1961,55,150,10400,1412,11812,-0.00181238,-0.238224,-0.971209,1
3943,1486,18,183,1369,42,103,7144,1304,8448,0.0105795,-0.213288,-0.976932,1
6120,2009,28,263,1961,52,153,10586,1800,12386,0.0221712,-0.278574,-0.960159,1
5831,2055,28,274,2057,46,175,10466,1905,12371,0.0278446,-0.212304,-0.976807,1
5705,2036,26,275,1555,33,105,9735,1570,11305,0.0322239,-0.179773,-0.98318,1
3075,1011,15,139,984,28,79,5331,1699,7030,0.0321264,-0.232265,-0.972122,1
7449,2451,31,256,1844,57,150,12238,4196,16434,0.02513,-0.140231,-0.9898,1
3934,1188,21,162,1115,33,91,6544,4792,11336,0.0689864,-0.0579386,-0.995934,1
5042,1394,26,193,1413,48,127,8243,3797,12040,0.0505786,-0.181027,-0.982177,1
5999,1427,29,233,1365,43,114,9210,4907,14117,0.0674026,-0.205676,-0.976296,1
3905,890,20,130,878,30,74,5927,5283,11210,0.0555324,-0.210771,-0.975957,1
3946,926,20,130,851,27,71,5971,9407,15378,0.0549776,-0.220543,-0.973827,1
2923,791,14,112,756,27,61,4684,3660,8344,0.0427252,-0.233289,-0.971469,1
6211,1934,28,243,1741,49,140,10346,6310,16656,0.0689344,-0.256356,-0.964121,1
5603,2026,25,274,2035,49,159,10171,5470,15641,0.077719,-0.228542,-0.970427,1
5883,2120,22,289,2093,43,157,10607,5134,15741,0.0649997,-0.255136,-0.964718,1
2938,1273,12,190,1296,22,96,5827,1996,7823,0.0654888,-0.263244,-0.962504,1
5553,2776,24,356,2664,40,209,11622,1841,13463,0.00906872,-0.308516,-0.951176,1
3855,2010,17,250,1962,28,144,8266,1782,10048,0.0206,-0.333176,-0.94264,1
4877,2622,22,327,2664,42,193,10747,2176,12923,0.00504567,-0.345628,-0.938358,1
4836,2571,22,332,2512,44,217,10534,1631,12165,0.0243534,-0.356867,-0.933838,1
5078,2557,22,357,2541,49,188,10792,1336,12128,-0.0038313,-0.376716,-0.926321,1
4861,2426,22,297,2281,48,167,10102,1306,11408,0.0256856,-0.368337,-0.929338,1
3397,1674,17,197,1487,26,111,6909,977,7886,0.0230222,-0.370024,-0.928737,1
5273,2226,26,281,2143,43,163,10155,1469,11624,0.0434581,-0.357848,-0.932768,1
5477,1970,28,256,1924,50,153,9858,1469,11327,0.0507451,-0.338544,-0.939581,1
5656,1967,28,250,1883,54,143,9981,1554,11535,0.0357049,-0.30968,-0.95017,1
5801,1898,29,248,1826,62,140,10004,1518,11522,0.0179117,-0.307678,-0.951322,1
5581,1871,30,249,1893,71,174,9869,1881,11750,0.0229394,-0.340145,-0.940093,1
5650,1965,32,260,1867,62,140,9976,1394,11370,0.0147279,-0.31953,-0.947462,1
3775,1301,21,172,1284,38,96,6687,948,7635,0.0226631,-0.327102,-0.944718,1
5422,1920,36,306,1870,52,146,9752,1403,11155,0.0297875,-0.320743,-0.946698,1
5469,2008,28,274,2485,57,163,10484,1464,11948,0.0193,-0.295653,-0.9551,1
5450,2026,28,283,1980,49,157,9973,1364,11337,0.00197324,-0.277631,-0.960686,1
5534,2131,29,358,2041,54,166,10313,1121,11434,-0.000887768,-0.28641,-0.958107,1
3777,1487,21,203,1444,32,135,7099,988,8087,0.0184909,-0.259929,-0.965451,1
5066,2044,26,305,2074,37,158,9710,1250,10960,0.0165837,-0.259348,-0.965641,1
4981,2158,26,302,2112,32,165,9776,1253,11029,0.0262198,-0.257669,-0.965877,1
5431,2559,28,343,2478,37,194,11070,1405,12475,0.0219978,-0.256199,-0.966374,1
5379,2714,26,348,2473,27,137,11104,1018,12122,0.0132735,-0.247929,-0.968687,1
4958,2264,29,351,2223,33,177,10035,1428,11463,0.0134321,-0.231132,-0.97283,1
4812,2176,25,295,2009,22,120,9459,1221,10680,0.0277673,-0.244542,-0.969241,1
2644,1167,15,160,1155,17,92,5250,1024,6274,0.0253599,-0.247463,-0.968566,1
5272,2290,28,308,2250,37,177,10362,1929,12291,0.0428911,-0.296245,-0.954149,1
5441,2131,28,292,2077,37,167,10173,1367,11540,0.0581358,-0.301719,-0.951623,1
3693,1301,19,208,1342,24,105,6692,2197,8889,0.0281092,-0.266302,-0.96348,1
4799,1591,27,220,1460,31,120,8248,4052,12300,0.030367,-0.249656,-0.967859,1
5174,1409,27,208,1430,41,146,8435,4105,12540,0.126302,-0.313264,-0.94123,1
3632,959,18,135,956,27,78,5805,4400,10205,0.113421,-0.336113,-0.934967,1
5863,1347,27,193,1293,41,109,8873,4631,13504,0.107868,-0.3129,-0.943641,1
3594,796,28,117,770,27,66,5398,8237,13635,0.138783,-0.388102,-0.911107,1
5331,1225,29,172,1160,37,98,8052,4556,12608,0.099949,-0.301144,-0.948326,1
3713,926,19,134,925,23,73,5813,3619,9432,0.115276,-0.311847,-0.943114,1
5505,1702,28,235,1669,45,133,9317,2445,11762,0.0657682,-0.301988,-0.95104,1
5541,2210,29,299,2114,48,177,10418,2977,13395,0.0707388,-0.28109,-0.957071,1
3941,1803,26,232,1748,42,130,7922,1481,9403,0.0649249,-0.236894,-0.969364,1
5197,2487,27,321,2382,51,178,10643,1863,12506,0.0747917,-0.2455,-0.966507,1
5753,2931,37,477,2873,61,203,12335,2120,14455,0.0360144,-0.287308,-0.957161,1
5138,2276,25,302,2218,53,169,10181,1956,12137,0.10919,-0.305984,-0.945755,1
5107,2118,27,283,2097,36,162,9830,2010,11840,0.0759239,-0.280841,-0.956746,1
5206,2091,28,271,1983,37,151,9767,2157,11924,0.0348394,-0.303018,-0.952348,1
5267,1968,26,258,1950,36,148,9653,1795,11448,0.0125079,-0.288019,-0.957543,1
5822,2229,29,321,2122,44,161,10728,1892,12620,0.0606355,-0.227327,-0.971929,1
5749,2148,27,312,2031,48,159,10474,2287,12761,0.0771234,-0.194934,-0.97778,1
4022,1502,20,192,1426,30,107,7299,1710,9009,0.0168841,-0.258467,-0.965873,1
4021,1529,17,199,1467,29,110,7372,2020,9392,0.00120369,-0.234699,-0.972067,1
5801,2176,27,308,2139,45,160,10656,2239,12895,0.0133976,-0.262183,-0.964925,1
5630,2149,27,303,2133,63,161,10466,1454,11920,0.00674865,-0.23509,-0.971951,1
5303,2114,23,257,1958,43,145,9843,1301,11144,0.0189304,-0.247206,-0.968778,1
5167,1993,24,257,1939,37,157,9574,1285,10859,0.0214647,-0.2323,-0.972408,1
5073,2046,23,267,2024,35,156,9624,1393,11017,0.0325697,-0.235849,-0.971244,1
6144,2299,28,304,2264,50,171,11260,2279,13539,0.0532417,-0.241946,-0.968828,1
5643,2081,26,274,2355,53,176,10608,2462,13070,0.0624697,-0.202879,-0.977209,1
3865,1643,24,199,1422,26,110,7289,1678,8967,0.0294747,-0.252211,-0.967223,1
5181,1500,29,212,1438,34,118,8512,2428,10940,0.0388529,-0.264348,-0.963645,1
2794,603,16,89,574,19,49,4144,2076,6220,0.0629209,-0.227575,-0.971726,1
5714,1165,28,177,1132,44,97,8357,4138,12495,0.0577381,-0.275713,-0.959504,1
5553,2022,31,217,1620,46,124,9613,3929,13542,0.0679562,-0.280967,-0.957309,1
3824,1305,33,174,1317,42,105,6800,3052,9852,0.0567852,-0.285007,-0.956842,1
5162,2144,36,274,2385,57,154,10212,4817,15029,0.0504146,-0.286088,-0.956876,1
3619,1535,15,204,1489,27,115,7004,2346,9350,0.0486375,-0.296769,-0.95371,1
5676,2589,24,334,2546,42,196,11407,1810,13217,0.0432681,-0.318145,-0.947055,1
3835,1882,17,245,1840,27,138,7984,2024,10008,0.0380544,-0.31548,-0.948169,1
5410,2847,24,354,2821,53,232,11741,2875,14616,0.0511863,-0.306089,-0.950626,1
5549,2809,25,509,2990,38,147,12067,1052,13119,0.0452193,-0.307591,-0.950444,1
5449,2812,25,360,2695,54,199,11594,1430,13024,0.0354732,-0.384024,-0.922641,1
4646,1907,18,245,1833,26,109,8784,774,9558,0.0374768,-0.339905,-0.939713,1
2197,1064,10,125,969,21,70,4456,510,4966,0.0280563,-0.281297,-0.959211,1
5382,2831,24,346,2661,49,196,11489,1385,12874,0.044139,-0.355051,-0.933804,1
3944,1389,13,174,1414,37,124,7095,757,7852,0.0514136,-0.275802,-0.959839,1
2257,1036,12,134,1014,28,74,4555,592,5147,0.0357919,-0.269764,-0.962261,1
5390,2460,32,309,2357,50,176,10774,1418,12192,0.0163768,-0.3319,-0.943173,1
5692,2566,34,494,3040,45,216,12087,1441,13528,0.0167373,-0.311219,-0.950191,1
5659,2317,29,293,2171,37,120,10626,942,11568,0.0346974,-0.286059,-0.957584,1
5726,2281,37,452,2747,52,170,11465,1420,12885,0.0260546,-0.394167,-0.918669,1
6945,2064,20,209,1541,34,112,10925,997,11922,0.0233057,-0.400044,-0.9162,1
2686,936,13,119,900,21,67,4742,594,5336,0.0234386,-0.32041,-0.946989,1
1724,619,10,80,608,18,46,3105,469,3574,0.0192622,-0.295231,-0.955232,1
4653,1622,25,240,1617,54,121,8332,1139,9471,0.0255308,-0.299891,-0.953632,1
5671,1946,36,258,1908,67,149,10035,1399,11434,0.0097344,-0.356352,-0.934301,1
5295,1416,20,188,1405,41,108,8473,928,9401,5.50143e-05,-0.309327,-0.950956,1
2565,1002,13,123,793,18,58,4572,502,5074,0.00791713,-0.256411,-0.966536,1
1836,746,11,100,738,14,56,3501,525,4026,-0.00176523,-0.246263,-0.969201,1
5496,2287,28,336,2047,41,154,10389,1381,11770,0.0142397,-0.251587,-0.96773,1
5384,2739,34,445,2397,51,184,11234,1435,12669,0.0379108,-0.253977,-0.966467,1
5445,2519,28,347,2515,36,191,11081,1612,12693,0.0129767,-0.248408,-0.968569,1
3682,2022,25,356,1821,27,137,8070,1106,9176,0.00629567,-0.225004,-0.974338,1
5297,2707,36,465,2530,37,197,11269,1773,13042,0.0165717,-0.245061,-0.969366,1
5346,2460,38,338,2435,37,193,10847,1703,12550,0.0240592,-0.249822,-0.967993,1
5296,2460,26,337,2578,38,195,10930,2625,13555,0.037462,-0.279163,-0.959513,1
3640,1609,18,221,1629,25,127,7269,1707,8976,0.0554749,-0.268783,-0.961602,1
5531,2333,26,317,2258,37,180,10682,2829,13511,0.0256106,-0.284274,-0.958401,1
3652,1531,18,208,1504,42,119,7074,2727,9801,0.0353249,-0.282857,-0.958512,1
5427,2100,26,354,2012,40,163,10122,3396,13518,0.0998366,-0.324414,-0.940632,1
5533,1777,35,276,1794,40,145,9600,4895,14495,0.091563,-0.350276,-0.932161,1
3708,972,18,141,952,29,80,5900,4745,10645,0.105493,-0.380971,-0.918549,1
5430,1167,27,176,1181,53,102,8136,14240,22376,0.0700862,-0.41129,-0.908806,1
3622,890,20,144,800,43,70,5589,5809,11398,0.0243024,-0.328248,-0.944279,1
5355,1508,29,215,1473,46,121,8747,6888,15635,0.0493953,-0.431745,-0.900642,1
3653,1062,15,147,1041,20,80,6018,4638,10656,0.0725656,-0.414451,-0.907174,1
2033,869,10,116,771,12,57,3868,636,4504,0.0330037,-0.312599,-0.949312,1
1663,790,9,103,766,11,58,3400,610,4010,0.0209397,-0.291741,-0.956268,1
5823,2686,29,380,2620,41,197,11776,1593,13369,0.0701579,-0.311169,-0.947761,1
5911,2864,31,354,2579,26,136,11901,1300,13201,0.0346291,-0.311125,-0.949738,1
3969,1912,21,244,1944,28,143,8261,1147,9408,0.0363973,-0.288279,-0.956855,1
5643,2942,33,355,2664,43,193,11873,1548,13421,0.0606921,-0.292218,-0.954424,1
3923,1923,20,241,1885,48,136,8176,1167,9343,0.0374377,-0.269309,-0.962326,1
4006,2029,19,236,1906,64,137,8397,1423,9820,0.0717019,-0.211087,-0.974834,1
6002,2880,27,346,2699,81,196,12231,2226,14457,0.0359758,-0.312692,-0.949173,1
3557,1516,14,180,1438,27,102,6834,686,7520,0.0177993,-0.308911,-0.950925,1
1899,791,8,98,774,19,56,3645,458,4103,-0.00350214,-0.228903,-0.973443,1
1912,816,9,100,791,18,57,3703,503,4206,-0.0133092,-0.213817,-0.976783,1
5548,2008,23,265,2049,55,155,10103,1327,11430,0.0321477,-0.231904,-0.972208,1
5954,2598,34,371,2263,48,169,11437,1780,13217,0.0228766,-0.230949,-0.972697,1
5701,2261,26,292,2155,59,186,10680,1798,12478,0.031262,-0.276919,-0.960385,1
4935,1662,39,209,1467,35,89,8436,1048,9484,0.0152664,-0.238221,-0.971091,1
2424,951,13,134,881,15,61,4479,850,5329,0.0339945,-0.145084,-0.988835,1
2279,874,14,117,823,16,65,4188,955,5143,0.0333422,-0.139888,-0.989606,1
5547,1801,31,269,1707,40,139,9534,2591,12125,0.0130562,-0.193712,-0.980972,1
5664,1480,31,214,1414,42,115,8960,4929,13889,0.0276188,-0.184017,-0.982535,1
3746,923,21,128,824,29,70,5741,5280,11021,0.0873204,-0.218675,-0.971883,1
5022,1050,26,155,1037,36,87,7413,8582,15995,0.134471,-0.25369,-0.957893,1
3574,777,19,113,807,27,66,5383,6720,12103,0.149788,-0.235915,-0.96016,1
3497,928,17,142,897,29,72,5582,14976,20558,0.155174,-0.151619,-0.976183,1
2214,690,11,93,655,18,54,3735,2819,6554,0.10109,-0.203505,-0.973841,1
5462,2008,27,274,2102,50,153,10076,17108,27184,0.107508,-0.252797,-0.961528,1
2359,952,11,124,919,16,70,4451,2453,6904,0.117146,-0.236543,-0.964533,1
3380,1584,16,198,1565,40,115,6898,2158,9056,0.0986499,-0.247971,-0.963732,1
5697,2884,28,366,2868,39,211,12093,2568,14661,0.0932265,-0.325124,-0.941065,1
4900,2331,22,302,1889,21,122,9587,1777,11364,0.076445,-0.333416,-0.939675,1
2349,1542,11,199,1503,25,108,5737,730,6467,0.0884071,-0.325998,-0.941227,1
5569,3743,26,446,4030,44,261,14119,1688,15807,0.0672721,-0.376378,-0.924021,1
5700,3761,27,490,3251,26,181,13436,1040,14476,0.0469154,-0.380956,-0.923402,1
2915,2088,15,246,2079,29,140,7512,738,8250,0.0686194,-0.356412,-0.931806,1
5739,3967,30,486,3824,58,263,14367,1393,15760,0.0590261,-0.3713,-0.926635,1
6040,3898,29,458,3313,30,182,13950,964,14914,0.0285176,-0.367383,-0.929633,1
3213,1903,15,232,1952,22,132,7469,743,8212,0.0192531,-0.339777,-0.940309,1
6012,3399,31,406,3280,57,266,13451,1319,14770,0.0336105,-0.355317,-0.934142,1
5356,2701,40,344,2587,54,187,11269,1252,12521,0.0227637,-0.338219,-0.940792,1
5271,2490,30,312,2423,53,176,10755,1313,12068,0.0194518,-0.319117,-0.947515,1
5147,2210,44,284,2169,64,165,10083,1339,11422,0.020603,-0.300359,-0.953604,1
5607,2345,43,344,2331,57,171,10898,1455,12353,0.0420513,-0.314079,-0.948465,1
5063,2198,28,276,2158,72,158,9953,1291,11244,0.0433207,-0.320456,-0.946272,1
5495,2123,31,285,2187,74,165,10360,1439,11799,0.0237546,-0.308895,-0.950799,1
4884,2027,38,306,1957,37,154,9403,1269,10672,0.0281451,-0.290168,-0.956562,1
5592,2526,32,387,2383,60,189,11169,1459,12628,0.0331758,-0.306844,-0.951182,1
5566,2613,28,344,2545,67,193,11356,2136,13492,0.0353687,-0.348808,-0.936526,1
5486,2403,28,326,2405,37,184,10869,2170,13039,0.0564142,-0.349034,-0.93541,1
3819,1553,18,212,1584,31,123,7340,2098,9438,0.0415482,-0.292953,-0.955224,1
5554,2067,28,291,2003,37,162,10142,2014,12156,0.036708,-0.28863,-0.956737,1
5550,1903,57,250,1748,38,142,9688,2579,12267,0.0299388,-0.273743,-0.961337,1
3699,1086,19,152,1045,25,86,6112,1815,7927,0.00274469,-0.273163,-0.961963,1
5722,1424,29,205,1399,38,115,8932,3615,12547,0.0347614,-0.296542,-0.954387,1
5263,1461,34,281,1401,39,111,8590,3471,12061,0.0247606,-0.272883,-0.961729,1
3731,932,25,137,947,24,75,5871,4050,9921,0.0363332,-0.256548,-0.965848,1
5348,1438,30,214,1526,33,113,8702,4324,13026,0.0430889,-0.26681,-0.962786,1
4976,1638,26,221,1590,33,122,8606,3027,11633,0.0220165,-0.244952,-0.969286,1
4974,2084,26,262,1971,34,148,9499,2112,11611,0.0154717,-0.237764,-0.9712,1
5702,3116,35,401,2565,38,203,12060,1804,13864,0.0260008,-0.251858,-0.967415,1
3839,2029,20,255,1951,31,143,8268,1893,10161,0.0482576,-0.238271,-0.969999,1
5844,3230,31,408,3208,48,230,12999,2736,15735,0.0470657,-0.228119,-0.972495,1
4183,2387,20,315,2382,35,171,9493,2079,11572,0.045858,-0.226426,-0.972948,1
6018,3596,29,468,3563,52,257,13983,2378,16361,-0.017354,-0.22767,-0.973584,1
4115,2518,21,328,2467,34,180,9663,2244,11907,0.0137463,-0.198194,-0.980066,1
5961,3716,28,463,3426,33,179,13806,1628,15434,-0.0132659,-0.236909,-0.971441,1
4058,2439,20,303,2448,38,172,9478,1230,10708,0.0354314,-0.219774,-0.974907,1
5824,3530,31,469,3491,33,242,13620,1471,15091,0.0519409,-0.242587,-0.968738,1
6193,3474,31,433,3305,36,254,13726,1222,14948,0.00889702,-0.339211,-0.940668,1
3161,1730,13,178,1429,18,105,6634,620,7254,-0.00289468,-0.268367,-0.963312,1
1842,1032,10,127,955,12,65,4043,429,4472,0.0196972,-0.230846,-0.972791,1
2267,1259,11,155,1245,20,91,5048,549,5597,0.0174516,-0.18203,-0.983138,1
5943,3408,30,395,3236,44,229,13285,1434,14719,0.0180284,-0.201736,-0.979274,1
6039,3276,31,389,3129,69,223,13156,1052,14208,-0.00990876,-0.166492,-0.985993,1
4202,2179,18,259,2129,36,147,8970,1022,9992,-0.00686073,-0.208411,-0.978017,1
6058,2800,25,398,2735,52,196,12264,1488,13752,-0.00838923,-0.310844,-0.950424,1
3700,1345,13,164,1322,36,99,6679,774,7453,0.00586248,-0.166247,-0.986067,1
2008,713,8,89,700,30,51,3599,514,4113,0.0112372,-0.0478246,-0.998793,1
1607,635,8,80,632,11,46,3019,502,3521,0.0293886,-0.0435865,-0.998617,1
6064,2450,28,317,2408,45,179,11491,2603,14094,0.0471213,-0.205855,-0.977447,1
4540,1827,22,228,1279,19,95,8010,1190,9200,0.0193327,-0.0962695,-0.995167,1
2474,1050,11,120,894,26,67,4642,1017,5659,-0.0154717,-0.0861933,-0.996159,1
5814,2537,31,327,2400,44,184,11337,2313,13650,0.0325187,-0.169353,-0.985019,1
3845,1515,20,235,1420,27,109,7171,1874,9045,0.0941613,-0.155641,-0.983315,1
5653,1729,33,260,1665,50,135,9525,2176,11701,0.0420414,-0.201212,-0.978645,1
5859,1493,32,212,1460,49,119,9224,2581,11805,0.0490079,-0.253225,-0.966165,1
5650,1665,30,233,1641,52,128,9399,2840,12239,0.0629179,-0.325794,-0.943345,1
5779,2407,30,295,2291,37,170,11009,3649,14658,0.0801909,-0.310442,-0.947204,1
6072,3135,24,287,2176,29,152,11875,1808,13683,0.0570584,-0.320538,-0.945516,1
3297,2090,14,244,2171,24,140,7980,1297,9277,0.050276,-0.299687,-0.952712,1
6287,4497,25,525,4121,31,208,15694,1222,16916,-0.0067875,-0.222153,-0.974988,1
3261,2473,13,295,2494,25,168,8729,877,9606,0.0279395,-0.295566,-0.954914,1
6261,4921,25,594,4846,48,329,17024,1420,18444,0.037092,-0.330565,-0.943054,1
4238,3341,17,397,3305,29,226,11553,984,12537,0.0240332,-0.305075,-0.952025,1
6178,4793,25,572,4709,47,321,16645,1382,18027,0.0165928,-0.303889,-0.952563,1
4278,3260,18,414,3286,36,223,11515,1038,12553,0.034993,-0.28637,-0.95748,1
6003,4733,29,556,4215,37,219,15792,968,16760,0.0337559,-0.286485,-0.95749,1
3077,2362,13,272,2348,24,156,8252,741,8993,0.0340411,-0.25411,-0.966576,1
5941,4222,28,488,4144,54,307,15184,958,16142,0.0603843,-0.271776,-0.960464,1
4070,2906,20,330,2785,27,189,10327,943,11270,0.0740902,-0.263385,-0.961842,1
6058,4115,28,477,4059,45,271,15053,1274,16327,0.0566854,-0.301464,-0.951791,1
4152,2812,20,323,2809,40,190,10346,1003,11349,0.0470488,-0.285868,-0.957113,1
6151,4064,30,485,3880,49,284,14943,1431,16374,0.0673541,-0.279884,-0.957668,1
4224,2686,20,325,2653,38,186,10132,1037,11169,0.0650135,-0.259479,-0.963558,1
5960,3741,31,442,3416,48,228,13866,1411,15277,0.0563468,-0.255667,-0.965122,1
4082,2422,23,288,2313,42,162,9332,992,10324,0.0554172,-0.236135,-0.970139,1
5349,2945,27,357,2881,44,204,11807,1301,13108,0.0571086,-0.221232,-0.973547,1
4847,2614,27,316,2493,51,172,10520,1191,11711,0.0521662,-0.222018,-0.973646,1
5857,3041,42,418,2997,64,213,12632,1147,13779,0.0472827,-0.217824,-0.974842,1
4007,1996,22,262,1900,30,139,8356,943,9299,-0.00159001,-0.186775,-0.982401,1
6012,2667,34,371,2674,47,190,11995,1434,13429,0.0211955,-0.144887,-0.989221,1
5741,2468,32,315,2475,67,180,11278,1415,12693,0.0210617,-0.13506,-0.990614,1
5828,2553,32,326,2493,60,180,11472,1450,12922,0.0127684,-0.119974,-0.992695,1
5692,3110,39,380,2704,89,195,12209,1394,13603,0.0109649,-0.107103,-0.994188,1
3895,1910,24,238,1839,38,132,8076,1003,9079,0.00999506,-0.0849689,-0.996334,1
5118,2985,27,313,2359,50,174,11026,1289,12315,0.00808451,-0.0691182,-0.997576,1
5741,2691,29,344,2625,62,194,11686,1425,13111,0.00692408,-0.0608536,-0.998123,1
3867,1883,19,240,1874,42,138,8063,974,9037,0.00604203,-0.0466445,-0.998893,1
5570,2749,47,353,2684,62,199,11664,1454,13118,0.00540905,-0.0800676,-0.996775,1
5586,2735,28,361,2682,57,198,11647,1408,13055,0.00433395,-0.0559348,-0.998425,1
5650,3022,37,457,2862,58,199,12285,1120,13405,0.00670993,-0.0468362,-0.99888,1
3783,1938,25,250,1831,38,137,8002,1010,9012,0.00504226,-0.0533334,-0.998564,1
5830,2952,29,359,2720,59,207,12156,1400,13556,-0.000237906,-0.0570342,-0.998372,1
5476,2811,28,382,2767,62,213,11739,1409,13148,-0.00272266,-0.0450431,-0.998981,1
5622,2846,28,368,2821,54,213,11952,1003,12955,-0.00576268,-0.0590351,-0.998239,1
5592,2873,29,370,2766,58,211,11899,1460,13359,-0.00413794,-0.0825972,-0.996575,1
3600,1492,15,195,1478,27,110,6917,731,7648,-0.00195196,-0.0688603,-0.997625,1
1788,883,9,115,882,15,66,3758,436,4194,-0.00188835,-0.0499255,-0.998751,1
5605,2913,29,392,2881,59,221,12100,1402,13502,-0.00516263,-0.0302903,-0.999528,1
5397,2831,28,373,2858,57,216,11760,1383,13143,-0.00868107,-0.00311803,-0.999958,1
3716,1995,19,254,1964,40,147,8135,991,9126,-0.00375246,-0.00513475,-0.99998,1
5650,2803,29,384,2765,55,205,11891,1453,13344,-0.00351335,-0.0235531,-0.999716,1
5516,2875,27,371,2823,57,212,11881,1329,13210,-0.00506138,-0.0225783,-0.999733,1
3819,1993,19,260,1956,38,143,8228,996,9224,-0.00370527,-0.0261692,-0.999651,1
5616,2887,26,390,2859,57,215,12050,1517,13567,-0.00500591,-0.0234368,-0.999713,1
5564,2996,67,375,2438,40,155,11635,999,12634,-0.00635662,-0.0252277,-0.999662,1
3878,1985,20,275,1948,54,147,8307,968,9275,-0.00568179,-0.0209867,-0.999764,1
5463,2910,27,366,2782,55,210,11813,1438,13251,-0.00430831,-0.0144944,-0.999886,1
5602,2895,28,386,2838,58,213,12020,1368,13388,-0.00563334,-0.00639576,-0.999964,1
3816,1953,19,255,1972,30,145,8190,961,9151,-0.00871856,-0.0140658,-0.999863,1
5625,3226,30,377,3022,59,215,12554,1438,13992,-0.00930668,-0.0199467,-0.999758,1
5572,3376,28,365,2792,54,210,12397,1406,13803,-0.010447,-0.00808729,-0.999913,1
5715,3585,30,378,2167,37,143,12055,978,13033,-0.0123709,-0.00896871,-0.999883,1
5682,3222,29,371,2969,58,677,13008,1413,14421,-0.0103983,-0.0174023,-0.999794,1
3400,1689,15,193,1476,30,118,6921,641,7562,-0.0107484,-0.0239617,-0.999655,1
1996,1016,10,130,996,19,80,4247,513,4760,-0.0103201,-0.0276081,-0.999565,1
3770,2033,20,305,1927,38,148,8241,979,9220,-0.0114782,-0.0111019,-0.999873,1
5023,2900,35,587,3247,80,269,12141,1293,13434,-0.0138088,-0.0246902,-0.9996,1
5275,2544,49,331,2636,51,192,11078,1315,12393,-0.0121395,-0.0172506,-0.999777,1
3627,1845,18,232,1858,36,137,7753,944,8697,-0.01148,-0.0221325,-0.999689,1
4185,1866,18,240,1848,36,136,8329,924,9253,-0.00939506,-0.0104579,-0.999901,1
4618,2329,23,301,2326,44,170,9811,1124,10935,-0.0109791,-0.0119776,-0.999868,1
5541,2853,50,400,2802,57,214,11917,1452,13369,-0.0108539,-0.0280759,-0.999547,1
5514,2865,44,371,2524,50,148,11516,967,12483,-0.00904681,-0.00923751,-0.999916,1
4513,1999,20,253,1995,52,146,8978,1008,9986,-0.00948743,-0.0189813,-0.999775,1
4986,2529,25,363,2682,88,290,10963,1477,12440,-0.0128308,-0.0296728,-0.999477,1
4976,2646,26,335,2602,49,196,10830,1308,12138,-0.0125529,-0.0166263,-0.999783,1
4921,2596,27,333,2648,69,197,10791,1271,12062,-0.0111894,-0.023347,-0.999665,1
5206,2627,25,331,2548,52,189,10978,1010,11988,-0.0108908,-0.0168472,-0.999799,1
5565,2874,31,391,2865,46,235,12007,1424,13431,-0.00888287,-0.014562,-0.999855,1
5495,2915,28,370,2881,68,214,11971,1431,13402,-0.00980746,-0.0177314,-0.999795,1
3774,2008,19,256,1941,39,148,8185,1021,9206,-0.0098503,-0.0137887,-0.999857,1
5523,2871,44,364,2870,58,214,11944,1398,13342,-0.00769744,-0.00994862,-0.999921,1
5440,2907,28,375,2873,57,213,11893,1413,13306,-0.00881806,-0.0171836,-0.999814,1
5556,2944,26,366,2884,59,209,12044,1431,13475,-0.0125596,-0.0155126,-0.999801,1
5502,2885,27,378,2833,75,221,11921,1462,13383,-0.0180893,-0.0204241,-0.999628,1
5502,2922,29,373,2879,59,213,11977,1395,13372,-0.0145202,-0.00876018,-0.999856,1
5667,2907,28,375,2890,60,213,12140,1467,13607,-0.00880095,-0.0289207,-0.999543,1
5453,2926,21,326,2039,45,150,10960,955,11915,-0.00602109,-0.00974034,-0.999934,1
2871,1488,14,188,1179,21,86,5847,647,6494,-0.00798848,-0.0128077,-0.999886,1
1955,1026,40,130,1008,20,73,4252,518,4770,-0.0111793,-0.0293377,-0.999507,1
3769,2049,18,257,1998,43,145,8279,982,9261,-0.00903623,-0.0421097,-0.999072,1
5606,3234,27,407,3174,63,230,12741,1422,14163,-0.00542598,-0.060733,-0.998139,1
5711,3297,26,411,3284,66,163,12958,992,13950,0.018378,-0.0840245,-0.996294,1
6057,3481,28,425,2336,39,164,12530,950,13480,0.00370681,-0.11335,-0.993548,1
3955,2286,19,290,2287,37,165,9039,1039,10078,-0.0199017,-0.128121,-0.991559,1
5867,3265,27,405,3152,46,236,12998,1474,14472,-0.021262,-0.132018,-0.991019,1
3841,2232,19,276,2084,31,152,8635,1041,9676,-0.00889602,-0.12415,-0.992224,1
5605,2796,41,359,2731,41,205,11778,1597,13375,-0.00844587,-0.145453,-0.989329,1
5657,2504,25,337,2451,41,233,11248,2036,13284,-0.00360277,-0.173788,-0.984777,1
4954,2135,33,281,2243,49,216,9911,1691,11602,0.0115648,-0.207684,-0.978128,1
5312,2212,24,286,2127,33,160,10154,1777,11931,0.00379198,-0.205497,-0.978651,1
6200,2302,28,308,2289,38,169,11334,2503,13837,0.00160673,-0.215646,-0.97647,1
3972,1620,20,200,1472,26,111,7421,1674,9095,0.00133755,-0.222062,-0.975032,1
3916,2148,20,213,1610,35,144,8086,1342,9428,0.00654114,-0.20546,-0.978644,1
5246,2219,31,484,2163,45,170,10358,1520,11878,0.0136451,-0.195103,-0.980688,1
5290,2267,25,294,2181,32,164,10253,1311,11564,0.00553511,-0.149715,-0.988714,1
5811,2702,28,449,3361,49,204,12604,1682,14286,0.0020345,-0.154627,-0.987971,1
6681,2924,22,284,1998,33,148,12090,1048,13138,-0.000161203,-0.165362,-0.986233,1
3538,1719,16,234,1741,26,120,7394,749,8143,-0.0110955,-0.100348,-0.99489,1
3924,2210,20,292,2153,44,160,8803,901,9704,-0.0165234,-0.111728,-0.993601,1
6298,3451,30,436,3437,51,252,13955,1390,15345,-0.00682243,-0.175609,-0.984436,1
6265,3590,29,440,2869,35,174,13402,951,14353,-0.00674605,-0.132284,-0.991189,1
3169,1795,16,242,1828,27,133,7210,729,7939,2.81403e-05,-0.147254,-0.989099,1
6205,3553,29,436,3187,35,175,13620,961,14581,-0.00360014,-0.147367,-0.989076,1
6196,3439,38,431,3555,53,248,13960,1104,15064,0.00434161,-0.159441,-0.987198,1
3083,1543,13,183,1518,21,107,6468,659,7127,-0.002655,-0.105095,-0.994459,1
1868,1127,9,136,1107,13,78,4338,474,4812,0.0118069,-0.17044,-0.985297,1
5108,3207,28,364,3105,42,208,12062,1309,13371,0.0353134,-0.207918,-0.977509,1
6090,3915,36,456,3704,28,177,14406,1566,15972,-0.0157496,-0.199982,-0.979673,1
4300,2900,21,357,2821,38,195,10632,1406,12038,-0.000608918,-0.20773,-0.978186,2
3208,2236,16,264,2195,35,149,8103,986,9089,0.0123291,-0.225471,-0.974172,2
6224,4381,40,510,4325,69,294,15843,1707,17550,0.0383217,-0.24368,-0.969099,2
4260,3075,20,364,2991,31,201,10942,1260,12202,0.0166002,-0.206665,-0.978271,2
5836,3996,28,452,3960,106,260,14638,1278,15916,0.0126993,-0.186254,-0.98242,2
4126,2735,19,321,2616,54,176,10047,1125,11172,0.0360257,-0.132312,-0.990553,2
6367,5414,36,727,3833,55,187,16619,1048,17667,-0.0161037,-0.178418,-0.983823,2
2868,1558,12,182,1533,20,88,6261,499,6760,-0.0129312,-0.132624,-0.991082,2
2182,1181,10,141,1047,20,69,4650,439,5089,-0.00497795,-0.0504476,-0.998714,2
2725,1449,13,201,1434,25,99,5946,624,6570,0.00142957,-0.0457096,-0.998954,2
6221,3173,29,400,3101,87,257,13268,1475,14743,0.0219812,-0.0713966,-0.997206,2
4826,2143,26,270,2041,60,142,9508,984,10492,0.0238798,-0.0479853,-0.998563,2
6252,3034,28,381,2937,68,204,12904,2010,14914,0.0388272,-0.0514661,-0.99792,2
5684,2033,22,246,1980,52,107,10124,942,11066,0.0149524,0.00243518,-0.999885,2
6084,3324,32,369,2883,56,225,12973,1957,14930,0.0363291,-0.0750302,-0.996519,2
3117,1542,13,188,1228,17,87,6192,837,7029,0.0284022,-0.0352304,-0.998976,2
2121,1071,12,132,1033,17,74,4460,678,5138,0.0307358,-0.0294533,-0.999094,2
5791,2841,32,361,2868,49,206,12148,1589,13737,0.020059,-0.0739211,-0.997062,2
6155,2820,22,246,1836,34,151,11264,1436,12700,0.0237155,-0.0885092,-0.995793,2
3088,1275,17,165,1260,26,96,5927,905,6832,0.0103929,-0.0780884,-0.996892,2
5956,2221,30,294,2129,47,161,10838,1772,12610,0.0152717,-0.0819712,-0.996518,2
6015,2193,52,324,2379,51,164,11178,2016,13194,0.0431803,-0.105242,-0.993509,2
3997,1709,21,206,1531,30,112,7606,1254,8860,0.0410637,-0.0774965,-0.996147,2
6400,2638,26,333,2527,44,205,12173,3845,16018,0.0514442,-0.186356,-0.981135,2
4035,1777,14,195,1836,23,119,7999,1229,9228,0.0582002,-0.18852,-0.980343,2
2120,1229,11,152,1361,21,113,5007,885,5892,0.0533438,-0.141216,-0.988541,2
2080,1289,10,159,1258,15,91,4902,749,5651,0.0540919,-0.126265,-0.990521,2
5063,3327,22,408,3255,37,229,12341,1221,13562,0.0490772,-0.156522,-0.986454,2
7174,4307,27,525,3520,44,208,15805,1018,16823,0.049892,-0.220305,-0.974154,2
3055,2371,15,283,2324,29,160,8237,768,9005,0.0566214,-0.208204,-0.976445,2
5945,4554,27,605,4059,44,215,15449,1054,16503,0.0478138,-0.247355,-0.967744,2
4087,3194,18,409,3736,45,230,11719,1029,12748,0.0329972,-0.265257,-0.963613,2
5285,4251,23,515,4216,41,290,14621,1317,15938,0.0257529,-0.306701,-0.951457,2
5862,4508,27,556,4634,40,321,15948,1174,17122,0.0333257,-0.307832,-0.950857,2
3986,3124,19,360,3037,26,206,10758,1029,11787,0.0297746,-0.265469,-0.96366,2
6057,4338,29,506,4346,41,300,15617,1088,16705,0.0220204,-0.278144,-0.960287,2
4190,3210,21,369,3220,36,216,11262,1088,12350,0.0221557,-0.244784,-0.969324,2
6014,4229,33,500,4161,56,265,15258,1105,16363,0.0281845,-0.274334,-0.961221,2
4209,2641,21,320,2638,42,183,10054,1083,11137,0.0216734,-0.228957,-0.973195,2
5971,3571,32,429,3496,78,248,13825,1382,15207,0.0371257,-0.249676,-0.967618,2
4069,2332,22,277,2322,45,157,9224,1057,10281,0.0299463,-0.216751,-0.975767,2
5850,3532,30,426,3516,67,239,13660,1618,15278,0.0441045,-0.257408,-0.965296,2
3930,2518,20,311,2525,34,175,9513,1057,10570,0.0342676,-0.224621,-0.973843,2
5694,4138,30,477,3987,62,290,14678,1634,16312,0.0341447,-0.201147,-0.978966,2
3824,2901,19,360,2838,34,191,10167,1070,11237,0.0342454,-0.172391,-0.984433,2
5690,4083,28,476,4082,44,292,14695,1366,16061,0.0549009,-0.220695,-0.973796,2
3937,2686,19,318,2693,30,186,9869,968,10837,0.0651532,-0.215142,-0.974407,2
5851,3700,47,469,3611,41,251,13970,1505,15475,0.064598,-0.197944,-0.978083,2
5816,3521,32,462,2607,32,163,12633,1041,13674,0.0468448,-0.167389,-0.984777,2
3013,1694,14,202,1689,20,114,6746,982,7728,0.0323579,-0.150112,-0.988139,2
5814,3105,33,374,3029,42,215,12612,2093,14705,0.0405514,-0.157197,-0.986734,2
5668,2976,27,384,2962,38,209,12264,1785,14049,0.0346927,-0.140873,-0.98942,2
3850,1986,40,258,1923,28,141,8226,1095,9321,0.0327764,-0.123297,-0.991828,2
5701,2758,28,357,2726,47,212,11829,1486,13315,0.0436914,-0.115219,-0.992379,2
5669,2585,28,349,2575,57,200,11463,1465,12928,0.078481,-0.121018,-0.989543,2
5795,2718,29,343,2614,37,229,11765,1491,13256,0.0585891,-0.114208,-0.991728,2
5911,2943,30,386,2859,37,212,12378,1474,13852,0.070711,-0.117163,-0.990592,2
6025,3101,28,397,2216,30,159,11956,974,12930,0.0478488,-0.0908123,-0.994718,2
3781,2099,18,265,2086,25,152,8426,937,9363,0.039538,-0.0948637,-0.994705,2
5977,3485,29,430,3331,43,242,13537,1426,14963,0.03336,-0.0976376,-0.994663,2
6095,3577,29,432,3317,28,167,13645,1003,14648,0.0163562,-0.093702,-0.995466,2
4142,2462,21,297,2413,27,175,9537,1072,10609,0.0351261,-0.0949647,-0.994861,2
6006,3644,30,438,3569,38,267,13992,1268,15260,0.0582597,-0.0991733,-0.993363,2
5351,3364,25,400,3342,51,231,12764,1298,14062,0.0309544,-0.103887,-0.994107,2
5645,3443,25,416,3416,51,236,13232,1278,14510,0.0408307,-0.11479,-0.99255,2
3819,2605,22,309,2565,37,172,9529,986,10515,0.0565841,-0.128439,-0.990102,2
4924,3294,25,390,3197,52,224,12106,1177,13283,0.0443839,-0.109255,-0.993022,2
6268,4115,29,481,4077,44,272,15286,1470,16756,0.08186,-0.187216,-0.978902,2
4578,2524,16,258,2185,21,149,9731,949,10680,0.0615584,-0.147827,-0.987095,2
2386,1505,9,176,1486,15,102,5679,598,6277,0.0350547,-0.0809151,-0.996104,2
1850,1299,9,150,1323,23,88,4742,574,5316,0.0325169,-0.102774,-0.994173,2
4761,3362,21,380,3381,58,222,12185,1373,13558,0.037818,-0.0986489,-0.994403,2
6443,4357,26,501,4110,49,199,15685,1360,17045,0.0248735,-0.11854,-0.992638,2
4400,2882,19,331,2851,47,234,10764,1216,11980,0.00917216,-0.0715592,-0.997394,2
6363,3847,27,462,3862,51,262,14874,1638,16512,0.00114502,-0.106026,-0.994363,2
6237,3670,29,424,3513,54,241,14168,1888,16056,0.0243702,-0.222169,-0.974704,2
4210,1913,15,210,1793,32,121,8294,919,9213,0.0241879,-0.202393,-0.979006,2
2237,1137,11,155,1120,20,81,4761,729,5490,0.0203847,-0.0764241,-0.996867,2
2036,1057,12,130,1054,25,74,4388,1037,5425,0.0211526,-0.0236462,-0.999497,2
5887,3094,32,371,2975,56,213,12628,1855,14483,0.0127775,-0.0677525,-0.997621,2
5924,3043,33,378,2966,71,214,12629,1861,14490,0.0171972,-0.120263,-0.992593,2
5199,2525,28,315,2451,70,178,10766,2311,13077,0.00950854,-0.055316,-0.998424,2
5202,2351,27,297,2239,51,166,10333,1983,12316,0.00706749,-0.0933838,-0.995605,2
5947,2321,33,306,2641,58,175,11481,1929,13410,0.0076202,-0.0760851,-0.997072,2
4197,1632,26,213,1576,37,112,7793,2686,10479,0.0184463,-0.0974058,-0.995074,2
4129,1576,21,195,1446,35,107,7509,2367,9876,0.0359845,-0.0829691,-0.995902,2
5159,1934,25,251,1886,47,140,9442,4367,13809,0.0496899,-0.0925646,-0.994466,2
4853,1971,26,248,1889,43,141,9171,4396,13567,0.0633897,-0.105736,-0.992372,2
4830,2181,27,290,2126,51,177,9682,8653,18335,0.0812427,-0.163544,-0.983185,2
2296,1064,11,137,1041,14,78,4641,3692,8333,0.116689,-0.128419,-0.984831,2
5901,3191,27,387,2954,50,255,12765,7660,20425,0.121498,-0.0176851,-0.992434,2
4019,2528,19,306,2646,27,179,9724,2934,12658,0.0703065,-0.213892,-0.974324,2
3069,2532,14,268,2276,20,155,8334,1156,9490,0.0643579,-0.211122,-0.975339,2
3936,3036,32,355,2930,28,209,10526,914,11440,0.0672201,-0.194961,-0.978505,2
4785,3963,46,571,4033,40,270,13708,1252,14960,0.0612448,-0.210151,-0.975749,2
3535,3041,16,344,2895,26,198,10055,1221,11276,0.0609596,-0.168743,-0.983773,2
5854,4754,47,586,3670,31,242,15184,1146,16330,0.0441621,-0.209197,-0.976876,2
2991,2817,14,298,2573,25,174,8892,859,9751,0.0333586,-0.190043,-0.981209,2
3746,3182,17,359,3101,28,205,10638,1077,11715,0.0320713,-0.227006,-0.973365,2
5895,4869,28,588,4343,25,222,15970,1081,17051,0.0216193,-0.237606,-0.971121,2
4239,3478,19,438,3740,30,251,12195,1079,13274,0.0125467,-0.236698,-0.971502,2
6219,5129,44,603,5071,56,347,17469,1546,19015,0.0346664,-0.300106,-0.953276,2
3276,2514,13,256,2235,26,143,8463,666,9129,0.0372021,-0.208368,-0.977343,2
1974,1572,10,180,1556,16,108,5416,501,5917,0.0334175,-0.180052,-0.983089,2
3921,3156,21,367,3132,53,211,10861,980,11841,0.0277418,-0.178821,-0.98349,2
5803,4252,30,500,4199,55,280,15119,1376,16495,0.0291296,-0.160675,-0.986577,2
5517,4053,29,486,4033,65,274,14457,1280,15737,0.016954,-0.144106,-0.989417,2
3905,2874,22,351,2806,51,190,10199,1035,11234,0.0137582,-0.116256,-0.993124,2
5911,4319,34,503,3969,64,258,15058,1218,16276,0.0070683,-0.107899,-0.994137,2
6066,3979,30,462,3967,56,261,14821,1536,16357,0.00307925,-0.102788,-0.994699,2
5763,3719,43,426,3103,46,186,13286,1106,14392,0.0043132,-0.0816265,-0.996654,2
3014,1896,17,223,1917,36,134,7237,789,8026,0.00678009,-0.0695347,-0.997557,2
5957,3707,31,426,3485,44,234,13884,1732,15616,0.00764374,-0.064056,-0.997916,2
5824,3686,27,380,2829,29,164,12939,1122,14061,0.00758698,-0.067848,-0.997667,2
5967,3713,34,428,3595,47,241,14025,1582,15607,-0.0101403,-0.0557581,-0.998393,2
3783,1934,15,212,1717,29,117,7807,803,8610,-0.00812644,-0.0407871,-0.999135,2
2366,1409,12,168,1419,18,96,5488,620,6108,0.00200884,-0.0432276,-0.999063,2
5993,3968,33,431,3480,46,239,14190,1437,15627,0.00360944,-0.0239232,-0.999707,2
5773,3555,33,406,2901,31,163,12862,1034,13896,0.00271137,-0.0176062,-0.999841,2
3031,1926,17,236,2059,32,143,7444,895,8339,0.00559558,-0.0277702,-0.999599,2
5740,3419,28,378,3483,42,220,13310,1537,14847,0.00475992,-0.0245894,-0.999686,2
5920,3653,36,438,3696,62,351,14156,1836,15992,0.00486714,-0.0201963,-0.999784,2
6241,3661,21,304,2551,38,175,12991,1035,14026,-0.00155154,-0.0201028,-0.999797,2
2456,1593,12,188,1306,15,87,5657,525,6182,0.00862601,-0.0349398,-0.999352,2
2126,1300,11,152,1372,17,87,5065,535,5600,-0.00211254,-0.0288935,-0.99958,2
5374,3631,29,398,3302,42,226,13002,1352,14354,-0.0011975,-0.046127,-0.998935,2
5554,3352,27,400,3308,42,227,12910,1606,14516,-0.00304772,-0.0421469,-0.999107,2
4268,2421,20,284,2441,28,160,9622,1075,10697,-0.00173809,-0.0496862,-0.998763,2
4725,2985,24,370,2989,36,201,11330,1177,12507,-0.00258432,-0.0487577,-0.998807,2
5123,2840,26,333,2696,42,210,11270,1179,12449,-0.00260186,-0.0416307,-0.99913,2
4444,2748,22,349,2777,33,183,10556,1164,11720,-3.53381e-05,-0.025833,-0.999667,2
6048,3682,30,394,3372,40,229,13795,1429,15224,-0.00362014,-0.0135111,-0.999902,2
5896,3713,30,437,3560,39,257,13932,1515,15447,-0.0127503,-0.00586965,-0.999902,2
3787,1965,16,231,1879,18,107,8003,629,8632,-0.00657133,-0.0235751,-0.9997,2
2501,1570,13,187,1595,20,108,5994,652,6646,-0.00286852,-0.0243849,-0.999699,2
5765,3545,27,419,3741,44,254,13795,1554,15349,-0.0029363,-0.0137271,-0.999901,2
6293,3920,31,476,2830,32,177,13759,1098,14857,-0.00584597,-0.0144751,-0.999878,2
3132,2249,22,302,2005,25,136,7871,859,8730,-0.00962301,-0.0173981,-0.999802,2
5973,3737,33,444,3727,45,251,14210,1611,15821,-0.00698964,-0.0300457,-0.999524,2
5859,3779,31,443,3667,41,227,14047,1476,15523,-0.00872578,-0.0283222,-0.999561,2
4172,2629,20,309,2589,32,176,9927,1083,11010,-0.00474524,-0.0269333,-0.999626,2
5995,3875,28,401,3369,43,229,13940,1453,15393,-0.00151725,-0.0350946,-0.999383,2
3830,2371,19,278,2333,31,161,9023,1082,10105,-0.00083534,-0.033147,-0.99945,2
5895,3702,29,430,3638,48,255,13997,1666,15663,0.00249032,-0.0347057,-0.999395,2
6086,2536,21,301,2441,23,131,11539,832,12371,0.00356979,-0.0338697,-0.99942,2
4802,2979,23,352,2923,37,202,11318,1345,12663,0.00286047,-0.0335685,-0.999432,2
6031,3697,29,432,3601,46,247,14083,1593,15676,0.00248189,-0.041947,-0.999117,2
5846,3649,30,434,3448,33,179,13619,1091,14710,0.00280102,-0.0421288,-0.999108,2
4169,2530,22,297,2477,30,165,9690,1091,10781,0.00448131,-0.0363417,-0.999329,2
6034,3592,31,457,3570,49,286,14019,1609,15628,0.00902107,-0.0388973,-0.999202,2
6079,3577,29,496,2758,31,169,13139,1149,14288,0.00892246,-0.0362645,-0.999302,2
2522,1540,13,183,1506,20,102,5886,659,6545,0.00990958,-0.0383989,-0.999213,2
5940,3535,29,450,3552,45,268,13819,1831,15650,0.00658924,-0.0302966,-0.999519,2
3083,1813,14,179,1504,19,104,6716,702,7418,0.00703518,-0.0348138,-0.999369,2
6036,3608,28,429,3555,47,245,13948,1569,15517,0.00494844,-0.0426512,-0.999078,2
4041,1897,15,223,1932,20,105,8233,666,8899,0.00266134,-0.0414479,-0.999137,2
2088,1259,11,150,1259,17,87,4871,546,5417,-0.000922429,-0.0289282,-0.999581,2
5834,3513,31,423,3530,49,279,13659,1610,15269,0.00652036,-0.0425213,-0.999074,2
5964,3540,31,428,3471,31,167,13632,1101,14733,0.00207477,-0.0312571,-0.999509,2
6003,3509,30,423,3437,45,238,13685,1587,15272,0.00187867,-0.0418059,-0.999124,2
5904,3624,38,672,3283,48,206,13775,1099,14874,0.00851983,-0.0371374,-0.999274,2
