Downsample[ns],BuildFilTree[ns],SearchFil[ns],DeleteFil[ns],BuildTreeSub[ns],SearchSub[ns],DeleteSub[ns],PreProcTotal[ns],Plane[ns],Total[ns],nx,ny,nz,planeCount
0,0,0,0,0,5951,1102,7053,14613,21666,-0.107649,0.0641259,-0.992119,0
0,0,0,0,0,2649,430,3079,14497,17576,-0.0560688,0.0339585,-0.997849,0
0,0,0,0,0,6043,1081,7124,8358,15482,-0.0473716,0.0266625,-0.998522,0
0,0,0,0,0,2620,432,3052,3022,6074,-0.0448822,0.0190508,-0.998811,0
0,0,0,0,0,6018,982,7000,7397,14397,-0.043193,0.00999387,-0.999017,0
0,0,0,0,0,6340,888,7228,6339,13567,-0.040872,0.000226227,-0.999164,0
0,0,0,0,0,3138,526,3664,5060,8724,-0.0385247,-0.00648856,-0.999237,0
0,0,0,0,0,3122,526,3648,6255,9903,-0.0378058,-0.00641124,-0.999265,0
0,0,0,0,0,4920,812,5732,9271,15003,-0.0372694,-0.00872228,-0.999267,0
0,0,0,0,0,6053,1038,7091,9779,16870,-0.0372729,-0.0100917,-0.999254,0
0,0,0,0,0,3084,515,3599,6632,10231,-0.0367136,-0.00857078,-0.999289,0
0,0,0,0,0,5475,831,6306,9740,16046,-0.0373703,-0.00672443,-0.999279,0
0,0,0,0,0,4784,829,5613,9063,14676,-0.0366696,-0.00747373,-0.9993,0
0,0,0,0,0,3354,615,3969,6597,10566,-0.0365258,-0.00878335,-0.999294,0
0,0,0,0,0,5924,992,6916,11270,18186,-0.0359034,-0.00963563,-0.999309,0
0,0,0,0,0,4035,675,4710,7827,12537,-0.036012,-0.00902721,-0.999311,0
0,0,0,0,0,5964,1006,6970,11309,18279,-0.0357949,-0.00973974,-0.999312,0
0,0,0,0,0,3764,627,4391,7705,12096,-0.0358023,-0.010207,-0.999307,0
0,0,0,0,0,6339,1008,7347,11840,19187,-0.0360666,-0.00933058,-0.999306,0
0,0,0,0,0,3117,478,3595,4903,8498,-0.0356811,-0.0097083,-0.999316,0
0,0,0,0,0,1797,265,2062,3302,5364,-0.0354326,-0.0109969,-0.999312,0
0,0,0,0,0,5671,891,6562,10644,17206,-0.0353024,-0.0102578,-0.999324,0
0,0,0,0,0,3835,631,4466,7666,12132,-0.0360053,-0.00773881,-0.999322,0
0,0,0,0,0,4826,919,5745,9147,14892,-0.0356819,-0.00836101,-0.999328,0
0,0,0,0,0,4802,836,5638,7209,12847,-0.0357546,-0.00809389,-0.999328,0
0,0,0,0,0,6001,1039,7040,10733,17773,-0.0362253,-0.00870143,-0.999306,0
0,0,0,0,0,3036,448,3484,4752,8236,-0.0362352,-0.00819132,-0.99931,0
0,0,0,0,0,1851,317,2168,3102,5270,-0.0370181,-0.00771637,-0.999285,0
0,0,0,0,0,1952,328,2280,3644,5924,-0.0378506,-0.00821262,-0.99925,0
0,0,0,0,0,5617,920,6537,10413,16950,-0.0379237,-0.00792203,-0.99925,0
0,0,0,0,0,5403,940,6343,7656,13999,-0.0377977,-0.00915503,-0.999244,0
0,0,0,0,0,5876,1030,6906,9175,16081,-0.0379388,-0.00874984,-0.999242,0
0,0,0,0,0,3101,537,3638,6028,9666,-0.0379823,-0.00756116,-0.99925,0
0,0,0,0,0,4906,824,5730,8897,14627,-0.0389771,-0.00654881,-0.999219,0
0,0,0,0,0,5880,967,6847,9880,16727,-0.0383863,-0.00785009,-0.999232,0
0,0,0,0,0,4913,846,5759,9154,14913,-0.0379522,-0.00758848,-0.999251,0
0,0,0,0,0,5947,974,6921,10430,17351,-0.0374891,-0.00852751,-0.999261,0
0,0,0,0,0,3398,544,3942,5058,9000,-0.0370472,-0.00920966,-0.999271,0
0,0,0,0,0,1817,315,2132,3344,5476,-0.0372051,-0.0097837,-0.99926,0
0,0,0,0,0,5906,1021,6927,11480,18407,-0.0374243,-0.00980539,-0.999251,0
0,0,0,0,0,3068,425,3493,4696,8189,-0.0371867,-0.00918946,-0.999266,0
0,0,0,0,0,1814,307,2121,3525,5646,-0.037348,-0.00883096,-0.999263,0
0,0,0,0,0,3113,518,3631,6122,9753,-0.0368735,-0.00989445,-0.999271,0
0,0,0,0,0,5926,1018,6944,11529,18473,-0.0372445,-0.00799492,-0.999274,0
0,0,0,0,0,4227,747,4974,7055,12029,-0.0373916,-0.0104984,-0.999246,0
0,0,0,0,0,3145,560,3705,6196,9901,-0.0371861,-0.0107979,-0.99925,0
0,0,0,0,0,5876,1005,6881,11640,18521,-0.0370629,-0.0108834,-0.999254,0
0,0,0,0,0,3186,529,3715,6576,10291,-0.0365471,-0.0107045,-0.999275,0
0,0,0,0,0,5935,979,6914,11036,17950,-0.0362769,-0.0116959,-0.999273,0
0,0,0,0,0,3142,518,3660,6659,10319,-0.036585,-0.0116431,-0.999263,0
0,0,0,0,0,4806,870,5676,10917,16593,-0.0374141,-0.0099735,-0.99925,0
0,0,0,0,0,4903,801,5704,8814,14518,-0.0381714,-0.00855116,-0.999235,0
0,0,0,0,0,2871,488,3359,5529,8888,-0.0374869,-0.0100588,-0.999247,0
0,0,0,0,0,6017,1014,7031,10403,17434,-0.0379807,-0.00920802,-0.999236,0
0,0,0,0,0,3180,548,3728,6101,9829,-0.0368555,-0.0104072,-0.999266,0
0,0,0,0,0,4857,870,5727,9640,15367,-0.0367904,-0.0113094,-0.999259,0
0,0,0,0,0,4953,799,5752,9033,14785,-0.0365015,-0.0102144,-0.999281,0
0,0,0,0,0,2778,481,3259,5411,8670,-0.0366286,-0.0104817,-0.999274,0
0,0,0,0,0,5993,1001,6994,10991,17985,-0.0365259,-0.0107994,-0.999274,0
0,0,0,0,0,4148,699,4847,7529,12376,-0.0376325,-0.00982735,-0.999244,0
0,0,0,0,0,3907,637,4544,7761,12305,-0.0379217,-0.00899418,-0.99924,0
0,0,0,0,0,3882,645,4527,6927,11454,-0.0374378,-0.00984492,-0.999251,0
0,0,0,0,0,3558,593,4151,6733,10884,-0.0371695,-0.00964737,-0.999262,0
0,0,0,0,0,5449,941,6390,9306,15696,-0.0370674,-0.00981174,-0.999264,0
0,0,0,0,0,2435,405,2840,4916,7756,-0.0368688,-0.00910777,-0.999279,0
0,0,0,0,0,4102,742,4844,7395,12239,-0.0373978,-0.00850838,-0.999264,0
0,0,0,0,0,5997,1005,7002,10505,17507,-0.0369352,-0.011086,-0.999256,0
0,0,0,0,0,3110,527,3637,6163,9800,-0.0365839,-0.0110682,-0.999269,0
0,0,0,0,0,4952,870,5822,9344,15166,-0.0369726,-0.0107287,-0.999259,0
0,0,0,0,0,4458,748,5206,8425,13631,-0.0371682,-0.0105064,-0.999254,0
0,0,0,0,0,4436,779,5215,8630,13845,-0.0370128,-0.0112326,-0.999252,0
0,0,0,0,0,4196,589,4785,5802,10587,-0.0375643,-0.00999053,-0.999244,0
0,0,0,0,0,2938,516,3454,5782,9236,-0.0383644,-0.00852383,-0.999228,0
0,0,0,0,0,6040,920,6960,9481,16441,-0.0375028,-0.0110158,-0.999236,0
0,0,0,0,0,3053,506,3559,5987,9546,-0.0376736,-0.0108132,-0.999232,0
0,0,0,0,0,3359,570,3929,6680,10609,-0.037522,-0.00925036,-0.999253,0
0,0,0,0,0,4777,733,5510,7468,12978,-0.0373759,-0.0113691,-0.999237,0
0,0,0,0,0,4160,710,4870,8051,12921,-0.0376645,-0.0110613,-0.999229,0
0,0,0,0,0,3802,637,4439,7866,12305,-0.0381366,-0.00904255,-0.999232,0
0,0,0,0,0,6295,1296,7591,9667,17258,-0.0380801,-0.0102146,-0.999222,0
0,0,0,0,0,3219,551,3770,5843,9613,-0.0377361,-0.0121095,-0.999214,0
0,0,0,0,0,4656,666,5322,7586,12908,-0.0379214,-0.0114246,-0.999216,0
0,0,0,0,0,3834,690,4524,7440,11964,-0.0371803,-0.0127645,-0.999227,0
0,0,0,0,0,5265,831,6096,9807,15903,-0.0373265,-0.0117374,-0.999235,0
0,0,0,0,0,3569,615,4184,7194,11378,-0.0374464,-0.0117354,-0.99923,0
0,0,0,0,0,4497,762,5259,8892,14151,-0.0384524,-0.0114076,-0.999195,0
0,0,0,0,0,4927,822,5749,8193,13942,-0.0387731,-0.0112071,-0.999185,0
0,0,0,0,0,3324,571,3895,6494,10389,-0.0387626,-0.0109099,-0.999189,0
0,0,0,0,0,6041,1033,7074,10827,17901,-0.0378528,-0.0124401,-0.999206,0
0,0,0,0,0,3833,654,4487,7484,11971,-0.0378993,-0.0122318,-0.999207,0
0,0,0,0,0,6152,1001,7153,11291,18444,-0.0383577,-0.0113799,-0.9992,0
0,0,0,0,0,2980,512,3492,5748,9240,-0.0373642,-0.012934,-0.999218,0
0,0,0,0,0,3407,570,3977,6890,10867,-0.0376512,-0.0121325,-0.999217,0
0,0,0,0,0,6120,1014,7134,13018,20152,-0.038023,-0.0112311,-0.999214,0
0,0,0,0,0,3132,504,3636,4757,8393,-0.0384883,-0.0108892,-0.9992,0
0,0,0,0,0,1880,306,2186,3373,5559,-0.0372483,-0.0128347,-0.999224,0
0,0,0,0,0,5868,928,6796,11068,17864,-0.0374956,-0.0111367,-0.999235,0
0,0,0,0,0,3908,710,4618,6791,11409,-0.0379679,-0.0103641,-0.999225,0
0,0,0,0,0,3220,637,3857,5596,9453,-0.038297,-0.0106467,-0.99921,0
0,0,0,0,0,5694,910,6604,10090,16694,-0.0384876,-0.00973309,-0.999212,0
0,0,0,0,0,6072,1002,7074,10097,17171,-0.0384258,-0.0109102,-0.999202,0
0,0,0,0,0,4233,693,4926,7684,12610,-0.0385169,-0.011509,-0.999192,0
0,0,0,0,0,4128,646,4774,7337,12111,-0.0389895,-0.00860903,-0.999203,0
0,0,0,0,0,5603,1028,6631,10322,16953,-0.0372387,-0.0124574,-0.999229,0
0,0,0,0,0,4014,729,4743,7482,12225,-0.0382941,-0.012792,-0.999185,0
0,0,0,0,0,5567,925,6492,9439,15931,-0.0396835,-0.0119408,-0.999141,0
0,0,0,0,0,3761,604,4365,7623,11988,-0.0399326,-0.00529939,-0.999188,0
0,0,0,0,0,6271,1012,7283,10434,17717,-0.0383635,-0.000169537,-0.999264,0
0,0,0,0,0,3326,543,3869,6041,9910,-0.0387773,0.0129142,-0.999165,0
0,0,0,0,0,5703,940,6643,10043,16686,-0.0339542,0.0391959,-0.998654,0
0,0,0,0,0,4112,678,4790,8192,12982,-0.0294012,0.0648226,-0.997464,0
0,0,0,0,0,6465,1067,7532,12160,19692,-0.026007,0.106971,-0.993922,0
0,0,0,0,0,2879,460,3339,9604,12943,-0.0267388,0.122258,-0.992138,0
0,0,0,0,0,5132,815,5947,18964,24911,-0.0263272,0.155436,-0.987495,0
0,0,0,0,0,3068,496,3564,12352,15916,-0.0225032,0.170365,-0.985124,0
0,0,0,0,0,2854,478,3332,14716,18048,-0.0192724,0.208246,-0.977887,0
0,0,0,0,0,3294,498,3792,14835,18627,-0.0075282,0.236335,-0.971643,0
0,0,0,0,0,2789,398,3187,14242,17429,0.00266066,0.268133,-0.963378,0
0,0,0,0,0,2730,452,3182,18245,21427,0.00747858,0.301301,-0.9535,0
0,0,0,0,0,2421,399,2820,18262,21082,0.0104707,0.343944,-0.938932,0
0,0,0,0,0,1828,298,2126,16992,19118,0.0032772,0.376084,-0.92658,0
0,0,0,0,0,1633,281,1914,17049,18963,-0.0050395,0.411975,-0.911181,0
0,0,0,0,0,1722,273,1995,18328,20323,-0.0215171,0.435457,-0.899953,0
0,0,0,0,0,1733,284,2017,21676,23693,-0.0281146,0.451261,-0.891949,0
0,0,0,0,0,1576,266,1842,22961,24803,-0.0191839,0.442791,-0.89642,0
0,0,0,0,0,1520,357,1877,27220,29097,-0.00657386,0.441954,-0.897013,0
0,0,0,0,0,1491,279,1770,30634,32404,-0.00261961,0.43302,-0.901381,0
0,0,0,0,0,1476,349,1825,33523,35348,0.00622559,0.434114,-0.900836,0
0,0,0,0,0,1439,265,1704,34927,36631,-0.00218371,0.419531,-0.907739,0
0,0,0,0,0,1426,329,1755,31687,33442,-0.00446906,0.432753,-0.901501,0
0,0,0,0,0,1445,298,1743,36214,37957,0.000523383,0.365428,-0.930839,0
0,0,0,0,0,1381,263,1644,33451,35095,-0.00298578,0.369149,-0.929366,0
0,0,0,0,0,1369,290,1659,32488,34147,-0.00527801,0.376515,-0.926396,0
0,0,0,0,0,1354,287,1641,35626,37267,0.000126255,0.332494,-0.943105,0
0,0,0,0,0,1354,254,1608,35146,36754,0.00992348,0.310674,-0.950465,0
0,0,0,0,0,1353,246,1599,35268,36867,0.0201093,0.317758,-0.947959,0
0,0,0,0,0,1397,253,1650,35251,36901,0.0284164,0.307428,-0.951147,0
0,0,0,0,0,1367,269,1636,34808,36444,0.043082,0.300381,-0.952846,0
0,0,0,0,0,3657,658,4315,43223,47538,0.0425209,0.293893,-0.954892,0
0,0,0,0,0,1349,342,1691,35925,37616,0.0293068,0.257322,-0.965881,0
0,0,0,0,0,1353,243,1596,34826,36422,0.0157955,0.274268,-0.961524,0
0,0,0,0,0,1504,277,1781,35078,36859,-0.019969,0.272896,-0.961836,0
0,0,0,0,0,1394,387,1781,33272,35053,-0.0363817,0.291498,-0.955879,0
0,0,0,0,0,1365,243,1608,32154,33762,-0.0343758,0.314722,-0.948561,0
0,0,0,0,0,1542,318,1860,32222,34082,-0.00136385,0.304524,-0.952504,0
0,0,0,0,0,1416,314,1730,31329,33059,0.0228446,0.277178,-0.960547,0
0,0,0,0,0,1631,250,1881,30256,32137,0.0313709,0.276994,-0.960359,0
0,0,0,0,0,1359,279,1638,27568,29206,0.0199406,0.27899,-0.960087,0
0,0,0,0,0,1415,335,1750,18007,19757,0.0249513,0.284567,-0.958332,0
0,0,0,0,0,1413,262,1675,8234,9909,0.050719,0.369051,-0.928025,0
0,0,0,0,0,2342,436,2778,9792,12570,0.110796,0.456421,-0.882839,0
0,0,0,0,0,5669,1043,6712,11684,18396,0.124088,0.54545,-0.828907,0
0,0,0,0,0,5513,1036,6549,24236,30785,0.10401,0.677373,-0.72825,0
0,0,0,0,0,2373,376,2749,11073,13822,0.0896901,0.684504,-0.723471,0
0,0,0,0,0,1408,271,1679,9856,11535,0.0773244,0.675976,-0.732856,0
0,0,0,0,0,1333,260,1593,11546,13139,0.0648445,0.690165,-0.720741,0
0,0,0,0,0,6278,1205,7483,-1000,-1000,-1,-1,-1,0
0,0,0,0,0,1934,372,2306,8815,11121,-0.00321104,0.214377,-0.976746,0
0,0,0,0,0,2196,437,2633,20287,22920,-0.00238681,0.224189,-0.974543,0
0,0,0,0,0,1673,331,2004,6492,8496,-0.000151906,0.193136,-0.981172,0
0,0,0,0,0,1591,303,1894,10590,12484,-0.00749613,0.211471,-0.977356,0
0,0,0,0,0,2605,479,3084,2367,5451,-0.0147974,0.18637,-0.982368,0
0,0,0,0,0,7051,1306,8357,28436,36793,-0.041162,0.327257,-0.944039,0
0,0,0,0,0,2121,396,2517,11845,14362,-0.0423938,0.292538,-0.955314,0
0,0,0,0,0,1469,354,1823,8333,10156,-0.0379487,0.256157,-0.96589,0
0,0,0,0,0,1457,273,1730,21144,22874,-0.0442097,0.247693,-0.967829,0
0,0,0,0,0,1461,279,1740,28663,30403,-0.0356186,0.23029,-0.97247,0
0,0,0,0,0,1579,294,1873,30341,32214,-0.0303221,0.249367,-0.967934,0
0,0,0,0,0,1429,266,1695,19023,20718,-0.0180444,0.311351,-0.950124,0
0,0,0,0,0,1616,304,1920,12453,14373,-0.00686561,0.326376,-0.945215,0
0,0,0,0,0,2042,388,2430,34417,36847,0.00477555,0.310745,-0.950482,0
0,0,0,0,0,1333,336,1669,27722,29391,-0.00396057,0.279159,-0.960237,0
0,0,0,0,0,1316,282,1598,30147,31745,-0.0228593,0.263809,-0.964304,0
0,0,0,0,0,1296,282,1578,31719,33297,-0.0405134,0.283351,-0.95816,0
0,0,0,0,0,1271,283,1554,36097,37651,-0.034155,0.25553,-0.966198,0
0,0,0,0,0,1310,286,1596,34977,36573,-0.0213308,0.293657,-0.955673,0
0,0,0,0,0,1279,310,1589,29438,31027,-0.00790535,0.354528,-0.935012,0
0,0,0,0,0,1234,239,1473,34448,35921,0.00604401,0.383215,-0.92364,0
0,0,0,0,0,1228,241,1469,28721,30190,0.00444925,0.460128,-0.887842,0
0,0,0,0,0,1224,240,1464,32195,33659,-0.0137273,0.525392,-0.85075,0
0,0,0,0,0,1236,241,1477,35230,36707,-0.0249856,0.532125,-0.846297,0
0,0,0,0,0,1384,280,1664,35998,37662,-0.0183079,0.543558,-0.839172,0
0,0,0,0,0,1280,252,1532,32226,33758,-0.0178754,0.561278,-0.827435,0
0,0,0,0,0,1352,270,1622,25520,27142,-0.0156047,0.513193,-0.858132,0
0,0,0,0,0,1281,271,1552,17442,18994,-0.0141254,0.471331,-0.881844,0
0,0,0,0,0,1463,285,1748,36050,37798,-0.0321257,0.385738,-0.922049,0
0,0,0,0,0,1252,300,1552,36177,37729,-0.0435145,0.321515,-0.945904,0
0,0,0,0,0,1256,313,1569,33268,34837,-0.0604841,0.30158,-0.95152,0
0,0,0,0,0,1260,242,1502,35059,36561,-0.0663421,0.174386,-0.98244,0
0,0,0,0,0,1328,320,1648,32767,34415,-0.100075,0.161257,-0.981826,0
0,0,0,0,0,1261,313,1574,31122,32696,-0.122591,0.149735,-0.981097,0
0,0,0,0,0,1427,249,1676,33420,35096,-0.128807,0.126523,-0.983566,0
0,0,0,0,0,1278,333,1611,31720,33331,-0.151553,0.140707,-0.978383,0
0,0,0,0,0,1295,292,1587,30510,32097,-0.167656,0.155507,-0.973504,0
0,0,0,0,0,1287,242,1529,28882,30411,-0.167197,0.185451,-0.968325,0
0,0,0,0,0,1335,248,1583,27405,28988,-0.151558,0.207518,-0.96642,0
0,0,0,0,0,1519,289,1808,29670,31478,-0.134091,0.26736,-0.954221,0
0,0,0,0,0,1289,273,1562,27737,29299,-0.11159,0.292583,-0.949707,0
0,0,0,0,0,1296,275,1571,26869,28440,-0.0799147,0.33646,-0.938301,0
0,0,0,0,0,1318,244,1562,22944,24506,-0.0648923,0.333888,-0.940377,0
0,0,0,0,0,5055,886,5941,22771,28712,-0.0544125,0.408026,-0.911347,0
0,0,0,0,0,2213,304,2517,12426,14943,-0.0486612,0.351216,-0.935029,0
0,0,0,0,0,1543,260,1803,6800,8603,-0.0524371,0.348924,-0.935683,0
0,0,0,0,0,2620,456,3076,7450,10526,-0.0654115,0.3658,-0.928392,0
0,0,0,0,0,6225,1035,7260,17671,24931,-0.100399,0.45964,-0.882412,0
0,0,0,0,0,2631,462,3093,12537,15630,-0.0985084,0.493919,-0.86391,0
0,0,0,0,0,5525,927,6452,21297,27749,-0.0920864,0.585484,-0.805437,0
0,0,0,0,0,1851,324,2175,11386,13561,-0.0716523,0.626365,-0.77623,0
0,0,0,0,0,1780,305,2085,12540,14625,-0.0590711,0.662466,-0.746759,0
0,0,0,0,0,6179,1439,7618,-1000,-1000,-1,-1,-1,0
0,0,0,0,0,1509,303,1812,29458,31270,-0.0326309,0.0917083,-0.995251,0
0,0,0,0,0,1378,288,1666,32526,34192,-0.0603781,0.152721,-0.986423,0
0,0,0,0,0,1374,261,1635,28359,29994,-0.0644524,0.134658,-0.988794,0
0,0,0,0,0,6228,1214,7442,55862,63304,-0.00640554,0.234591,-0.972073,0
0,0,0,0,0,1365,291,1656,32332,33988,-0.00180256,0.238132,-0.971231,0
0,0,0,0,0,1395,353,1748,33422,35170,-0.00292295,0.246092,-0.969242,0
0,0,0,0,0,1779,273,2052,32879,34931,-0.00948098,0.253994,-0.967159,0
0,0,0,0,0,1501,319,1820,30407,32227,-0.0179635,0.280223,-0.959767,0
0,0,0,0,0,1550,318,1868,33817,35685,-0.0249442,0.241032,-0.970196,0
0,0,0,0,0,1573,386,1959,36905,38864,-0.0122162,0.258622,-0.965901,0
0,0,0,0,0,3573,618,4191,42865,47056,-0.00441803,0.320494,-0.94724,0
0,0,0,0,0,1706,298,2004,34832,36836,0.00718234,0.367693,-0.929919,0
0,0,0,0,0,1564,275,1839,33718,35557,0.0196984,0.35713,-0.933847,0
0,0,0,0,0,1564,277,1841,33880,35721,0.029412,0.362097,-0.931676,0
0,0,0,0,0,1490,269,1759,33788,35547,0.0304652,0.344992,-0.938111,0
0,0,0,0,0,1430,319,1749,33036,34785,0.0251573,0.272779,-0.961748,0
0,0,0,0,0,1536,314,1850,33511,35361,0.0398703,0.29256,-0.955416,0
0,0,0,0,0,1516,291,1807,31868,33675,0.0474136,0.296293,-0.95392,0
0,0,0,0,0,1406,295,1701,31362,33063,0.0402549,0.280712,-0.958948,0
0,0,0,0,0,1400,296,1696,29324,31020,0.0336181,0.29188,-0.955864,0
0,0,0,0,0,6540,1153,7693,37598,45291,-0.0855367,0.458986,-0.884316,0
0,0,0,0,0,1456,262,1718,8195,9913,-0.0997577,0.463438,-0.880496,0
0,0,0,0,0,1401,281,1682,2792,4474,-0.107294,0.481555,-0.869824,0
0,0,0,0,0,1287,229,1516,6588,8104,-0.10294,0.443382,-0.890402,0
0,0,0,0,0,2222,450,2672,5973,8645,-0.134123,0.51081,-0.849167,0
0,0,0,0,0,5951,1095,7046,25172,32218,-0.0876354,0.545143,-0.833751,0
0,0,0,0,0,1824,330,2154,9634,11788,-0.0455602,0.538588,-0.841337,0
0,0,0,0,0,1546,282,1828,10345,12173,-0.00551651,0.541688,-0.840562,0
0,0,0,0,0,2411,436,2847,16531,19378,-0.0100829,0.597409,-0.801873,0
0,0,0,0,0,3347,715,4062,24675,28737,-0.0523148,0.655019,-0.753799,0
0,0,0,0,0,1992,407,2399,16074,18473,-0.0830794,0.68983,-0.719189,0
0,0,0,0,0,5871,1143,7014,-1000,-1000,-1,-1,-1,0
0,0,0,0,0,1650,300,1950,9529,11479,-0.0142357,0.0574036,-0.99825,0
0,0,0,0,0,3301,622,3923,36687,40610,-0.0333459,0.161349,-0.986334,0
0,0,0,0,0,1534,375,1909,21015,22924,-0.0285494,0.177482,-0.98371,0
0,0,0,0,0,5889,1581,7470,16630,24100,-0.0182509,0.244556,-0.969464,0
0,0,0,0,0,1969,377,2346,21080,23426,-0.0148457,0.215232,-0.97645,0
0,0,0,0,0,1625,297,1922,19984,21906,-0.0131285,0.22913,-0.973308,0
0,0,0,0,0,1426,479,1905,22768,24673,-0.0245603,0.203578,-0.978751,0
0,0,0,0,0,1759,330,2089,26552,28641,-0.0224349,0.215758,-0.976189,0
0,0,0,0,0,1422,314,1736,25045,26781,-0.0209557,0.2046,-0.978621,0
0,0,0,0,0,1419,319,1738,34169,35907,-0.0163347,0.160564,-0.98689,0
0,0,0,0,0,2043,382,2425,42025,44450,0.0136857,0.315274,-0.948902,0
0,0,0,0,0,1378,297,1675,35432,37107,0.0243846,0.343117,-0.938976,0
0,0,0,0,0,1346,290,1636,35455,37091,0.0274171,0.353224,-0.935137,0
0,0,0,0,0,1353,283,1636,36847,38483,0.0168644,0.403389,-0.914873,0
0,0,0,0,0,1306,279,1585,37115,38700,0.00336571,0.415593,-0.909544,0
0,0,0,0,0,1262,285,1547,37592,39139,-0.00297748,0.452,-0.892013,0
0,0,0,0,0,1252,287,1539,37228,38767,-0.00814534,0.448926,-0.893531,0
0,0,0,0,0,1263,248,1511,36219,37730,-0.0209776,0.529923,-0.847787,0
0,0,0,0,0,3255,541,3796,44467,48263,-0.0236636,0.519813,-0.853952,0
0,0,0,0,0,1291,289,1580,26665,28245,-0.0124079,0.48139,-0.876419,0
0,0,0,0,0,1254,329,1583,34165,35748,0.0188461,0.530114,-0.847717,0
0,0,0,0,0,1249,250,1499,31426,32925,0.0398562,0.47157,-0.880927,0
0,0,0,0,0,2170,321,2491,27963,30454,0.0675304,0.463422,-0.883561,0
0,0,0,0,0,1206,228,1434,18812,20246,0.0856634,0.504044,-0.85942,0
0,0,0,0,0,5927,1153,7080,-1000,-1000,-1,-1,-1,0
0,0,0,0,0,2221,587,2808,27212,30020,-0.0249775,0.202217,-0.979022,0
0,0,0,0,0,1358,312,1670,17523,19193,-0.0423826,0.254253,-0.966209,0
0,0,0,0,0,1502,268,1770,16844,18614,-0.0701041,0.344437,-0.936189,0
0,0,0,0,0,1709,297,2006,18792,20798,-0.112125,0.426485,-0.897518,0
0,0,0,0,0,1515,262,1777,17082,18859,-0.10801,0.451532,-0.885693,0
0,0,0,0,0,1642,273,1915,19416,21331,-0.0858747,0.526495,-0.84583,0
0,0,0,0,0,1452,344,1796,18203,19999,-0.0399127,0.555671,-0.830444,0
0,0,0,0,0,6666,1138,7804,44638,52442,0.0118398,0.692882,-0.720954,0
0,0,0,0,0,1653,291,1944,22970,24914,0.0042654,0.686277,-0.727328,0
0,0,0,0,0,1530,264,1794,21498,23292,-0.00118862,0.65702,-0.753872,0
0,0,0,0,0,1544,267,1811,29787,31598,-0.0102736,0.643099,-0.765714,0
0,0,0,0,0,1588,274,1862,27430,29292,-0.00822186,0.597997,-0.801457,0
0,0,0,0,0,1585,299,1884,22470,24354,-0.0171871,0.559406,-0.828716,0
0,0,0,0,0,1583,266,1849,32322,34171,-0.0277365,0.497318,-0.867125,0
0,0,0,0,0,1473,316,1789,28917,30706,-0.034578,0.43949,-0.897582,0
0,0,0,0,0,1546,325,1871,30872,32743,-0.0356863,0.379025,-0.924698,0
0,0,0,0,0,1485,260,1745,35051,36796,-0.0161556,0.294989,-0.955364,0
0,0,0,0,0,4389,820,5209,44427,49636,0.0122862,0.287669,-0.957651,0
0,0,0,0,0,1485,266,1751,34360,36111,0.0324891,0.262817,-0.964298,0
0,0,0,0,0,1460,270,1730,33731,35461,0.0410455,0.227061,-0.973015,0
0,0,0,0,0,1743,316,2059,33971,36030,0.032744,0.221617,-0.974584,0
0,0,0,0,0,2811,545,3356,39260,42616,0.0248787,0.236634,-0.97128,0
0,0,0,0,0,1364,297,1661,31638,33299,0.0054602,0.245791,-0.969308,0
0,0,0,0,0,1383,297,1680,29884,31564,-0.00423961,0.255688,-0.96675,0
0,0,0,0,0,1348,307,1655,27396,29051,-0.00431133,0.233606,-0.972322,0
0,0,0,0,0,1343,287,1630,17944,19574,-0.000791842,0.27211,-0.962266,0
0,0,0,0,0,1528,283,1811,12039,13850,0.0254779,0.332215,-0.94286,0
0,0,0,0,0,5860,1080,6940,22771,29711,0.138361,0.378633,-0.915147,0
0,0,0,0,0,2627,484,3111,7393,10504,0.158025,0.393193,-0.905774,0
0,0,0,0,0,1859,355,2214,8171,10385,0.206471,0.343347,-0.916233,0
0,0,0,0,0,1567,290,1857,7880,9737,0.243914,0.384344,-0.890385,0
0,0,0,0,0,2838,526,3364,18147,21511,0.231876,0.472352,-0.850363,0
0,0,0,0,0,2919,536,3455,17156,20611,0.195449,0.568327,-0.799252,0
0,0,0,0,0,2420,452,2872,16420,19292,0.165431,0.643811,-0.747087,0
0,0,0,0,0,6661,1197,7858,-1000,-1000,-1,-1,-1,0
0,0,0,0,0,1624,303,1927,28630,30557,-0.0133989,0.039539,-0.999128,0
0,0,0,0,0,1430,272,1702,26756,28458,-0.00412395,0.07524,-0.997157,0
0,0,0,0,0,1440,314,1754,25358,27112,0.00578101,0.0831532,-0.99652,0
0,0,0,0,0,1989,290,2279,31854,34133,-0.00406515,0.0391972,-0.999223,0
0,0,0,0,0,1452,382,1834,33617,35451,-0.0216531,0.0360009,-0.999117,0
0,0,0,0,0,1451,278,1729,33962,35691,-0.0231078,0.0220613,-0.99949,0
0,0,0,0,0,2277,432,2709,43602,46311,-0.0311471,0.0869738,-0.995724,0
0,0,0,0,0,1496,276,1772,32777,34549,-0.027274,0.111089,-0.993436,0
0,0,0,0,0,1891,436,2327,34133,36460,-0.0180399,0.0975153,-0.995071,0
0,0,0,0,0,1468,391,1859,35961,37820,-0.0164949,0.0733088,-0.997173,0
0,0,0,0,0,1452,272,1724,35476,37200,-0.0165459,0.0663816,-0.997657,0
0,0,0,0,0,1453,272,1725,34512,36237,-0.0117261,0.0683976,-0.997589,0
0,0,0,0,0,1450,353,1803,36374,38177,-0.00928082,0.0600104,-0.998155,0
0,0,0,0,0,1353,298,1651,36489,38140,-0.0162244,0.0838484,-0.996347,0
0,0,0,0,0,6202,1228,7430,56811,64241,-0.010179,0.279023,-0.960231,0
0,0,0,0,0,1342,265,1607,36902,38509,-0.00327198,0.321771,-0.946812,0
0,0,0,0,0,1303,260,1563,35851,37414,0.000895109,0.356099,-0.934448,0
0,0,0,0,0,1326,389,1715,37965,39680,0.000437595,0.303983,-0.952677,0
0,0,0,0,0,1240,251,1491,37978,39469,-0.00278463,0.337449,-0.94134,0
0,0,0,0,0,1331,283,1614,35432,37046,0.0146438,0.481575,-0.876282,0
0,0,0,0,0,1276,290,1566,36659,38225,0.0141722,0.40006,-0.91638,0
0,0,0,0,0,1288,347,1635,36383,38018,0.00730466,0.390316,-0.920652,0
0,0,0,0,0,1249,280,1529,36224,37753,0.00401689,0.378607,-0.925549,0
0,0,0,0,0,1241,271,1512,33750,35262,0.0185872,0.375944,-0.926456,0
0,0,0,0,0,1260,246,1506,34636,36142,0.0305988,0.344343,-0.938345,0
0,0,0,0,0,1283,291,1574,32854,34428,0.0451234,0.373749,-0.926432,0
0,0,0,0,0,1349,246,1595,32510,34105,0.0579431,0.383116,-0.921881,0
0,0,0,0,0,1306,250,1556,26049,27605,0.0715414,0.362887,-0.929083,0
0,0,0,0,0,2102,278,2380,29648,32028,0.0839922,0.327419,-0.941139,0
0,0,0,0,0,1291,258,1549,26041,27590,0.0625173,0.284114,-0.95675,0
0,0,0,0,0,1310,254,1564,25222,26786,0.033009,0.25412,-0.966609,0
0,0,0,0,0,1340,286,1626,24587,26213,0.0111717,0.241049,-0.970449,0
0,0,0,0,0,1301,302,1603,22051,23654,-0.00326625,0.237366,-0.971415,0
0,0,0,0,0,1490,295,1785,21328,23113,0.006898,0.237936,-0.971256,0
0,0,0,0,0,1426,275,1701,20855,22556,0.0422188,0.216965,-0.975266,0
0,0,0,0,0,1282,290,1572,18350,19922,0.0544292,0.186475,-0.980951,0
0,0,0,0,0,1388,257,1645,18943,20588,0.0449726,0.162907,-0.985616,0
0,0,0,0,0,1618,299,1917,16445,18362,0.0341572,0.148151,-0.988374,0
0,0,0,0,0,1874,330,2204,21293,23497,0.0277266,0.133394,-0.990675,0
0,0,0,0,0,6302,1062,7364,30775,38139,0.035577,0.122304,-0.991855,0
0,0,0,0,0,1425,247,1672,11834,13506,0.037068,0.117969,-0.992325,0
0,0,0,0,0,1405,248,1653,11631,13284,0.0376627,0.12069,-0.991976,0
0,0,0,0,0,1390,239,1629,11379,13008,0.0363952,0.129901,-0.990859,0
0,0,0,0,0,1721,300,2021,15850,17871,0.0391359,0.133851,-0.990229,0
0,0,0,0,0,6047,1033,7080,29785,36865,0.0586736,0.131907,-0.989524,0
0,0,0,0,0,1617,289,1906,12419,14325,0.0576904,0.127219,-0.990195,0
0,0,0,0,0,1668,287,1955,14793,16748,0.0588802,0.126167,-0.99026,0
0,0,0,0,0,2060,358,2418,17779,20197,0.0536667,0.128344,-0.990276,0
0,0,0,0,0,2338,401,2739,19719,22458,0.0537517,0.128946,-0.990194,0
0,0,0,0,0,1750,317,2067,14745,16812,0.0550677,0.120507,-0.991184,0
0,0,0,0,0,1674,313,1987,13487,15474,0.0572924,0.109351,-0.992351,0
0,0,0,0,0,2052,360,2412,15001,17413,0.0571833,0.100105,-0.993332,0
0,0,0,0,0,2357,394,2751,15720,18471,0.0521428,0.0817238,-0.99529,0
0,0,0,0,0,2386,403,2789,12693,15482,0.0428637,0.0642642,-0.997012,0
0,0,0,0,0,2219,385,2604,9911,12515,0.0242742,0.0296484,-0.999265,0
0,0,0,0,0,6241,1013,7254,9008,16262,0.0141857,0.0138876,-0.999803,0
0,0,0,0,0,3037,589,3626,3504,7130,0.0113167,0.00802309,-0.999904,0
0,0,0,0,0,4602,747,5349,6101,11450,0.0141644,0.0112474,-0.999837,0
0,0,0,0,0,4558,801,5359,5350,10709,0.0196025,0.0155081,-0.999688,0
0,0,0,0,0,3367,568,3935,4158,8093,0.0238573,0.0183112,-0.999548,0
0,0,0,0,0,6107,1009,7116,8504,15620,0.0257891,0.0196899,-0.999474,0
0,0,0,0,0,6738,1006,7744,6955,14699,0.0245373,0.0172341,-0.99955,0
0,0,0,0,0,6036,1000,7036,7474,14510,0.0223071,0.0121302,-0.999678,0
0,0,0,0,0,3139,540,3679,4578,8257,0.0222232,0.00767998,-0.999724,0
0,0,0,0,0,5892,989,6881,8345,15226,0.0227671,0.00328031,-0.999735,0
0,0,0,0,0,5933,990,6923,8362,15285,0.0226706,0.00174514,-0.999741,0
0,0,0,0,0,4083,671,4754,5519,10273,0.0205139,0.00226021,-0.999787,0
0,0,0,0,0,6029,977,7006,7767,14773,0.0167083,0.00224195,-0.999858,0
0,0,0,0,0,4094,703,4797,5394,10191,0.0154021,0.00158082,-0.99988,0
0,0,0,0,0,5941,961,6902,7260,14162,0.0183456,9.34312e-06,-0.999832,0
0,0,0,0,0,4188,727,4915,5422,10337,0.0216427,-0.000919668,-0.999766,0
0,0,0,0,0,5931,1011,6942,8094,15036,0.0228918,-0.00142967,-0.999737,0
0,0,0,0,0,5926,1018,6944,7818,14762,0.0173414,0.00285415,-0.999846,0
0,0,0,0,0,3696,523,4219,3824,8043,0.0162166,0.00397332,-0.999861,0
0,0,0,0,0,2132,396,2528,2418,4946,0.0164471,0.00467401,-0.999854,0
0,0,0,0,0,2204,368,2572,2541,5113,0.0168593,0.00424481,-0.999849,0
0,0,0,0,0,5986,991,6977,7170,14147,0.017579,0.00349333,-0.999839,0
0,0,0,0,0,6096,1039,7135,6470,13605,0.0178551,0.00212411,-0.999838,0
0,0,0,0,0,4072,703,4775,5197,9972,0.0153747,0.000235836,-0.999882,0
0,0,0,0,0,6125,1011,7136,7966,15102,0.0122904,-0.000808456,-0.999925,0
0,0,0,0,0,5930,1001,6931,7244,14175,0.011442,-0.00184041,-0.999933,0
0,0,0,0,0,3167,601,3768,4155,7923,0.0111895,-0.00249196,-0.999934,0
0,0,0,0,0,5903,986,6889,8285,15174,0.0113614,-0.00305306,-0.999931,0
0,0,0,0,0,4342,703,5045,5492,10537,0.0131383,-0.00267729,-0.99991,0
0,0,0,0,0,6702,961,7663,7372,15035,0.0127187,-0.00403327,-0.999911,0
0,0,0,0,0,3890,643,4533,5040,9573,0.0128456,-0.00417398,-0.999909,0
0,0,0,0,0,5946,1058,7004,7985,14989,0.0122764,-0.00382316,-0.999917,0
0,0,0,0,0,4039,664,4703,5254,9957,0.0120822,-0.00265079,-0.999924,0
0,0,0,0,0,5903,1076,6979,7845,14824,0.0131085,-0.00304966,-0.99991,0
0,0,0,0,0,6897,990,7887,6250,14137,0.014245,-0.00401398,-0.999891,0
0,0,0,0,0,3121,535,3656,4098,7754,0.0146411,-0.0046251,-0.999882,0
0,0,0,0,0,4795,821,5616,6663,12279,0.014745,-0.00424591,-0.999883,0
0,0,0,0,0,6082,1063,7145,8583,15728,0.0146539,-0.00403349,-0.999885,0
0,0,0,0,0,4248,685,4933,5411,10344,0.0143122,-0.0040496,-0.99989,0
0,0,0,0,0,5394,1041,6435,6983,13418,0.0135121,-0.00531005,-0.999895,0
0,0,0,0,0,5282,865,6147,6306,12453,0.0142851,-0.00676077,-0.999875,0
0,0,0,0,0,3767,612,4379,5121,9500,0.013879,-0.00658214,-0.999882,0
0,0,0,0,0,6100,971,7071,8013,15084,0.0133406,-0.00559228,-0.999895,0
0,0,0,0,0,5082,713,5795,5354,11149,0.0132459,-0.00417713,-0.999904,0
0,0,0,0,0,4119,704,4823,5571,10394,0.0133376,-0.00363158,-0.999904,0
0,0,0,0,0,6157,975,7132,9611,16743,0.0138847,-0.00396051,-0.999896,0
0,0,0,0,0,3340,536,3876,3462,7338,0.0135367,-0.00416943,-0.9999,0
0,0,0,0,0,2128,366,2494,2812,5306,0.0137066,-0.00444316,-0.999896,0
0,0,0,0,0,3129,547,3676,4985,8661,0.0133837,-0.00438572,-0.999901,0
0,0,0,0,0,6205,1012,7217,7766,14983,0.0136766,-0.00295405,-0.999902,0
0,0,0,0,0,3866,642,4508,5071,9579,0.0143619,-0.00333105,-0.999892,0
0,0,0,0,0,3862,662,4524,4618,9142,0.0144678,-0.00430934,-0.999886,0
0,0,0,0,0,5014,832,5846,6855,12701,0.0143806,-0.00490259,-0.999884,0
0,0,0,0,0,4958,841,5799,6862,12661,0.0141945,-0.00522313,-0.999886,0
0,0,0,0,0,3630,590,4220,4316,8536,0.0143003,-0.00635831,-0.999878,0
0,0,0,0,0,5722,935,6657,6860,13517,0.0135345,-0.00718331,-0.999883,0
0,0,0,0,0,3885,636,4521,4973,9494,0.0134265,-0.00731382,-0.999883,0
0,0,0,0,0,5015,851,5866,6161,12027,0.0135941,-0.00774596,-0.999878,0
0,0,0,0,0,5148,829,5977,5553,11530,0.0128162,-0.0076476,-0.999888,0
0,0,0,0,0,3565,602,4167,4504,8671,0.0129059,-0.00897812,-0.999876,0
0,0,0,0,0,5716,967,6683,6868,13551,0.0109873,-0.00891705,-0.9999,0
0,0,0,0,0,3792,615,4407,4829,9236,0.00937718,-0.00892207,-0.999916,0
0,0,0,0,0,5270,993,6263,6914,13177,0.00864355,-0.00967675,-0.999916,0
0,0,0,0,0,5346,910,6256,6920,13176,0.00934837,-0.0100678,-0.999906,0
0,0,0,0,0,5224,860,6084,6112,12196,0.0105038,-0.00963884,-0.999898,0
0,0,0,0,0,4850,835,5685,6148,11833,0.0115582,-0.00937047,-0.999889,0
0,0,0,0,0,4935,840,5775,5879,11654,0.0132138,-0.00996314,-0.999863,0
0,0,0,0,0,4793,574,5367,4188,9555,0.0137803,-0.00952452,-0.99986,0
0,0,0,0,0,1940,332,2272,2499,4771,0.01316,-0.00880948,-0.999875,0
0,0,0,0,0,5942,962,6904,7336,14240,0.0123426,-0.00914567,-0.999882,0
0,0,0,0,0,5861,956,6817,5847,12664,0.0118724,-0.00931056,-0.999886,0
0,0,0,0,0,3789,622,4411,4898,9309,0.0120911,-0.00985198,-0.999879,0
0,0,0,0,0,5700,861,6561,6899,13460,0.0121071,-0.0102762,-0.999874,0
0,0,0,0,0,5413,863,6276,7276,13552,0.0129443,-0.0103523,-0.999863,0
0,0,0,0,0,3775,644,4419,5167,9586,0.0128694,-0.0111979,-0.999854,0
0,0,0,0,0,5341,883,6224,6664,12888,0.0138653,-0.0106281,-0.999847,0
0,0,0,0,0,5975,914,6889,6517,13406,0.0131743,-0.00969098,-0.999866,0
0,0,0,0,0,3765,693,4458,4644,9102,0.0145354,-0.00795663,-0.999863,0
0,0,0,0,0,6139,993,7132,7160,14292,0.0156898,-0.00660523,-0.999855,0
0,0,0,0,0,3853,648,4501,4680,9181,0.015638,-0.00644826,-0.999857,0
0,0,0,0,0,5790,897,6687,6640,13327,0.0150826,-0.00655379,-0.999865,0
0,0,0,0,0,6273,927,7200,5952,13152,0.0148341,-0.00621862,-0.999871,0
0,0,0,0,0,2982,518,3500,3688,7188,0.014373,-0.00597616,-0.999879,0
0,0,0,0,0,6784,963,7747,7616,15363,0.0142029,-0.0065821,-0.999877,0
0,0,0,0,0,5332,861,6193,6478,12671,0.0143365,-0.00687174,-0.999874,0
0,0,0,0,0,3434,531,3965,3901,7866,0.0137748,-0.00750989,-0.999877,0
0,0,0,0,0,5304,905,6209,6993,13202,0.0135865,-0.0079637,-0.999876,0
0,0,0,0,0,5360,901,6261,6933,13194,0.0127395,-0.00887649,-0.999879,0
0,0,0,0,0,5270,944,6214,6967,13181,0.0133278,-0.00936808,-0.999867,0
0,0,0,0,0,4858,826,5684,6138,11822,0.0132149,-0.0101509,-0.999861,0
0,0,0,0,0,5955,1023,6978,7564,14542,0.0127361,-0.0105987,-0.999863,0
0,0,0,0,0,5724,991,6715,6024,12739,0.0115904,-0.0104652,-0.999878,0
0,0,0,0,0,5965,999,6964,6990,13954,0.0129636,-0.0104351,-0.999862,0
0,0,0,0,0,4067,687,4754,5079,9833,0.0136663,-0.0105732,-0.999851,0
0,0,0,0,0,4369,711,5080,5219,10299,0.0133355,-0.0105588,-0.999855,0
0,0,0,0,0,6067,934,7001,7320,14321,0.0137297,-0.0098748,-0.999857,1
0,0,0,0,0,5526,892,6418,5179,11597,0.0136693,-0.00959498,-0.99986,1
0,0,0,0,0,2939,405,3344,3363,6707,0.0131399,-0.00882745,-0.999875,1
0,0,0,0,0,5310,872,6182,7221,13403,0.0131598,-0.00880816,-0.999875,1
0,0,0,0,0,5528,910,6438,6161,12599,0.0130116,-0.0092159,-0.999873,1
0,0,0,0,0,3838,653,4491,5922,10413,0.0127086,-0.0100028,-0.999869,1
0,0,0,0,0,3826,635,4461,4845,9306,0.0125389,-0.0103654,-0.999868,1
0,0,0,0,0,4985,866,5851,6196,12047,0.012931,-0.010004,-0.999866,1
0,0,0,0,0,5431,893,6324,6609,12933,0.0137945,-0.0100113,-0.999855,1
0,0,0,0,0,5492,941,6433,6816,13249,0.0141536,-0.00912365,-0.999858,1
0,0,0,0,0,3850,638,4488,4697,9185,0.0145415,-0.00768332,-0.999865,1
0,0,0,0,0,5498,955,6453,6355,12808,0.0144312,-0.00706063,-0.999871,1
0,0,0,0,0,7544,1316,8860,5944,14804,0.0145272,-0.00803752,-0.999862,1
0,0,0,0,0,2418,392,2810,2998,5808,0.0146516,-0.00684899,-0.999869,1
0,0,0,0,0,6134,917,7051,6307,13358,0.0155949,-0.00661761,-0.999857,1
0,0,0,0,0,5453,869,6322,5970,12292,0.0152444,-0.0076439,-0.999855,1
0,0,0,0,0,6061,961,7022,6693,13715,0.0158477,-0.00704735,-0.99985,1
0,0,0,0,0,3795,616,4411,4747,9158,0.0152258,-0.00703147,-0.999859,1
0,0,0,0,0,5982,965,6947,7349,14296,0.0147028,-0.0062171,-0.999873,1
0,0,0,0,0,4878,787,5665,5713,11378,0.0142807,-0.00577451,-0.999881,1
0,0,0,0,0,4932,784,5716,6063,11779,0.0142535,-0.00552028,-0.999883,1
0,0,0,0,0,2850,455,3305,3408,6713,0.0159549,-0.00494277,-0.999861,1
0,0,0,0,0,5587,919,6506,6549,13055,0.0159799,-0.00549965,-0.999857,1
0,0,0,0,0,5419,898,6317,6339,12656,0.0156532,-0.00556001,-0.999862,1
0,0,0,0,0,5413,867,6280,6268,12548,0.0148333,-0.00500867,-0.999878,1
0,0,0,0,0,5361,865,6226,6446,12672,0.015265,-0.00463929,-0.999873,1
0,0,0,0,0,4834,825,5659,6087,11746,0.0153347,-0.00572127,-0.999866,1
0,0,0,0,0,5852,917,6769,7150,13919,0.0157397,-0.00643621,-0.999856,1
0,0,0,0,0,6044,965,7009,6841,13850,0.0164018,-0.00609645,-0.999847,1
0,0,0,0,0,4089,677,4766,5377,10143,0.0158032,-0.00603779,-0.999857,1
0,0,0,0,0,6020,979,6999,7280,14279,0.0159447,-0.00575277,-0.999856,1
0,0,0,0,0,6483,916,7399,5638,13037,0.0155146,-0.00554988,-0.999864,1
0,0,0,0,0,3027,525,3552,3772,7324,0.0154176,-0.00533766,-0.999867,1
0,0,0,0,0,5433,899,6332,6910,13242,0.0160565,-0.0056711,-0.999855,1
0,0,0,0,0,5844,882,6726,6838,13564,0.0173466,-0.00593127,-0.999832,1
0,0,0,0,0,3881,630,4511,4759,9270,0.0183669,-0.00567853,-0.999815,1
0,0,0,0,0,5337,874,6211,8497,14708,0.0170424,-0.00544365,-0.99984,1
0,0,0,0,0,5911,983,6894,7279,14173,0.0163523,-0.00470108,-0.999855,1
0,0,0,0,0,5494,936,6430,6863,13293,0.0157846,-0.0045869,-0.999865,1
0,0,0,0,0,6098,959,7057,7367,14424,0.0123419,-0.00502633,-0.999911,1
0,0,0,0,0,5322,866,6188,6533,12721,0.00947663,-0.00591848,-0.999938,1
0,0,0,0,0,3813,621,4434,4552,8986,0.00875744,-0.00757024,-0.999933,1
0,0,0,0,0,5857,992,6849,6482,13331,0.0103408,-0.00865433,-0.999909,1
0,0,0,0,0,5333,877,6210,6617,12827,0.0107292,-0.00698684,-0.999918,1
0,0,0,0,0,5499,888,6387,6877,13264,0.0105946,-0.00665651,-0.999922,1
0,0,0,0,0,3841,692,4533,4870,9403,0.0107567,-0.0074899,-0.999914,1
0,0,0,0,0,5870,913,6783,5404,12187,0.0119591,-0.00792581,-0.999897,1
0,0,0,0,0,3536,587,4123,4607,8730,0.0114553,-0.00842517,-0.999899,1
0,0,0,0,0,5332,877,6209,7018,13227,0.00739827,-0.00935388,-0.999929,1
0,0,0,0,0,5432,924,6356,7112,13468,0.00412005,-0.00649154,-0.999971,1
0,0,0,0,0,5379,907,6286,6061,12347,0.00337265,-0.0032064,-0.999989,1
0,0,0,0,0,3851,631,4482,4911,9393,0.00628362,-0.00103116,-0.99998,1
0,0,0,0,0,4940,797,5737,6663,12400,0.0106073,-0.00322003,-0.999939,1
0,0,0,0,0,5035,836,5871,6258,12129,0.0127011,-0.00654155,-0.999898,1
0,0,0,0,0,4949,810,5759,6315,12074,0.0138448,-0.0125665,-0.999825,1
0,0,0,0,0,5631,812,6443,6504,12947,0.0104074,-0.0176019,-0.999791,1
0,0,0,0,0,5996,1014,7010,7769,14779,0.00531203,-0.0183947,-0.999817,1
0,0,0,0,0,3808,518,4326,3893,8219,0.00500617,-0.0164601,-0.999852,1
0,0,0,0,0,2389,353,2742,2868,5610,0.00589225,-0.0155495,-0.999862,1
0,0,0,0,0,3093,514,3607,4304,7911,0.00940663,-0.0119764,-0.999884,1
0,0,0,0,0,5298,879,6177,6902,13079,0.0107708,-0.00741818,-0.999914,1
0,0,0,0,0,5550,1099,6649,6709,13358,0.0127699,-0.00290389,-0.999914,1
0,0,0,0,0,3810,618,4428,4875,9303,0.0112978,0.00187868,-0.999935,1
0,0,0,0,0,6094,1047,7141,7683,14824,0.0127787,0.00878697,-0.99988,1
0,0,0,0,0,3786,645,4431,6104,10535,0.0132632,0.0143885,-0.999808,1
0,0,0,0,0,4035,613,4648,6210,10858,0.0149942,0.0256519,-0.999559,1
0,0,0,0,0,5546,819,6365,8741,15106,0.0187577,0.0473465,-0.998702,1
0,0,0,0,0,4506,756,5262,9911,15173,0.021503,0.0760728,-0.99687,1
0,0,0,0,0,3874,563,4437,9466,13903,0.0264302,0.105697,-0.994047,1
0,0,0,0,0,5480,943,6423,25114,31537,0.0378354,0.189976,-0.981059,1
0,0,0,0,0,3851,641,4492,15375,19867,0.0474435,0.186959,-0.981221,1
0,0,0,0,0,1615,285,1900,8308,10208,0.067527,0.203037,-0.97684,1
0,0,0,0,0,2479,439,2918,13728,16646,0.0997831,0.255704,-0.961592,1
0,0,0,0,0,6202,1036,7238,23840,31078,0.125243,0.319884,-0.939142,1
0,0,0,0,0,1715,288,2003,10530,12533,0.124456,0.326386,-0.937007,1
0,0,0,0,0,5826,972,6798,26703,33501,0.097137,0.39433,-0.913821,1
0,0,0,0,0,1527,255,1782,12666,14448,0.0879253,0.358886,-0.929231,1
0,0,0,0,0,1488,261,1749,16315,18064,0.0849844,0.32131,-0.943153,1
0,0,0,0,0,1775,322,2097,24700,26797,0.084818,0.304254,-0.948807,1
0,0,0,0,0,1423,269,1692,22744,24436,0.0790814,0.281704,-0.956237,1
0,0,0,0,0,1342,294,1636,27067,28703,0.0612985,0.26511,-0.962268,1
0,0,0,0,0,1471,278,1749,29500,31249,0.035872,0.272199,-0.961572,1
0,0,0,0,0,5172,938,6110,44738,50848,0.00835327,0.305259,-0.952233,1
0,0,0,0,0,1367,252,1619,33312,34931,0.0092557,0.284593,-0.958604,1
0,0,0,0,0,1389,253,1642,35439,37081,0.0181294,0.221072,-0.975089,1
0,0,0,0,0,1365,289,1654,35430,37084,0.0318577,0.203203,-0.978618,1
0,0,0,0,0,1415,338,1753,33385,35138,0.0423371,0.240544,-0.969714,1
0,0,0,0,0,1486,277,1763,34682,36445,0.0465357,0.202644,-0.978146,1
0,0,0,0,0,1831,346,2177,36106,38283,0.0446687,0.16693,-0.984957,1
0,0,0,0,0,1503,301,1804,36700,38504,0.0477195,0.128353,-0.99058,1
0,0,0,0,0,1484,269,1753,36068,37821,0.0423736,0.116995,-0.992228,1
0,0,0,0,0,1502,371,1873,35851,37724,0.0356209,0.186641,-0.981782,1
0,0,0,0,0,1391,254,1645,35648,37293,0.0342777,0.179609,-0.983141,1
0,0,0,0,0,1372,306,1678,34303,35981,0.0284657,0.176097,-0.983961,1
0,0,0,0,0,1351,336,1687,33398,35085,0.0187562,0.174791,-0.984427,1
0,0,0,0,0,1347,251,1598,29799,31397,0.0153671,0.162375,-0.986609,1
0,0,0,0,0,1750,309,2059,22916,24975,0.0193142,0.140868,-0.98984,1
0,0,0,0,0,1410,231,1641,13988,15629,0.0286052,0.130179,-0.991078,1
0,0,0,0,0,5531,917,6448,23454,29902,0.0341378,0.150818,-0.987972,1
0,0,0,0,0,4087,732,4819,14498,19317,0.0350089,0.156531,-0.987052,1
0,0,0,0,0,4011,698,4709,11761,16470,0.019524,0.199565,-0.97969,1
0,0,0,0,0,2911,522,3433,9542,12975,0.00438514,0.0811421,-0.996693,1
0,0,0,0,0,5743,1025,6768,19578,26346,-0.0781215,0.208289,-0.974943,1
0,0,0,0,0,3051,606,3657,7631,11288,-0.0696724,0.230262,-0.970632,1
0,0,0,0,0,5995,1102,7097,22457,29554,-0.0783119,0.30524,-0.94905,1
0,0,0,0,0,2079,371,2450,8018,10468,0.107676,-0.0651465,-0.99205,1
0,0,0,0,0,1380,360,1740,4538,6278,0.0697373,-0.00496706,-0.997553,1
0,0,0,0,0,1723,316,2039,14352,16391,0.0670388,0.0722737,-0.995129,1
0,0,0,0,0,2164,396,2560,15503,18063,0.137031,0.0392723,-0.989788,1
0,0,0,0,0,4241,856,5097,21439,26536,0.16092,0.0743401,-0.984164,1
0,0,0,0,0,2135,410,2545,9898,12443,0.152507,0.12268,-0.980659,1
0,0,0,0,0,2836,527,3363,10282,13645,0.126475,0.181291,-0.975263,1
0,0,0,0,0,6227,1172,7399,19904,27303,0.099831,0.256117,-0.961477,1
0,0,0,0,0,1964,379,2343,10418,12761,0.0790263,0.31762,-0.944919,1
0,0,0,0,0,1816,343,2159,10059,12218,0.0591438,0.3808,-0.922764,1
0,0,0,0,0,2547,473,3020,13122,16142,0.0543726,0.448822,-0.891966,1
0,0,0,0,0,3421,633,4054,17183,21237,0.0646349,0.503604,-0.861513,1
0,0,0,0,0,2733,497,3230,15057,18287,0.0756076,0.540193,-0.838138,1
0,0,0,0,0,1993,360,2353,11331,13684,0.0710202,0.567377,-0.82039,1
0,0,0,0,0,2530,451,2981,13878,16859,0.0619171,0.597865,-0.799201,1
0,0,0,0,0,2902,518,3420,17393,20813,0.0503752,0.640134,-0.76661,1
0,0,0,0,0,2815,500,3315,6712,10027,0.0381019,0.664565,-0.746258,1
0,0,0,0,0,5925,1064,6989,-1000,-1000,-1,-1,-1,1
0,0,0,0,0,1786,349,2135,30835,32970,-0.0173236,-0.0252805,-0.999531,1
0,0,0,0,0,4245,772,5017,36790,41807,-0.0035088,0.025811,-0.999661,1
0,0,0,0,0,1455,276,1731,33851,35582,-0.00170708,-0.00788938,-0.999968,1
0,0,0,0,0,1444,337,1781,34221,36002,0.00420665,-0.00387156,-0.999984,1
0,0,0,0,0,1395,339,1734,34790,36524,0.0106248,-0.00834597,-0.999909,1
0,0,0,0,0,1369,268,1637,35429,37066,-0.0104068,0.0110515,-0.999885,1
0,0,0,0,0,1334,313,1647,35281,36928,-0.0267408,0.00485699,-0.999631,1
0,0,0,0,0,1465,304,1769,35342,37111,-0.0359142,0.0228149,-0.999094,1
0,0,0,0,0,1443,275,1718,35424,37142,-0.0362085,0.0455365,-0.998306,1
0,0,0,0,0,2795,519,3314,42655,45969,-0.0092395,0.0859592,-0.996256,1
0,0,0,0,0,1394,316,1710,36108,37818,-0.00437491,0.0771484,-0.99701,1
0,0,0,0,0,1281,259,1540,36395,37935,0.00267299,0.09256,-0.995704,1
0,0,0,0,0,1264,267,1531,36419,37950,-0.00437148,0.0880588,-0.996106,1
0,0,0,0,0,2786,551,3337,54242,57579,-0.0320241,0.304258,-0.952052,1
0,0,0,0,0,1226,299,1525,35998,37523,-0.0264631,0.277942,-0.960233,1
0,0,0,0,0,1228,311,1539,35972,37511,-0.00734211,0.232037,-0.972679,1
0,0,0,0,0,1240,295,1535,31989,33524,0.0108356,0.209658,-0.977715,1
0,0,0,0,0,1232,307,1539,34240,35779,0.03899,0.191876,-0.980645,1
0,0,0,0,0,1233,256,1489,31178,32667,0.0585313,0.197655,-0.978523,1
0,0,0,0,0,1236,240,1476,30129,31605,0.0547986,0.175169,-0.983012,1
0,0,0,0,0,1235,288,1523,29886,31409,0.0479311,0.155078,-0.986739,1
0,0,0,0,0,1237,253,1490,28946,30436,0.0256327,0.132995,-0.990785,1
0,0,0,0,0,1274,259,1533,25676,27209,0.0155482,0.106286,-0.994214,1
0,0,0,0,0,1361,270,1631,28283,29914,0.0194519,0.0873822,-0.995985,1
0,0,0,0,0,1390,275,1665,27272,28937,0.021885,0.0753736,-0.996915,1
0,0,0,0,0,1401,280,1681,27023,28704,0.0216668,0.0856046,-0.996093,1
0,0,0,0,0,1257,343,1600,23054,24654,0.0174493,0.113704,-0.993361,1
0,0,0,0,0,1246,241,1487,21727,23214,0.0080457,0.117773,-0.993008,1
0,0,0,0,0,1186,234,1420,18664,20084,0.00119586,0.105534,-0.994415,1
0,0,0,0,0,1791,325,2116,17756,19872,0.00605281,0.106963,-0.994245,1
0,0,0,0,0,1724,317,2041,18553,20594,0.0135248,0.0885306,-0.995982,1
0,0,0,0,0,1667,287,1954,10669,12623,0.0194372,0.0818987,-0.996451,1
0,0,0,0,0,2174,394,2568,13833,16401,0.00898247,0.0923385,-0.995687,1
0,0,0,0,0,3002,545,3547,20818,24365,-0.0088682,0.144709,-0.989435,1
0,0,0,0,0,2213,376,2589,19473,22062,-0.0416912,0.174421,-0.983788,1
0,0,0,0,0,1621,289,1910,19909,21819,-0.0574727,0.229813,-0.971536,1
0,0,0,0,0,1439,291,1730,21876,23606,-0.0602578,0.295567,-0.95342,1
0,0,0,0,0,5519,1110,6629,37310,43939,-0.0592424,0.40692,-0.911541,1
0,0,0,0,0,1359,254,1613,28028,29641,-0.0448685,0.348285,-0.936314,1
0,0,0,0,0,1525,294,1819,24523,26342,-0.0419713,0.393208,-0.918491,1
0,0,0,0,0,1508,278,1786,32162,33948,-0.0310682,0.257719,-0.96572,1
0,0,0,0,0,1588,279,1867,35075,36942,-0.0102533,0.161788,-0.986772,1
0,0,0,0,0,5853,926,6779,47085,53864,0.0359368,0.174218,-0.984051,1
0,0,0,0,0,1499,326,1825,35122,36947,0.0762508,0.139462,-0.987287,1
0,0,0,0,0,1476,258,1734,33791,35525,0.0754006,0.075809,-0.994268,1
0,0,0,0,0,1445,293,1738,32805,34543,0.0654017,0.0422519,-0.996964,1
0,0,0,0,0,2545,393,2938,35947,38885,0.0736949,0.0688388,-0.994902,1
0,0,0,0,0,1568,305,1873,30817,32690,0.0451521,0.0548455,-0.997473,1
0,0,0,0,0,1359,275,1634,30017,31651,0.0237502,0.0849009,-0.996106,1
0,0,0,0,0,1482,310,1792,28363,30155,0.0285224,0.0999256,-0.994586,1
0,0,0,0,0,1366,244,1610,25825,27435,0.0310476,0.102394,-0.99426,1
0,0,0,0,0,1388,244,1632,24126,25758,0.0199143,0.110633,-0.993662,1
0,0,0,0,0,1523,278,1801,17238,19039,0.0232003,0.148311,-0.988669,1
0,0,0,0,0,1648,289,1937,5157,7094,0.0272146,0.17722,-0.983795,1
0,0,0,0,0,3882,741,4623,15827,20450,0.00128554,0.221184,-0.975232,1
0,0,0,0,0,3861,665,4526,17183,21709,-0.0440488,0.192811,-0.980247,1
0,0,0,0,0,2027,359,2386,9295,11681,-0.092689,0.196716,-0.976069,1
0,0,0,0,0,3235,547,3782,15448,19230,-0.134075,0.200857,-0.970402,1
0,0,0,0,0,3193,548,3741,16461,20202,-0.142743,0.197327,-0.96989,1
0,0,0,0,0,2821,445,3266,14453,17719,-0.134616,0.200215,-0.97046,1
0,0,0,0,0,2409,423,2832,12104,14936,-0.12664,0.200264,-0.971523,1
0,0,0,0,0,5959,1042,7001,26057,33058,-0.145254,0.391604,-0.908597,1
0,0,0,0,0,2059,321,2380,12325,14705,-0.16024,0.430724,-0.888144,1
0,0,0,0,0,1327,338,1665,6054,7719,-0.173865,0.473808,-0.863295,1
0,0,0,0,0,1564,277,1841,12264,14105,-0.19365,0.56976,-0.798669,1
0,0,0,0,0,2323,446,2769,-1000,-1000,-1,-1,-1,1
0,0,0,0,0,6004,1196,7200,28695,35895,-0.0179969,0.0585436,-0.998123,1
0,0,0,0,0,1547,304,1851,19134,20985,-0.011035,-0.0274276,-0.999563,1
0,0,0,0,0,1510,274,1784,21340,23124,-0.0174659,-0.0360859,-0.999196,1
0,0,0,0,0,1582,295,1877,21928,23805,-0.0241595,-0.0416095,-0.998842,1
0,0,0,0,0,1665,336,2001,28142,30143,-0.0227573,-0.0461397,-0.998676,1
0,0,0,0,0,1508,270,1778,31475,33253,-0.0155053,-0.0362263,-0.999224,1
0,0,0,0,0,1795,364,2159,32951,35110,-0.0152487,-0.0286909,-0.999472,1
0,0,0,0,0,1457,405,1862,30708,32570,-0.00290012,0.00859982,-0.999959,1
0,0,0,0,0,1445,314,1759,33810,35569,0.0102775,0.00273576,-0.999943,1
0,0,0,0,0,1423,381,1804,34998,36802,0.00327885,-0.0283706,-0.999592,1
0,0,0,0,0,1393,270,1663,36242,37905,0.0153453,-0.00502114,-0.99987,1
0,0,0,0,0,1339,318,1657,35912,37569,0.00247886,-0.0250015,-0.999684,1
0,0,0,0,0,5820,1165,6985,52948,59933,-0.0607673,0.140896,-0.988158,1
0,0,0,0,0,1300,294,1594,36764,38358,-0.0840184,0.150077,-0.985098,1
0,0,0,0,0,1280,302,1582,37469,39051,-0.0834492,0.140314,-0.986584,1
0,0,0,0,0,1418,320,1738,36890,38628,-0.0726491,0.113781,-0.990846,1
0,0,0,0,0,1255,369,1624,36474,38098,-0.0621413,0.109469,-0.992046,1
0,0,0,0,0,3238,576,3814,44350,48164,-0.063474,0.148281,-0.986906,1
0,0,0,0,0,1266,257,1523,36173,37696,-0.0552712,0.125584,-0.990542,1
0,0,0,0,0,1231,294,1525,36402,37927,-0.0354606,0.107074,-0.993619,1
0,0,0,0,0,1219,291,1510,37138,38648,-0.00634817,0.0852343,-0.996341,1
0,0,0,0,0,1218,285,1503,35525,37028,0.0290822,0.11185,-0.9933,1
0,0,0,0,0,1255,254,1509,36734,38243,0.0300582,0.0742567,-0.996786,1
0,0,0,0,0,1226,253,1479,35234,36713,0.0522319,0.077785,-0.995601,1
0,0,0,0,0,3084,490,3574,34967,38541,0.0425807,0.0741176,-0.99634,1
0,0,0,0,0,1264,270,1534,32328,33862,0.0468771,0.0989037,-0.993992,1
0,0,0,0,0,1250,248,1498,33181,34679,0.0434105,0.102919,-0.993742,1
0,0,0,0,0,3854,793,4647,40975,45622,0.0201097,0.147539,-0.988852,1
0,0,0,0,0,1311,268,1579,30897,32476,0.00113425,0.142858,-0.989742,1
0,0,0,0,0,1277,288,1565,29694,31259,-0.0155924,0.143133,-0.989581,1
0,0,0,0,0,1285,311,1596,28409,30005,-0.0212184,0.142776,-0.989528,1
0,0,0,0,0,1248,250,1498,26559,28057,-0.0197051,0.151038,-0.988332,1
0,0,0,0,0,1234,335,1569,23539,25108,-0.00523403,0.168542,-0.985681,1
0,0,0,0,0,1262,262,1524,20226,21750,-0.00214385,0.207199,-0.978297,1
0,0,0,0,0,1411,262,1673,16896,18569,-0.00539313,0.247972,-0.968752,1
0,0,0,0,0,1433,272,1705,6193,7898,-0.00819056,0.301519,-0.953425,1
0,0,0,0,0,3566,697,4263,21019,25282,-0.0401444,0.386159,-0.921558,1
0,0,0,0,0,2994,527,3521,12931,16452,-0.0483683,0.44225,-0.895586,1
0,0,0,0,0,6410,1149,7559,11184,18743,-0.0539831,0.572704,-0.817983,1
0,0,0,0,0,2451,471,2922,11745,14667,-0.0733536,0.673343,-0.735683,1
0,0,0,0,0,6768,1026,7794,-1000,-1000,-1,-1,-1,1
0,0,0,0,0,1866,365,2231,37295,39526,-0.0122391,0.122292,-0.992419,1
0,0,0,0,0,1348,378,1726,34390,36116,-0.0187858,0.189621,-0.981678,1
0,0,0,0,0,2821,515,3336,32021,35357,-0.0087109,0.239368,-0.97089,1
0,0,0,0,0,1449,347,1796,34911,36707,0.00376262,0.185361,-0.982663,1
0,0,0,0,0,1520,393,1913,33198,35111,0.0127984,0.208884,-0.977857,1
0,0,0,0,0,1539,285,1824,35468,37292,0.00211943,0.14156,-0.989927,1
0,0,0,0,0,1584,327,1911,35367,37278,-0.0154987,0.128135,-0.991636,1
0,0,0,0,0,1501,276,1777,35154,36931,-0.0231301,0.132748,-0.99088,1
0,0,0,0,0,1484,275,1759,35598,37357,-0.011107,0.0936317,-0.995545,1
0,0,0,0,0,1868,349,2217,34273,36490,-0.000732189,0.11406,-0.993474,1
0,0,0,0,0,1554,269,1823,33112,34935,0.0083003,0.118309,-0.992942,1
0,0,0,0,0,1409,267,1676,31937,33613,0.000711212,0.132854,-0.991136,1
0,0,0,0,0,1389,257,1646,30551,32197,-0.0141838,0.156049,-0.987647,1
0,0,0,0,0,1344,246,1590,29415,31005,-0.0363685,0.167021,-0.985282,1
0,0,0,0,0,1516,305,1821,28339,30160,-0.0386639,0.152195,-0.987594,1
0,0,0,0,0,4965,1171,6136,28570,34706,-0.0131959,0.220982,-0.975188,1
0,0,0,0,0,1255,223,1478,5411,6889,0.00240356,0.258216,-0.966084,1
0,0,0,0,0,1588,272,1860,8000,9860,0.0368684,0.370017,-0.928293,1
0,0,0,0,0,4601,820,5421,25825,31246,0.0753513,0.497396,-0.864245,1
0,0,0,0,0,2497,386,2883,14727,17610,0.0896196,0.574164,-0.813821,1
0,0,0,0,0,1365,271,1636,13143,14779,0.10396,0.644376,-0.75761,1
0,0,0,0,0,1818,347,2165,15017,17182,0.131441,0.676638,-0.724489,1
0,0,0,0,0,2612,518,3130,-1000,-1000,-1,-1,-1,1
0,0,0,0,0,5577,764,6341,16138,22479,0.0047449,0.0320921,-0.999474,1
0,0,0,0,0,1880,353,2233,8137,10370,0.000108253,-0.00341467,-0.999994,1
0,0,0,0,0,2711,509,3220,22043,25263,-0.0101443,-0.0298012,-0.999504,1
0,0,0,0,0,1995,387,2382,9616,11998,-0.0155585,-0.0241731,-0.999587,1
0,0,0,0,0,4166,798,4964,40207,45171,-0.0382431,-8.20572e-05,-0.999269,1
0,0,0,0,0,1632,293,1925,24203,26128,-0.0442778,-0.0472739,-0.9979,1
0,0,0,0,0,3885,757,4642,41091,45733,-0.0690733,0.00724861,-0.997585,1
0,0,0,0,0,1458,384,1842,31955,33797,-0.0682475,-0.0251861,-0.997351,1
0,0,0,0,0,1405,263,1668,31408,33076,-0.063488,-0.0370643,-0.997294,1
0,0,0,0,0,1620,360,1980,34092,36072,-0.0609289,-0.0218623,-0.997903,1
0,0,0,0,0,2914,538,3452,37703,41155,-0.0378317,0.000540256,-0.999284,1
0,0,0,0,0,1420,323,1743,34658,36401,-0.0405073,-0.0256245,-0.998851,1
0,0,0,0,0,3321,699,4020,56221,60241,-0.0148381,0.182395,-0.983113,1
0,0,0,0,0,1344,260,1604,34473,36077,-0.00125839,0.218232,-0.975896,1
0,0,0,0,0,1337,291,1628,36301,37929,-0.0017881,0.215737,-0.97645,1
0,0,0,0,0,1382,339,1721,36500,38221,-0.0163814,0.223197,-0.974636,1
0,0,0,0,0,1261,265,1526,36414,37940,-0.0214556,0.248979,-0.968271,1
0,0,0,0,0,1232,259,1491,37356,38847,-0.0178656,0.222719,-0.974719,1
0,0,0,0,0,1269,316,1585,35465,37050,-0.00106084,0.279855,-0.960042,1
0,0,0,0,0,1229,294,1523,37086,38609,0.00623401,0.210367,-0.977603,1
0,0,0,0,0,1274,248,1522,36924,38446,0.0198961,0.173051,-0.984712,1
0,0,0,0,0,1237,262,1499,34034,35533,0.0487059,0.140014,-0.988951,1
0,0,0,0,0,1473,267,1740,32233,33973,0.0654263,0.130313,-0.989312,1
0,0,0,0,0,1237,236,1473,33230,34703,0.0552818,0.120927,-0.991121,1
0,0,0,0,0,3633,630,4263,37063,41326,0.0637503,0.24775,-0.966724,1
0,0,0,0,0,1248,246,1494,31888,33382,0.0293653,0.20482,-0.978359,1
0,0,0,0,0,1255,244,1499,30402,31901,0.0263721,0.22292,-0.97448,1
0,0,0,0,0,1424,297,1721,29263,30984,0.0162643,0.239491,-0.970762,1
0,0,0,0,0,1244,281,1525,25467,26992,0.0206938,0.218471,-0.975624,1
0,0,0,0,0,1368,276,1644,20432,22076,0.0408675,0.25198,-0.966869,1
0,0,0,0,0,5623,885,6508,35500,42008,0.058633,0.315798,-0.947013,1
0,0,0,0,0,1311,237,1548,12846,14394,0.0538425,0.331552,-0.941899,1
0,0,0,0,0,1344,258,1602,7247,8849,0.058117,0.389066,-0.919375,1
0,0,0,0,0,6044,1095,7139,17755,24894,0.0188373,0.53393,-0.845319,1
0,0,0,0,0,3148,582,3730,4624,8354,0.00739276,0.582292,-0.812946,1
0,0,0,0,0,3515,660,4175,8773,12948,-0.0226571,0.679317,-0.733495,1
0,0,0,0,0,6039,1075,7114,-1000,-1000,-1,-1,-1,1
0,0,0,0,0,1893,380,2273,29722,31995,0.0124303,0.0815164,-0.996595,1
0,0,0,0,0,1315,246,1561,26629,28190,0.0208329,0.106685,-0.994074,1
0,0,0,0,0,1591,304,1895,29431,31326,0.0391567,0.0863229,-0.995498,1
0,0,0,0,0,1338,279,1617,29840,31457,0.0545629,0.0327945,-0.997972,1
0,0,0,0,0,1548,316,1864,29851,31715,0.0670748,-0.0163974,-0.997613,1
0,0,0,0,0,1521,329,1850,32646,34496,0.0617598,0.00459901,-0.99808,1
0,0,0,0,0,1375,270,1645,32547,34192,0.059672,0.00677426,-0.998195,1
0,0,0,0,0,1378,357,1735,33428,35163,0.055868,0.0268778,-0.998077,1
0,0,0,0,0,1576,280,1856,31757,33613,0.0681621,0.0110133,-0.997614,1
0,0,0,0,0,4388,720,5108,42960,48068,0.063723,0.0799173,-0.994763,1
0,0,0,0,0,1496,265,1761,33503,35264,0.0591506,0.0847212,-0.994647,1
0,0,0,0,0,1460,306,1766,31918,33684,0.068366,0.0467811,-0.996563,1
0,0,0,0,0,1586,305,1891,34825,36716,0.0356934,0.0700495,-0.996905,1
0,0,0,0,0,1624,316,1940,31757,33697,0.0445755,0.0818523,-0.995647,1
0,0,0,0,0,1569,308,1877,31740,33617,0.0270598,0.0866846,-0.995868,1
0,0,0,0,0,1551,288,1839,33014,34853,0.00764238,0.0810842,-0.996678,1
0,0,0,0,0,1620,307,1927,35062,36989,-0.00750674,0.0564382,-0.998378,1
0,0,0,0,0,1503,315,1818,34717,36535,-0.0161108,0.0402751,-0.999059,1
0,0,0,0,0,1737,340,2077,34657,36734,-0.0256308,0.0181351,-0.999507,1
0,0,0,0,0,1476,348,1824,34003,35827,-0.0298982,0.00149197,-0.999552,1
0,0,0,0,0,1813,498,2311,35542,37853,-0.0156994,-0.0259615,-0.99954,1
0,0,0,0,0,1455,279,1734,35636,37370,-0.00978029,-0.0206846,-0.999738,1
0,0,0,0,0,1449,295,1744,33280,35024,-0.00641984,-0.00405792,-0.999971,1
0,0,0,0,0,1564,373,1937,33928,35865,-0.00147825,-0.0266842,-0.999643,1
0,0,0,0,0,1422,299,1721,30532,32253,-0.0142197,0.00443085,-0.999889,1
0,0,0,0,0,1401,317,1718,30706,32424,-0.0118241,0.027068,-0.999564,1
0,0,0,0,0,1527,444,1971,30176,32147,-0.00214749,0.0673744,-0.997726,1
0,0,0,0,0,1385,251,1636,28906,30542,0.00422462,0.0681663,-0.997665,1
0,0,0,0,0,1549,288,1837,29727,31564,-0.0106896,0.0835248,-0.996448,1
0,0,0,0,0,1287,243,1530,26622,28152,-0.0274869,0.0714674,-0.997064,1
0,0,0,0,0,1314,246,1560,27698,29258,-0.0344582,0.0312724,-0.998917,1
0,0,0,0,0,1563,305,1868,28975,30843,-0.0345756,0.0282509,-0.999003,1
0,0,0,0,0,1389,264,1653,25999,27652,-0.0412839,0.0449335,-0.998137,1
0,0,0,0,0,1416,254,1670,19424,21094,-0.0519306,0.0844022,-0.995078,1
0,0,0,0,0,1359,235,1594,1795,3389,-0.0602383,0.138413,-0.988541,1
0,0,0,0,0,4183,782,4965,25978,30943,-0.0233233,0.17202,-0.984817,1
0,0,0,0,0,2613,473,3086,13854,16940,0.0138724,0.199446,-0.979811,1
0,0,0,0,0,2538,473,3011,14678,17689,0.0800451,0.239596,-0.967567,1
0,0,0,0,0,2503,441,2944,10905,13849,0.152271,0.323351,-0.933947,1
0,0,0,0,0,3010,570,3580,16374,19954,0.207361,0.354,-0.911968,1
0,0,0,0,0,2086,395,2481,10436,12917,0.216988,0.379629,-0.899332,1
0,0,0,0,0,4103,785,4888,25248,30136,0.190476,0.424725,-0.885058,1
0,0,0,0,0,2163,411,2574,15394,17968,0.170421,0.431015,-0.886106,1
0,0,0,0,0,2265,423,2688,15719,18407,0.15066,0.466465,-0.871614,1
0,0,0,0,0,2240,379,2619,10592,13211,0.160898,0.505446,-0.847724,1
0,0,0,0,0,3295,670,3965,23755,27720,0.190883,0.570199,-0.799023,1
0,0,0,0,0,2331,438,2769,15187,17956,0.196178,0.61293,-0.765396,1
0,0,0,0,0,1632,286,1918,-1000,-1000,-1,-1,-1,1
0,0,0,0,0,6668,1251,7919,28246,36165,-0.0556017,0.0714439,-0.995894,1
0,0,0,0,0,1730,333,2063,22081,24144,-0.0659119,0.0132288,-0.997738,1
0,0,0,0,0,1449,261,1710,30227,31937,-0.0738718,-0.0402283,-0.996456,1
0,0,0,0,0,1669,332,2001,29390,31391,-0.0701158,-0.0100648,-0.997488,1
0,0,0,0,0,1412,267,1679,34168,35847,-0.0547027,-0.0157748,-0.998378,1
0,0,0,0,0,1555,321,1876,35225,37101,-0.0414829,-0.00349884,-0.999133,1
0,0,0,0,0,1415,306,1721,34828,36549,-0.0344487,0.00992245,-0.999357,1
0,0,0,0,0,1342,279,1621,35118,36739,-0.0280608,0.0525339,-0.998225,1
0,0,0,0,0,1309,301,1610,35715,37325,-0.0261758,0.0977834,-0.994864,1
0,0,0,0,0,1319,247,1566,36263,37829,-0.0251088,0.115313,-0.993012,1
0,0,0,0,0,1388,552,1940,35700,37640,-0.0216124,0.17265,-0.984746,1
0,0,0,0,0,1244,281,1525,36540,38065,-0.0269508,0.186605,-0.982065,1
0,0,0,0,0,1267,310,1577,37016,38593,-0.0251315,0.173042,-0.984594,1
0,0,0,0,0,1429,353,1782,34365,36147,-0.0176724,0.181574,-0.983219,1
0,0,0,0,0,1245,335,1580,35207,36787,-0.027582,0.132031,-0.990862,1
0,0,0,0,0,1467,274,1741,34626,36367,-0.0322952,0.133304,-0.990549,1
0,0,0,0,0,1248,269,1517,25222,26739,-0.0100543,0.167005,-0.985905,1
0,0,0,0,0,1248,289,1537,32209,33746,0.0148622,0.21535,-0.976424,1
0,0,0,0,0,1261,341,1602,29821,31423,0.0276667,0.288783,-0.956995,1
0,0,0,0,0,1255,271,1526,27721,29247,0.0107092,0.297232,-0.954745,1
0,0,0,0,0,1272,238,1510,23612,25122,0.00457189,0.313999,-0.949412,1
0,0,0,0,0,1456,337,1793,19338,21131,0.0152995,0.354019,-0.935113,1
0,0,0,0,0,1533,282,1815,14468,16283,0.0239317,0.353993,-0.934942,1
0,0,0,0,0,2076,380,2456,10319,12775,0.0453176,0.401026,-0.914945,1
0,0,0,0,0,6087,1085,7172,16071,23243,0.0767257,0.464173,-0.882415,1
0,0,0,0,0,2578,461,3039,9373,12412,0.0904437,0.487275,-0.868552,1
0,0,0,0,0,2738,487,3225,10913,14138,0.0993454,0.533228,-0.840118,1
0,0,0,0,0,3833,663,4496,15212,19708,0.107937,0.599672,-0.792933,1
0,0,0,0,0,3075,509,3584,12106,15690,0.110233,0.672881,-0.731492,1
0,0,0,0,0,2853,491,3344,-1000,-1000,-1,-1,-1,1
0,0,0,0,0,3025,612,3637,49984,53621,-0.034197,0.285335,-0.957818,1
0,0,0,0,0,1455,287,1742,27873,29615,-0.0536256,0.353769,-0.933794,1
0,0,0,0,0,1498,253,1751,27015,28766,-0.0685307,0.380944,-0.922055,1
0,0,0,0,0,1512,266,1778,27835,29613,-0.0657929,0.377557,-0.923646,1
0,0,0,0,0,1738,308,2046,32844,34890,-0.0486972,0.378736,-0.924223,1
0,0,0,0,0,1576,309,1885,31863,33748,-0.0374907,0.354018,-0.934487,1
0,0,0,0,0,1582,277,1859,29644,31503,-0.0354562,0.370606,-0.928113,1
0,0,0,0,0,1642,270,1912,26328,28240,-0.0511725,0.364749,-0.929699,1
0,0,0,0,0,1622,274,1896,30771,32667,-0.0709986,0.313209,-0.947026,1
0,0,0,0,0,1613,336,1949,30505,32454,-0.080404,0.277512,-0.957352,1
0,0,0,0,0,1515,295,1810,31999,33809,-0.0779583,0.21036,-0.974511,1
0,0,0,0,0,1495,306,1801,31781,33582,-0.0701317,0.176096,-0.981872,1
0,0,0,0,0,1445,257,1702,33651,35353,-0.0471817,0.108636,-0.992961,1
0,0,0,0,0,1411,254,1665,33463,35128,-0.0552111,0.0597513,-0.996685,1
0,0,0,0,0,1469,333,1802,32231,34033,-0.0593247,0.0483864,-0.997065,1
0,0,0,0,0,1332,357,1689,32165,33854,-0.0639158,0.041174,-0.997106,1
0,0,0,0,0,1301,274,1575,29138,30713,-0.0627929,0.0854774,-0.99436,1
0,0,0,0,0,1280,301,1581,28887,30468,-0.0557294,0.0649243,-0.996333,1
0,0,0,0,0,1261,241,1502,27081,28583,-0.0573374,0.0652207,-0.996222,1
0,0,0,0,0,1290,323,1613,25224,26837,-0.0665281,0.0828485,-0.994339,1
0,0,0,0,0,1305,234,1539,16816,18355,-0.0617539,0.0889378,-0.994121,1
0,0,0,0,0,1376,249,1625,6805,8430,-0.0358073,0.0651959,-0.99723,1
0,0,0,0,0,2645,459,3104,14628,17732,0.0422354,0.0143668,-0.999004,1
0,0,0,0,0,2666,475,3141,13917,17058,0.0560588,0.0634937,-0.996407,1
0,0,0,0,0,3100,546,3646,15572,19218,0.111697,0.0447167,-0.992736,1
0,0,0,0,0,1869,241,2110,6306,8416,0.118987,0.0840771,-0.98933,1
0,0,0,0,0,3769,714,4483,17005,21488,0.107684,0.222237,-0.969028,1
0,0,0,0,0,3934,726,4660,17066,21726,0.106659,0.301024,-0.947633,1
0,0,0,0,0,2197,402,2599,10500,13099,0.131714,0.369837,-0.919713,1
0,0,0,0,0,2912,525,3437,14799,18236,0.170728,0.453307,-0.874851,1
0,0,0,0,0,2376,437,2813,11486,14299,0.177735,0.51253,-0.840074,1
0,0,0,0,0,3953,710,4663,22323,26986,0.170086,0.599317,-0.782234,1
0,0,0,0,0,2355,411,2766,11055,13821,0.158411,0.630446,-0.759897,1
0,0,0,0,0,1762,297,2059,10642,12701,0.139519,0.681883,-0.718032,1
0,0,0,0,0,3182,581,3763,-1000,-1000,-1,-1,-1,1
0,0,0,0,0,1697,326,2023,26065,28088,-0.0692341,-0.0690852,-0.995205,1
0,0,0,0,0,1406,263,1669,32628,34297,-0.0714757,-0.0857991,-0.993745,1
0,0,0,0,0,1799,275,2074,34233,36307,-0.0498032,-0.0556947,-0.997205,1
0,0,0,0,0,1407,268,1675,34496,36171,-0.0359575,-0.0673761,-0.997079,1
0,0,0,0,0,1684,274,1958,35092,37050,-0.0288855,-0.0655353,-0.997432,1
0,0,0,0,0,1394,266,1660,34108,35768,-0.0387477,-0.0736916,-0.996528,1
0,0,0,0,0,1369,296,1665,35967,37632,-0.0387665,-0.0495858,-0.998017,1
0,0,0,0,0,6275,1254,7529,56408,63937,-0.0501856,0.193792,-0.979758,1
0,0,0,0,0,1330,311,1641,36743,38384,-0.0657395,0.218108,-0.973708,1
0,0,0,0,0,1316,260,1576,36532,38108,-0.0626284,0.236151,-0.969696,1
0,0,0,0,0,1337,295,1632,35490,37122,-0.0575369,0.314843,-0.947398,1
0,0,0,0,0,1276,286,1562,35523,37085,-0.049886,0.361568,-0.93101,1
0,0,0,0,0,1222,287,1509,29173,30682,-0.0424833,0.238849,-0.970127,1
0,0,0,0,0,1280,248,1528,22963,24491,-0.0496426,0.131832,-0.990028,1
0,0,0,0,0,1394,255,1649,14871,16520,-0.0555154,0.106337,-0.992779,1
0,0,0,0,0,1757,276,2033,37033,39066,0.011894,-0.0197759,-0.999734,1
0,0,0,0,0,1261,245,1506,21601,23107,0.0334691,0.069458,-0.997023,1
0,0,0,0,0,1239,425,1664,25165,26829,0.0638762,0.189775,-0.979747,1
0,0,0,0,0,1243,269,1512,28340,29852,0.0860518,0.081222,-0.992974,1
0,0,0,0,0,1272,238,1510,27167,28677,0.119677,0.192604,-0.973952,1
0,0,0,0,0,6039,1055,7094,48789,55883,0.160901,0.483747,-0.860291,1
0,0,0,0,0,1436,251,1687,23006,24693,0.146311,0.453992,-0.878912,1
0,0,0,0,0,1456,286,1742,14848,16590,0.152805,0.465629,-0.871688,1
0,0,0,0,0,1456,312,1768,14582,16350,0.133999,0.475462,-0.869471,1
0,0,0,0,0,3755,654,4409,11940,16349,0.157384,0.526682,-0.835366,1
0,0,0,0,0,2095,371,2466,14947,17413,0.137334,0.576322,-0.805601,1
0,0,0,0,0,6552,1135,7687,22707,30394,0.133687,0.659799,-0.739454,1
0,0,0,0,0,1678,306,1984,6331,8315,0.136605,0.673122,-0.726805,1
0,0,0,0,0,1563,267,1830,-1000,-1000,-1,-1,-1,1
0,0,0,0,0,3485,701,4186,45351,49537,-0.0350245,0.237983,-0.970638,1
0,0,0,0,0,1436,253,1689,21277,22966,-0.0401808,0.321837,-0.945942,1
0,0,0,0,0,1370,268,1638,21593,23231,-0.0469319,0.435632,-0.898901,1
0,0,0,0,0,1575,273,1848,24253,26101,-0.034364,0.489317,-0.871429,1
0,0,0,0,0,1467,293,1760,24411,26171,-0.00780799,0.503732,-0.863825,1
0,0,0,0,0,1646,300,1946,28836,30782,0.00872516,0.476113,-0.879341,1
0,0,0,0,0,1560,273,1833,30398,32231,0.00779526,0.449027,-0.893484,1
0,0,0,0,0,1517,300,1817,25885,27702,-0.0011706,0.417878,-0.908502,1
0,0,0,0,0,1541,270,1811,30113,31924,-0.00676777,0.361603,-0.932307,1
0,0,0,0,0,1570,321,1891,24683,26574,-0.00239848,0.329566,-0.94413,1
0,0,0,0,0,1459,334,1793,28591,30384,0.0316324,0.289858,-0.956547,1
0,0,0,0,0,1541,413,1954,35749,37703,0.0251245,0.0955638,-0.995106,1
0,0,0,0,0,1437,270,1707,35362,37069,0.00484638,0.0705869,-0.997494,1
0,0,0,0,0,1421,280,1701,35424,37125,-0.03176,0.011305,-0.999432,1
0,0,0,0,0,1534,264,1798,35513,37311,-0.0438592,0.0404327,-0.998219,1
0,0,0,0,0,1388,255,1643,34629,36272,-0.0633269,0.0890674,-0.994011,1
0,0,0,0,0,1341,307,1648,32579,34227,-0.0678876,0.110728,-0.99153,1
0,0,0,0,0,1370,260,1630,32954,34584,-0.0566111,0.132237,-0.9896,1
0,0,0,0,0,1290,243,1533,32693,34226,-0.0460519,0.132146,-0.99016,1
0,0,0,0,0,1585,271,1856,31100,32956,-0.0235824,0.120807,-0.992396,1
0,0,0,0,0,1477,270,1747,26800,28547,-0.0115154,0.105682,-0.994333,1
0,0,0,0,0,5477,890,6367,32848,39215,-0.0580888,0.199904,-0.978092,1
0,0,0,0,0,1915,293,2208,9834,12042,-0.0535156,0.189839,-0.980356,1
0,0,0,0,0,1311,224,1535,4972,6507,-0.104761,0.142536,-0.98423,1
0,0,0,0,0,1272,234,1506,5647,7153,-0.134097,0.163695,-0.977355,1
0,0,0,0,0,2245,410,2655,12207,14862,-0.152029,0.160118,-0.97532,1
0,0,0,0,0,5342,965,6307,23650,29957,-0.148469,0.223702,-0.963283,1
0,0,0,0,0,1809,305,2114,10266,12380,-0.155294,0.228059,-0.961183,1
0,0,0,0,0,1442,264,1706,7836,9542,-0.160293,0.306852,-0.938162,1
0,0,0,0,0,2692,581,3273,20821,24094,-0.158084,0.351003,-0.922933,1
0,0,0,0,0,3159,576,3735,18070,21805,-0.141521,0.405113,-0.903247,1
0,0,0,0,0,2231,412,2643,13080,15723,-0.116243,0.450013,-0.885424,1
0,0,0,0,0,2546,476,3022,15747,18769,-0.084954,0.512155,-0.854682,1
0,0,0,0,0,2125,399,2524,14437,16961,-0.0693366,0.570156,-0.818606,1
0,0,0,0,0,2068,379,2447,11504,13951,-0.0422076,0.653716,-0.755562,1
0,0,0,0,0,2643,463,3106,-1000,-1000,-1,-1,-1,1
0,0,0,0,0,5937,1042,6979,25468,32447,-0.00402348,0.0362786,-0.999333,1
0,0,0,0,0,1413,353,1766,22966,24732,-0.0218673,-0.0160048,-0.999633,1
0,0,0,0,0,1577,292,1869,31875,33744,-0.0259007,-0.0531138,-0.998253,1
0,0,0,0,0,1639,391,2030,33994,36024,-0.0349547,-0.0521979,-0.998025,1
0,0,0,0,0,1365,276,1641,35759,37400,-0.0482661,-0.0367244,-0.998159,1
0,0,0,0,0,1401,270,1671,35899,37570,-0.055998,-0.0216599,-0.998196,1
0,0,0,0,0,1326,267,1593,35817,37410,-0.0572493,0.0470685,-0.99725,1
0,0,0,0,0,1347,284,1631,36053,37684,-0.0508408,0.0757509,-0.99583,1
0,0,0,0,0,1310,249,1559,36508,38067,-0.0367905,0.14144,-0.989263,1
0,0,0,0,0,1211,267,1478,36659,38137,-0.0232895,0.135881,-0.990451,1
0,0,0,0,0,1188,238,1426,35817,37243,-0.0224152,0.0956316,-0.995165,1
0,0,0,0,0,1212,345,1557,34977,36534,0.0212156,0.331154,-0.943338,1
0,0,0,0,0,1193,263,1456,33793,35249,0.0382025,0.376998,-0.925426,1
0,0,0,0,0,1209,238,1447,23192,24639,-0.00276291,0.2202,-0.975451,1
0,0,0,0,0,5297,1007,6304,54681,60985,-0.0369579,0.35063,-0.935785,1
0,0,0,0,0,1237,265,1502,31604,33106,-0.0369307,0.330582,-0.943055,1
0,0,0,0,0,1228,282,1510,30127,31637,-0.0212124,0.3551,-0.934588,1
0,0,0,0,0,1257,229,1486,28735,30221,-0.000892175,0.38421,-0.923245,1
0,0,0,0,0,1277,266,1543,26023,27566,-0.00330982,0.351152,-0.936313,1
0,0,0,0,0,1411,359,1770,20931,22701,0.0250256,0.33064,-0.943425,1
0,0,0,0,0,4890,883,5773,28562,34335,0.0851788,0.393422,-0.915404,1
0,0,0,0,0,1325,320,1645,7304,8949,0.101743,0.410097,-0.906349,1
0,0,0,0,0,1798,299,2097,9024,11121,0.114429,0.512853,-0.850816,1
0,0,0,0,0,5645,964,6609,17712,24321,0.0993563,0.590681,-0.800765,1
0,0,0,0,0,3789,676,4465,14625,19090,0.149797,0.644413,-0.749862,1
0,0,0,0,0,3124,530,3654,11281,14935,0.120416,0.629191,-0.767866,1
0,0,0,0,0,1857,334,2191,5984,8175,0.128958,0.637034,-0.759972,1
0,0,0,0,0,1796,322,2118,6517,8635,0.144013,0.667784,-0.730291,1
0,0,0,0,0,5504,1094,6598,-1000,-1000,-1,-1,-1,1
0,0,0,0,0,2502,508,3010,38410,41420,0.00139729,0.215799,-0.976437,1
0,0,0,0,0,1396,293,1689,30548,32237,-0.0103056,0.271647,-0.962342,1
0,0,0,0,0,1716,305,2021,30946,32967,-0.0194738,0.322033,-0.946528,1
0,0,0,0,0,1475,274,1749,32186,33935,-0.0195877,0.302924,-0.952814,1
0,0,0,0,0,1497,313,1810,34265,36075,-0.0100032,0.259074,-0.965806,1
0,0,0,0,0,1510,390,1900,35348,37248,-0.00315393,0.187157,-0.982325,1
0,0,0,0,0,1505,324,1829,34415,36244,-0.00149482,0.180259,-0.983618,1
0,0,0,0,0,1493,311,1804,34636,36440,-0.000609848,0.128418,-0.99172,1
0,0,0,0,0,2594,460,3054,48629,51683,-0.00235778,0.231731,-0.972777,1
0,0,0,0,0,1453,262,1715,35221,36936,-0.00716792,0.135297,-0.990779,1
0,0,0,0,0,1394,379,1773,34035,35808,-0.0169751,0.142036,-0.989716,1
0,0,0,0,0,1344,278,1622,31153,32775,-0.0181878,0.163097,-0.986442,1
0,0,0,0,0,1329,241,1570,31058,32628,-0.00541049,0.122399,-0.992466,1
0,0,0,0,0,1292,238,1530,29405,30935,-0.0084157,0.0622103,-0.998028,1
0,0,0,0,0,1285,319,1604,27343,28947,-0.00209109,0.0699977,-0.997545,1
0,0,0,0,0,1561,278,1839,26501,28340,-0.0137668,0.0414922,-0.999044,1
0,0,0,0,0,1265,290,1555,23435,24990,-0.0267729,0.0615562,-0.997744,1
0,0,0,0,0,1594,283,1877,15658,17535,-0.0349449,0.064584,-0.9973,1
0,0,0,0,0,1654,290,1944,6640,8584,-0.0291782,0.104103,-0.994138,1
0,0,0,0,0,5663,929,6592,20233,26825,0.0117971,0.198297,-0.980071,1
0,0,0,0,0,2253,387,2640,10476,13116,0.0454094,0.182514,-0.982154,1
0,0,0,0,0,1969,343,2312,10378,12690,0.073392,0.179256,-0.981061,1
0,0,0,0,0,5471,1061,6532,25442,31974,0.105037,0.189332,-0.976279,1
0,0,0,0,0,1699,317,2016,8915,10931,0.0927416,0.228355,-0.969151,1
0,0,0,0,0,5966,933,6899,23798,30697,0.072513,0.362745,-0.929063,1
0,0,0,0,0,2188,299,2487,11414,13901,0.0659584,0.412541,-0.908548,1
0,0,0,0,0,1528,283,1811,11332,13143,0.0695326,0.485648,-0.871385,1
0,0,0,0,0,6045,1107,7152,25260,32412,0.0745288,0.635277,-0.768679,1
0,0,0,0,0,1876,346,2222,11386,13608,0.0754587,0.658233,-0.749023,1
0,0,0,0,0,5624,998,6622,-1000,-1000,-1,-1,-1,1
0,0,0,0,0,1454,281,1735,18600,20335,-0.00644565,-0.0258266,-0.999646,1
0,0,0,0,0,1496,288,1784,19038,20822,-0.0104712,-0.0435833,-0.998995,1
0,0,0,0,0,1355,316,1671,21588,23259,-0.0233025,-0.0564276,-0.998135,1
0,0,0,0,0,1528,283,1811,19987,21798,-0.0371588,-0.0408367,-0.998475,1
0,0,0,0,0,1811,323,2134,35656,37790,-0.0562156,-0.0986374,-0.993534,1
0,0,0,0,0,1365,316,1681,32499,34180,-0.0579563,-0.0926067,-0.994015,1
0,0,0,0,0,1412,377,1789,33473,35262,-0.0573759,-0.121935,-0.990878,1
0,0,0,0,0,1402,280,1682,34782,36464,-0.0513087,-0.102195,-0.99344,1
0,0,0,0,0,1417,269,1686,34831,36517,-0.0427966,-0.109532,-0.993062,1
0,0,0,0,0,1523,304,1827,35236,37063,-0.0314139,-0.0824047,-0.996104,1
0,0,0,0,0,1348,287,1635,35370,37005,-0.0428113,-0.0614745,-0.99719,1
0,0,0,0,0,1298,310,1608,35596,37204,-0.0389411,-0.00553586,-0.999226,1
0,0,0,0,0,1449,257,1706,35668,37374,-0.0502426,-0.0118559,-0.998667,1
0,0,0,0,0,1223,241,1464,35955,37419,-0.0379266,0.0393303,-0.998506,1
0,0,0,0,0,1352,238,1590,36430,38020,-0.0213804,0.028941,-0.999353,1
0,0,0,0,0,1294,298,1592,36513,38105,-0.00318771,0.0218479,-0.999756,1
0,0,0,0,0,1164,229,1393,36562,37955,0.0196252,0.0694457,-0.997393,1
0,0,0,0,0,1172,289,1461,36746,38207,0.0110459,0.0344426,-0.999346,1
0,0,0,0,0,1260,232,1492,35014,36506,0.0162117,0.0433175,-0.99893,1
0,0,0,0,0,1673,317,1990,31853,33843,0.0509795,0.168029,-0.984463,1
0,0,0,0,0,1218,244,1462,30796,32258,0.0777424,0.138188,-0.98735,1
0,0,0,0,0,1193,226,1419,30419,31838,0.105513,0.143821,-0.983963,1
0,0,0,0,0,1195,223,1418,15744,17162,0.123733,0.232451,-0.964705,1
0,0,0,0,0,1259,290,1549,9611,11160,0.131644,0.282294,-0.950253,1
0,0,0,0,0,4961,932,5893,46868,52761,0.105953,0.351222,-0.930278,1
0,0,0,0,0,1268,361,1629,20924,22553,0.0764288,0.332054,-0.940159,1
0,0,0,0,0,1268,225,1493,11985,13478,0.0663947,0.362952,-0.929439,1
0,0,0,0,0,1861,336,2197,13722,15919,0.0462453,0.398764,-0.915887,1
0,0,0,0,0,2702,492,3194,9537,12731,0.0771873,0.499954,-0.862605,1
0,0,0,0,0,3939,681,4620,20425,25045,0.105747,0.58477,-0.804277,1
0,0,0,0,0,2495,430,2925,12237,15162,0.105057,0.664407,-0.73995,1
0,0,0,0,0,2636,433,3069,-1000,-1000,-1,-1,-1,1
0,0,0,0,0,2231,430,2661,39077,41738,0.0430622,0.177862,-0.983113,1
0,0,0,0,0,1495,314,1809,24724,26533,0.0571642,0.200733,-0.977977,1
0,0,0,0,0,1473,303,1776,31885,33661,0.0645953,0.208044,-0.975984,1
0,0,0,0,0,1425,253,1678,32536,34214,0.0712574,0.175154,-0.981959,1
0,0,0,0,0,1522,343,1865,23874,25739,0.0750788,0.141652,-0.987065,1
0,0,0,0,0,1361,282,1643,34379,36022,0.0303584,0.0586039,-0.99782,1
0,0,0,0,0,2804,505,3309,37448,40757,0.0250552,0.0436694,-0.998732,1
0,0,0,0,0,1373,241,1614,34595,36209,0.0157932,-0.000853536,-0.999875,1
0,0,0,0,0,1533,247,1780,35003,36783,0.0176423,-0.0357281,-0.999206,1
0,0,0,0,0,1327,327,1654,35053,36707,0.0253074,-0.0319867,-0.999168,1
0,0,0,0,0,1328,271,1599,33393,34992,0.0321258,-0.0317543,-0.99898,1
0,0,0,0,0,1585,273,1858,33849,35707,0.0205495,-0.0116009,-0.999721,1
0,0,0,0,0,1318,283,1601,33105,34706,0.0130322,0.0180173,-0.999753,1
0,0,0,0,0,1297,272,1569,32627,34196,0.0110166,0.0400768,-0.999136,1
0,0,0,0,0,1335,293,1628,32207,33835,0.01297,0.0433613,-0.998975,1
0,0,0,0,0,1268,230,1498,31255,32753,0.019205,0.0754068,-0.996968,1
0,0,0,0,0,1343,265,1608,29903,31511,0.0309183,0.108944,-0.993567,1
0,0,0,0,0,1277,224,1501,29182,30683,0.0317237,0.0960899,-0.994867,1
0,0,0,0,0,1320,233,1553,29542,31095,0.0350973,0.0912641,-0.995208,1
0,0,0,0,0,5601,1017,6618,42507,49125,0.0672256,0.159728,-0.98487,1
0,0,0,0,0,1228,225,1453,25825,27278,0.0438598,0.120859,-0.9917,1
0,0,0,0,0,1178,274,1452,25814,27266,0.0391523,0.0619918,-0.997308,1
0,0,0,0,0,1273,242,1515,24838,26353,0.0305604,0.037839,-0.998817,1
0,0,0,0,0,1242,265,1507,24358,25865,0.0258793,0.0359001,-0.99902,1
0,0,0,0,0,1482,298,1780,24587,26367,0.0185344,0.0262214,-0.999484,1
0,0,0,0,0,1284,228,1512,23957,25469,0.00997982,0.0484861,-0.998774,1
0,0,0,0,0,1176,216,1392,17261,18653,-0.000136285,0.0647549,-0.997901,1
0,0,0,0,0,1229,211,1440,5468,6908,0.018732,0.0950516,-0.995296,1
0,0,0,0,0,5162,937,6099,31995,38094,0.0970655,0.143508,-0.984878,1
0,0,0,0,0,2032,333,2365,11042,13407,0.123629,0.115096,-0.985631,1
0,0,0,0,0,1263,225,1488,8937,10425,0.16408,0.066824,-0.984181,1
0,0,0,0,0,1161,214,1375,7021,8396,0.186072,0.105243,-0.976884,1
0,0,0,0,0,1566,297,1863,11468,13331,0.196079,0.160447,-0.967373,1
0,0,0,0,0,3973,776,4749,24979,29728,0.194245,0.284774,-0.938708,1
0,0,0,0,0,2411,462,2873,17636,20509,0.206003,0.313838,-0.92686,1
0,0,0,0,0,1517,293,1810,12593,14403,0.208817,0.344734,-0.91518,1
0,0,0,0,0,2208,425,2633,15178,17811,0.189905,0.438024,-0.878676,1
0,0,0,0,0,2620,519,3139,20574,23713,0.171428,0.49304,-0.85295,1
0,0,0,0,0,1643,310,1953,3001,4954,0.162636,0.507071,-0.846421,1
0,0,0,0,0,5319,994,6313,31112,37425,0.122412,0.567206,-0.814428,1
0,0,0,0,0,2094,346,2440,15188,17628,0.121131,0.590426,-0.79795,1
0,0,0,0,0,1493,278,1771,11814,13585,0.109515,0.614212,-0.781505,1
0,0,0,0,0,2030,378,2408,18467,20875,0.101157,0.642978,-0.759175,1
0,0,0,0,0,2377,427,2804,20252,23056,0.104594,0.662466,-0.741754,1
0,0,0,0,0,1753,342,2095,16295,18390,0.112822,0.671052,-0.732776,1
0,0,0,0,0,1598,292,1890,12240,14130,0.103589,0.687131,-0.719111,1
0,0,0,0,0,2351,429,2780,-1000,-1000,-1,-1,-1,1
0,0,0,0,0,6218,785,7003,34053,41056,-0.0176744,0.0304095,-0.999381,1
0,0,0,0,0,1422,272,1694,24603,26297,-0.021277,-0.00412998,-0.999765,1
0,0,0,0,0,1392,263,1655,19190,20845,-0.0174027,0.01905,-0.999667,1
0,0,0,0,0,1523,296,1819,25587,27406,-0.0241119,0.0321013,-0.999194,1
0,0,0,0,0,1334,264,1598,32044,33642,-0.0499018,0.0151876,-0.998639,1
0,0,0,0,0,1400,306,1706,32896,34602,-0.0592118,0.00973358,-0.998198,1
0,0,0,0,0,1331,324,1655,34765,36420,-0.0593291,0.031869,-0.99773,1
0,0,0,0,0,1386,289,1675,34540,36215,-0.0531844,0.0227693,-0.998325,1
0,0,0,0,0,1315,248,1563,34264,35827,-0.0414381,0.0193908,-0.998953,1
0,0,0,0,0,1247,247,1494,34670,36164,-0.0236293,0.0290337,-0.999299,1
0,0,0,0,0,1220,245,1465,34778,36243,-0.0235209,0.00675963,-0.999701,1
0,0,0,0,0,1568,269,1837,35810,37647,-0.0195364,0.00201704,-0.999807,1
0,0,0,0,0,1206,240,1446,35500,36946,-0.0223459,-0.00433555,-0.999741,1
0,0,0,0,0,1191,265,1456,35831,37287,-0.0263386,-0.0120283,-0.999581,1
0,0,0,0,0,1185,232,1417,36141,37558,-0.029444,-0.00845155,-0.999531,1
0,0,0,0,0,1239,231,1470,36126,37596,-0.031388,-0.00597059,-0.99949,1
0,0,0,0,0,1370,285,1655,34906,36561,-0.0207802,0.0221215,-0.999539,1
0,0,0,0,0,1178,239,1417,25733,27150,-0.0362517,0.013823,-0.999247,1
0,0,0,0,0,1202,232,1434,34295,35729,-0.0313726,0.00385737,-0.9995,1
0,0,0,0,0,1180,231,1411,21811,23222,-0.0253744,0.0290733,-0.999255,1
0,0,0,0,0,3070,599,3669,47246,50915,0.0360775,0.0498133,-0.998107,1
0,0,0,0,0,1228,226,1454,34490,35944,0.0553174,0.0451921,-0.997445,1
0,0,0,0,0,1188,249,1437,31666,33103,0.0934239,0.097736,-0.990817,1
0,0,0,0,0,1179,225,1404,30476,31880,0.129351,0.196896,-0.971854,1
0,0,0,0,0,1560,242,1802,28843,30645,0.156929,0.265812,-0.951166,1
0,0,0,0,0,1224,254,1478,26366,27844,0.139775,0.266087,-0.953761,1
0,0,0,0,0,1210,226,1436,22229,23665,0.111809,0.293871,-0.949283,1
0,0,0,0,0,1266,225,1491,18514,20005,0.081661,0.37163,-0.924783,1
0,0,0,0,0,1861,329,2190,10526,12716,0.0659598,0.440021,-0.895562,1
0,0,0,0,0,1665,317,1982,6572,8554,0.0702081,0.492156,-0.867671,1
0,0,0,0,0,7141,1124,8265,20328,28593,0.100353,0.634539,-0.766348,1
0,0,0,0,0,2137,347,2484,7306,9790,0.0847347,0.641611,-0.762335,1
0,0,0,0,0,1580,289,1869,6292,8161,0.0661165,0.689014,-0.721726,1
0,0,0,0,0,6071,1047,7118,-1000,-1000,-1,-1,-1,1
0,0,0,0,0,2194,425,2619,31616,34235,0.00628614,0.102225,-0.994741,1
0,0,0,0,0,1347,257,1604,26890,28494,0.0247125,0.156936,-0.9873,1
0,0,0,0,0,1425,268,1693,26498,28191,0.0651383,0.218281,-0.97371,1
0,0,0,0,0,1272,240,1512,27732,29244,0.0832605,0.209702,-0.974214,1
0,0,0,0,0,1275,258,1533,29962,31495,0.083504,0.203678,-0.975471,1
0,0,0,0,0,1334,367,1701,32212,33913,0.0646431,0.226054,-0.971968,1
0,0,0,0,0,1375,294,1669,33851,35520,0.00926622,0.281791,-0.959431,1
0,0,0,0,0,1426,307,1733,34531,36264,-0.0302413,0.262931,-0.964341,1
0,0,0,0,0,2850,591,3441,43548,46989,-0.0443985,0.391591,-0.919068,1
0,0,0,0,0,1434,303,1737,28215,29952,-0.0327925,0.382041,-0.923563,1
0,0,0,0,0,1544,309,1853,29953,31806,-0.0198782,0.3335,-0.94254,1
0,0,0,0,0,1450,336,1786,31253,33039,-0.00738177,0.267536,-0.96352,1
0,0,0,0,0,1555,327,1882,34966,36848,0.015973,0.104127,-0.994436,1
0,0,0,0,0,1446,299,1745,34487,36232,0.0258913,0.0684146,-0.997321,1
0,0,0,0,0,1386,292,1678,33664,35342,0.0355891,0.0736466,-0.996649,1
0,0,0,0,0,1364,241,1605,32725,34330,0.0355744,0.0480965,-0.998209,1
0,0,0,0,0,1361,305,1666,31761,33427,0.0325623,0.0523998,-0.998095,1
0,0,0,0,0,1379,245,1624,30289,31913,0.0442624,0.0642254,-0.996953,1
0,0,0,0,0,1345,316,1661,31445,33106,0.0273494,0.0608594,-0.997772,1
0,0,0,0,0,1336,240,1576,31063,32639,0.00660747,0.0660941,-0.997792,1
0,0,0,0,0,1362,238,1600,29777,31377,-0.000717436,0.0668833,-0.997761,1
0,0,0,0,0,1295,238,1533,27389,28922,-0.0120355,0.113063,-0.993515,1
0,0,0,0,0,5442,991,6433,43943,50376,-0.0455858,0.185152,-0.981652,1
0,0,0,0,0,1295,256,1551,15120,16671,-0.039007,0.151645,-0.987665,1
0,0,0,0,0,1214,210,1424,3314,4738,-0.0822426,0.121458,-0.989184,1
0,0,0,0,0,1943,336,2279,8472,10751,-0.103947,0.0969245,-0.989849,1
0,0,0,0,0,5534,992,6526,20364,26890,-0.082873,0.182889,-0.979635,1
0,0,0,0,0,1944,363,2307,9647,11954,-0.0356238,0.199032,-0.979345,1
0,0,0,0,0,2026,374,2400,5178,7578,0.00996533,0.261158,-0.965245,1
0,0,0,0,0,5635,1093,6728,14197,20925,0.0705185,0.344546,-0.936117,1
0,0,0,0,0,3018,591,3609,17024,20633,0.0827199,0.393357,-0.915657,1
0,0,0,0,0,1814,356,2170,14059,16229,0.0930448,0.455864,-0.885173,1
0,0,0,0,0,5975,1071,7046,19906,26952,0.0895533,0.536961,-0.83884,1
0,0,0,0,0,1936,364,2300,9234,11534,0.0830302,0.547366,-0.832764,1
0,0,0,0,0,1952,360,2312,5817,8129,0.0671054,0.590228,-0.804443,1
0,0,0,0,0,5771,1072,6843,26084,32927,0.0389983,0.675347,-0.736468,1
0,0,0,0,0,2101,348,2449,13290,15739,0.0374218,0.68469,-0.727873,1
0,0,0,0,0,1556,283,1839,-1000,-1000,-1,-1,-1,1
0,0,0,0,0,2029,408,2437,28100,30537,-0.0175959,0.0750509,-0.997025,1
0,0,0,0,0,1661,300,1961,27517,29478,-0.0067664,0.0471091,-0.998867,1
0,0,0,0,0,1406,277,1683,27195,28878,-0.00293545,0.0637788,-0.99796,1
0,0,0,0,0,1501,296,1797,32143,33940,-0.0167339,0.0301618,-0.999405,1
0,0,0,0,0,1397,306,1703,32543,34246,-0.00333939,0.0383795,-0.999258,1
0,0,0,0,0,1360,264,1624,33430,35054,-0.000215661,0.0779682,-0.996956,1
0,0,0,0,0,2853,509,3362,40436,43798,-0.00865873,0.166435,-0.986014,1
0,0,0,0,0,1231,268,1499,34418,35917,-0.0166397,0.122979,-0.99227,1
0,0,0,0,0,1272,300,1572,34969,36541,-0.0140688,0.183495,-0.98292,1
0,0,0,0,0,1266,222,1488,35232,36720,-0.0115992,0.193402,-0.981051,1
0,0,0,0,0,1238,309,1547,35534,37081,-0.0076149,0.200319,-0.979701,1
0,0,0,0,0,1185,226,1411,36130,37541,-0.00571517,0.197296,-0.980327,1
0,0,0,0,0,1237,228,1465,35901,37366,-0.00814324,0.191307,-0.981496,1
0,0,0,0,0,3595,553,4148,44049,48197,0.00606983,0.268012,-0.963397,1
0,0,0,0,0,1202,255,1457,33875,35332,0.00624571,0.256449,-0.966538,1
0,0,0,0,0,1207,237,1444,34451,35895,-0.00495575,0.249038,-0.968481,1
0,0,0,0,0,1207,264,1471,31931,33402,-0.0360228,0.254177,-0.966487,1
0,0,0,0,0,1206,259,1465,29968,31433,-0.0507892,0.26249,-0.963597,1
0,0,0,0,0,1361,277,1638,30053,31691,-0.0393333,0.250468,-0.967326,1
0,0,0,0,0,1245,229,1474,28953,30427,-0.0287928,0.222224,-0.97457,1
0,0,0,0,0,1307,255,1562,29490,31052,-0.0181,0.199556,-0.97972,1
0,0,0,0,0,1199,228,1427,29072,30499,-0.019457,0.189916,-0.981608,1
0,0,0,0,0,1202,230,1432,28757,30189,-0.03103,0.190699,-0.981158,1
0,0,0,0,0,1322,393,1715,38934,40649,-0.0362886,0.200167,-0.97909,1
0,0,0,0,0,1360,246,1606,27647,29253,-0.0352748,0.20301,-0.978541,1
0,0,0,0,0,1425,254,1679,28938,30617,-0.029576,0.210577,-0.97713,1
0,0,0,0,0,1437,244,1681,29335,31016,-0.0221116,0.22807,-0.973394,1
0,0,0,0,0,1247,223,1470,28314,29784,-0.0138202,0.260615,-0.965344,1
0,0,0,0,0,1490,280,1770,29267,31037,-0.0045644,0.293237,-0.956029,1
0,0,0,0,0,1335,245,1580,28181,29761,0.0125085,0.293984,-0.955729,1
0,0,0,0,0,1198,296,1494,26171,27665,0.0453232,0.292436,-0.955211,1
0,0,0,0,0,1462,287,1749,24442,26191,0.0757715,0.255596,-0.96381,1
0,0,0,0,0,1137,224,1361,22722,24083,0.112627,0.245279,-0.962888,1
0,0,0,0,0,1422,241,1663,22254,23917,0.12287,0.227446,-0.966008,1
0,0,0,0,0,1127,223,1350,22293,23643,0.126607,0.207133,-0.970086,1
0,0,0,0,0,1476,308,1784,20644,22428,0.119433,0.194296,-0.973645,1
0,0,0,0,0,1330,269,1599,17862,19461,0.100286,0.180093,-0.978524,1
0,0,0,0,0,1830,386,2216,22825,25041,0.068811,0.15849,-0.98496,1
0,0,0,0,0,1790,334,2124,17337,19461,0.0425435,0.12721,-0.990963,1
0,0,0,0,0,1693,303,1996,15407,17403,0.0194105,0.0931385,-0.995464,1
0,0,0,0,0,1920,370,2290,13320,15610,0.00585456,0.0756252,-0.997119,1
0,0,0,0,0,5782,1004,6786,17590,24376,0.00289403,0.0672367,-0.997733,1
0,0,0,0,0,1904,331,2235,6553,8788,0.00293385,0.0620412,-0.998069,1
0,0,0,0,0,3041,536,3577,8288,11865,-0.000756682,0.0566892,-0.998392,1
0,0,0,0,0,5372,904,6276,12079,18355,-0.00247935,0.0503005,-0.998731,1
0,0,0,0,0,3687,653,4340,7496,11836,-0.000529138,0.0460023,-0.998941,1
0,0,0,0,0,5324,907,6231,9832,16063,0.00396791,0.0419503,-0.999112,1
0,0,0,0,0,3747,648,4395,6408,10803,0.00229839,0.0408574,-0.999162,1
0,0,0,0,0,5277,975,6252,9097,15349,0.000792985,0.0409426,-0.999161,1
0,0,0,0,0,5221,943,6164,8525,14689,0.00136461,0.042118,-0.999112,1
0,0,0,0,0,3661,647,4308,5719,10027,0.00106644,0.0436762,-0.999045,1
0,0,0,0,0,5367,932,6299,8903,15202,-0.000663085,0.0442496,-0.99902,1
0,0,0,0,0,3639,623,4262,5825,10087,-0.00325033,0.0454461,-0.998962,1
0,0,0,0,0,4191,636,4827,5977,10804,0.00169524,0.0468533,-0.9989,1
0,0,0,0,0,4960,835,5795,9337,15132,0.0067256,0.0485116,-0.9988,1
0,0,0,0,0,5089,865,5954,9814,15768,0.00654539,0.0490939,-0.998773,1
0,0,0,0,0,2680,474,3154,6277,9431,0.00605156,0.0506389,-0.998699,1
0,0,0,0,0,5235,971,6206,11663,17869,0.00520761,0.0498673,-0.998742,1
0,0,0,0,0,3647,653,4300,8210,12510,0.0102006,0.0477508,-0.998807,1
0,0,0,0,0,4724,884,5608,11605,17213,0.0117808,0.0463329,-0.998856,1
0,0,0,0,0,3738,621,4359,8908,13267,0.0180105,0.0463203,-0.998764,1
0,0,0,0,0,3393,651,4044,10497,14541,0.0199343,0.0487968,-0.99861,1
0,0,0,0,0,2693,496,3189,8594,11783,0.0187075,0.0506094,-0.998543,1
0,0,0,0,0,4756,750,5506,13016,18522,0.0171143,0.0501584,-0.998595,1
0,0,0,0,0,3038,531,3569,9571,13140,0.0216438,0.0485885,-0.998584,1
0,0,0,0,0,2976,530,3506,10467,13973,0.0215989,0.0475551,-0.998635,1
0,0,0,0,0,4969,902,5871,16502,22373,0.0222931,0.0475268,-0.998621,1
0,0,0,0,0,3368,666,4034,11345,15379,0.0229366,0.0479665,-0.998586,1
0,0,0,0,0,2380,389,2769,7960,10729,0.0238885,0.048953,-0.998515,1
0,0,0,0,0,2983,537,3520,11352,14872,0.023466,0.0496927,-0.998489,1
0,0,0,0,0,2976,574,3550,11320,14870,0.0231966,0.0498483,-0.998487,1
0,0,0,0,0,3662,682,4344,14179,18523,0.021852,0.0502698,-0.998496,1
0,0,0,0,0,2775,532,3307,10082,13389,0.0216895,0.0507486,-0.998476,1
0,0,0,0,0,2638,477,3115,10211,13326,0.0212605,0.0517093,-0.998436,1
0,0,0,0,0,5384,914,6298,16373,22671,0.024253,0.0510839,-0.9984,1
0,0,0,0,0,2605,488,3093,10255,13348,0.0237321,0.0503572,-0.998449,1
0,0,0,0,0,2345,428,2773,9329,12102,0.0235961,0.0488407,-0.998528,1
0,0,0,0,0,5323,948,6271,15275,21546,0.0218677,0.0460626,-0.998699,1
0,0,0,0,0,2154,394,2548,7729,10277,0.0216781,0.0447666,-0.998762,1
0,0,0,0,0,2915,501,3416,10202,13618,0.0200853,0.042741,-0.998885,1
0,0,0,0,0,4825,841,5666,15047,20713,0.0186972,0.0411146,-0.99898,1
0,0,0,0,0,3388,572,3960,9553,13513,0.0207776,0.0392058,-0.999015,1
0,0,0,0,0,3173,511,3684,9339,13023,0.0217976,0.0394164,-0.998985,1
0,0,0,0,0,3700,789,4489,11639,16128,0.0213629,0.0396555,-0.998985,1
0,0,0,0,0,2796,518,3314,8602,11916,0.019703,0.0409279,-0.998968,1
0,0,0,0,0,5503,978,6481,13940,20421,0.0208797,0.0425189,-0.998878,1
0,0,0,0,0,2592,478,3070,8774,11844,0.0194599,0.0448645,-0.998803,1
0,0,0,0,0,4003,723,4726,12685,17411,0.0187626,0.0446732,-0.998826,1
0,0,0,0,0,4099,715,4814,12434,17248,0.0185126,0.0417306,-0.998958,1
0,0,0,0,0,2972,536,3508,9047,12555,0.0228798,0.0398825,-0.998942,1
0,0,0,0,0,4774,845,5619,14238,19857,0.0221774,0.0410515,-0.998911,1
0,0,0,0,0,3372,584,3956,10114,14070,0.0179523,0.0410965,-0.998994,1
0,0,0,0,0,2709,501,3210,7920,11130,0.0190123,0.0402746,-0.999008,1
0,0,0,0,0,3536,563,4099,9423,13522,0.0168733,0.0388349,-0.999103,1
0,0,0,0,0,5234,868,6102,12767,18869,0.0164176,0.0389468,-0.999106,1
0,0,0,0,0,2611,470,3081,7006,10087,0.0212177,0.0380756,-0.99905,1
0,0,0,0,0,5299,897,6196,14589,20785,0.0230493,0.0412819,-0.998882,1
0,0,0,0,0,3476,604,4080,9990,14070,0.0232668,0.0424239,-0.998829,1
0,0,0,0,0,2262,377,2639,6987,9626,0.0228043,0.0430833,-0.998811,1
0,0,0,0,0,4849,983,5832,15768,21600,0.0208519,0.0416397,-0.998915,1
0,0,0,0,0,3343,582,3925,11047,14972,0.0197198,0.0405782,-0.998982,1
0,0,0,0,0,2598,454,3052,7838,10890,0.0198144,0.0407258,-0.998974,1
0,0,0,0,0,5553,901,6454,13469,19923,0.0226451,0.0419197,-0.998864,1
0,0,0,0,0,2656,451,3107,8402,11509,0.0268126,0.0417937,-0.998767,1
0,0,0,0,0,3830,627,4457,13412,17869,0.0253371,0.0439005,-0.998715,1
0,0,0,0,0,2971,491,3462,10452,13914,0.0246879,0.0455078,-0.998659,1
0,0,0,0,0,3138,541,3679,11614,15293,0.0242042,0.045135,-0.998688,1
0,0,0,0,0,4216,704,4920,14175,19095,0.0216558,0.0445323,-0.998773,1
0,0,0,0,0,3054,579,3633,10756,14389,0.0209512,0.0441201,-0.998807,1
0,0,0,0,0,2859,496,3355,9029,12384,0.0203761,0.0440873,-0.99882,1
0,0,0,0,0,2819,496,3315,9485,12800,0.0198973,0.0439224,-0.998837,1
0,0,0,0,0,4537,752,5289,13363,18652,0.0179009,0.0433409,-0.9989,1
0,0,0,0,0,4263,754,5017,12416,17433,0.015714,0.0430086,-0.998951,1
0,0,0,0,0,2475,432,2907,7060,9967,0.0177503,0.0417305,-0.998971,1
0,0,0,0,0,4719,893,5612,13882,19494,0.017386,0.0411442,-0.999002,1
0,0,0,0,0,4749,910,5659,11506,17165,0.0141139,0.0409203,-0.999063,1
0,0,0,0,0,2605,453,3058,6569,9627,0.0129776,0.039673,-0.999128,1
0,0,0,0,0,5218,1015,6233,11860,18093,0.0092951,0.0384871,-0.999216,1
0,0,0,0,0,3430,600,4030,7933,11963,0.00583866,0.0374522,-0.999282,1
0,0,0,0,0,3380,613,3993,8170,12163,0.00411153,0.0352448,-0.99937,1
0,0,0,0,0,2610,475,3085,5078,8163,0.00344133,0.0350064,-0.999381,2
0,0,0,0,0,4689,716,5405,7646,13051,0.00964713,0.0331168,-0.999405,2
0,0,0,0,0,4783,847,5630,10350,15980,0.0135539,0.0332328,-0.999356,2
0,0,0,0,0,4957,871,5828,10677,16505,0.0125177,0.0334711,-0.999361,2
0,0,0,0,0,4894,846,5740,8190,13930,0.0112906,0.0339704,-0.999359,2
0,0,0,0,0,2616,464,3080,5888,8968,0.0155492,0.0328746,-0.999339,2
0,0,0,0,0,4764,825,5589,12207,17796,0.0179175,0.031499,-0.999343,2
0,0,0,0,0,3369,584,3953,9419,13372,0.0181412,0.0304626,-0.999371,2
0,0,0,0,0,5412,961,6373,14220,20593,0.0151128,0.0307815,-0.999412,2
0,0,0,0,0,3348,590,3938,9039,12977,0.0171363,0.031041,-0.999371,2
0,0,0,0,0,5907,1178,7085,11175,18260,0.0180112,0.0321127,-0.999322,2
0,0,0,0,0,2885,475,3360,6855,10215,0.0176179,0.0326458,-0.999312,2
0,0,0,0,0,1575,254,1829,3995,5824,0.0150982,0.0338175,-0.999314,2
0,0,0,0,0,1395,247,1642,3759,5401,0.0137246,0.0339043,-0.999331,2
0,0,0,0,0,3665,621,4286,8633,12919,0.0119375,0.033257,-0.999376,2
0,0,0,0,0,4792,841,5633,11340,16973,0.0105278,0.0319792,-0.999433,2
0,0,0,0,0,3384,605,3989,7695,11684,0.00818575,0.0320918,-0.999452,2
0,0,0,0,0,5213,974,6187,10137,16324,0.0142894,0.0324738,-0.99937,2
0,0,0,0,0,3382,626,4008,9150,13158,0.0179043,0.0334864,-0.999279,2
0,0,0,0,0,3362,578,3940,8786,12726,0.0146318,0.0354905,-0.999263,2
0,0,0,0,0,4426,782,5208,11041,16249,0.0131714,0.0358667,-0.99927,2
0,0,0,0,0,1474,253,1727,3279,5006,0.0136307,0.0373766,-0.999208,2
0,0,0,0,0,5294,1318,6612,11341,17953,0.0129098,0.0391841,-0.999148,2
0,0,0,0,0,3383,583,3966,8268,12234,0.0124655,0.039711,-0.999133,2
0,0,0,0,0,3145,567,3712,8214,11926,0.0106697,0.040545,-0.999121,2
0,0,0,0,0,3959,710,4669,9300,13969,0.015562,0.0404773,-0.999059,2
0,0,0,0,0,3955,744,4699,10779,15478,0.0179749,0.0404828,-0.999019,2
0,0,0,0,0,3938,767,4705,11720,16425,0.0225939,0.0406755,-0.998917,2
0,0,0,0,0,2971,567,3538,10273,13811,0.023475,0.0418308,-0.998849,2
0,0,0,0,0,3667,688,4355,13249,17604,0.0228713,0.0434493,-0.998794,2
0,0,0,0,0,3375,578,3953,12227,16180,0.0229138,0.0445891,-0.998743,2
0,0,0,0,0,3373,585,3958,12412,16370,0.0239377,0.0449467,-0.998702,2
0,0,0,0,0,3950,702,4652,14802,19454,0.02416,0.0456893,-0.998663,2
0,0,0,0,0,2986,518,3504,11693,15197,0.0241749,0.0461263,-0.998643,2
0,0,0,0,0,4787,819,5606,17772,23378,0.0249978,0.0476892,-0.998549,2
0,0,0,0,0,2465,391,2856,8070,10926,0.025221,0.047415,-0.998557,2
0,0,0,0,0,1319,217,1536,5166,6702,0.0244421,0.0464122,-0.998623,2
0,0,0,0,0,1627,283,1910,6599,8509,0.0239164,0.0460288,-0.998653,2
0,0,0,0,0,4774,868,5642,18951,24593,0.0249477,0.0457436,-0.998642,2
0,0,0,0,0,2629,523,3152,10583,13735,0.0252025,0.045418,-0.99865,2
0,0,0,0,0,4922,864,5786,15081,20867,0.0262595,0.0455801,-0.998615,2
0,0,0,0,0,2171,376,2547,9132,11679,0.0267593,0.0465213,-0.998559,2
0,0,0,0,0,5983,1019,7002,19038,26040,0.0270505,0.049012,-0.998432,2
0,0,0,0,0,2270,403,2673,9181,11854,0.0269631,0.0490016,-0.998435,2
0,0,0,0,0,2079,391,2470,9430,11900,0.0263429,0.0494395,-0.99843,2
0,0,0,0,0,3398,628,4026,15785,19811,0.0255701,0.0485904,-0.998491,2
0,0,0,0,0,3405,603,4008,14310,18318,0.025498,0.0475344,-0.998544,2
0,0,0,0,0,2334,384,2718,9599,12317,0.0266483,0.0464365,-0.998566,2
0,0,0,0,0,3665,649,4314,16298,20612,0.026011,0.0460429,-0.998601,2
0,0,0,0,0,3215,499,3714,11988,15702,0.0267568,0.0448921,-0.998633,2
0,0,0,0,0,3423,594,4017,14596,18613,0.0247807,0.0435805,-0.998743,2
0,0,0,0,0,2863,469,3332,10903,14235,0.0249351,0.0428055,-0.998772,2
0,0,0,0,0,6239,860,7099,14384,21483,0.0250828,0.043879,-0.998722,2
0,0,0,0,0,2157,394,2551,8988,11539,0.0253269,0.044982,-0.998667,2
0,0,0,0,0,2843,529,3372,11755,15127,0.0246043,0.045769,-0.998649,2
0,0,0,0,0,2818,534,3352,11621,14973,0.0241796,0.0458107,-0.998657,2
0,0,0,0,0,4383,855,5238,17094,22332,0.0247204,0.0452225,-0.998671,2
0,0,0,0,0,2519,464,2983,10688,13671,0.0251361,0.0449613,-0.998672,2
0,0,0,0,0,3698,678,4376,14965,19341,0.0247595,0.0443773,-0.998708,2
0,0,0,0,0,2800,523,3323,11718,15041,0.0237646,0.0443298,-0.998734,2
0,0,0,0,0,3477,665,4142,14071,18213,0.0234631,0.043192,-0.998791,2
0,0,0,0,0,2852,502,3354,11037,14391,0.0231231,0.0431373,-0.998802,2
0,0,0,0,0,2701,479,3180,10538,13718,0.0214357,0.0431099,-0.99884,2
0,0,0,0,0,3223,592,3815,12654,16469,0.0229609,0.0423569,-0.998839,2
0,0,0,0,0,3269,671,3940,12818,16758,0.0242597,0.0414982,-0.998844,2
0,0,0,0,0,2507,453,2960,10161,13121,0.0233963,0.0414208,-0.998868,2
0,0,0,0,0,2807,486,3293,11014,14307,0.0221073,0.0415097,-0.998894,2
0,0,0,0,0,3559,620,4179,14157,18336,0.0243412,0.0422203,-0.998812,2
0,0,0,0,0,2642,489,3131,10793,13924,0.0242789,0.0434526,-0.99876,2
0,0,0,0,0,3488,551,4039,12417,16456,0.0252361,0.043069,-0.998753,2
0,0,0,0,0,3034,559,3593,12067,15660,0.0241812,0.0428579,-0.998789,2
0,0,0,0,0,2883,373,3256,7878,11134,0.0233416,0.0432762,-0.99879,2
0,0,0,0,0,4949,923,5872,20036,25908,0.023233,0.0439192,-0.998765,2
0,0,0,0,0,2746,482,3228,9847,13075,0.0219202,0.0435385,-0.998812,2
0,0,0,0,0,2093,359,2452,8046,10498,0.0212545,0.0432653,-0.998838,2
0,0,0,0,0,5591,1013,6604,18576,25180,0.0220736,0.0428721,-0.998837,2
0,0,0,0,0,2237,390,2627,9325,11952,0.0216004,0.0431899,-0.998833,2
0,0,0,0,0,1844,337,2181,7166,9347,0.0198116,0.0429595,-0.99888,2
0,0,0,0,0,3414,633,4047,12721,16768,0.0204296,0.0426257,-0.998882,2
0,0,0,0,0,4433,785,5218,15012,20230,0.0224664,0.0413994,-0.99889,2
0,0,0,0,0,2525,462,2987,9852,12839,0.022018,0.0407672,-0.998926,2
0,0,0,0,0,2999,516,3515,11668,15183,0.0206105,0.0407969,-0.998955,2
0,0,0,0,0,3698,654,4352,13632,17984,0.0195771,0.0414634,-0.998948,2
0,0,0,0,0,2873,487,3360,10589,13949,0.0204372,0.0411448,-0.998944,2
0,0,0,0,0,3470,592,4062,12823,16885,0.0203668,0.0410636,-0.998949,2
0,0,0,0,0,2709,474,3183,10035,13218,0.0189059,0.0414961,-0.99896,2
0,0,0,0,0,5005,850,5855,17386,23241,0.0188719,0.0404888,-0.999001,2
0,0,0,0,0,2681,460,3141,9709,12850,0.0172723,0.0403941,-0.999035,2
0,0,0,0,0,4045,707,4752,13402,18154,0.0180544,0.0402767,-0.999025,2
0,0,0,0,0,3049,517,3566,10166,13732,0.0206656,0.0407279,-0.998957,2
0,0,0,0,0,4876,841,5717,16319,22036,0.0188833,0.0420986,-0.998935,2
0,0,0,0,0,4841,852,5693,11543,17236,0.0206537,0.041955,-0.998906,2
0,0,0,0,0,2207,391,2598,8571,11169,0.0178426,0.0416109,-0.998974,2
0,0,0,0,0,3028,539,3567,10960,14527,0.0172535,0.0409008,-0.999014,2
0,0,0,0,0,4893,849,5742,14808,20550,0.0165858,0.0408507,-0.999028,2
0,0,0,0,0,2717,463,3180,8968,12148,0.0153125,0.0416708,-0.999014,2
0,0,0,0,0,5230,955,6185,15279,21464,0.0139012,0.0422508,-0.99901,2
0,0,0,0,0,2714,480,3194,8700,11894,0.0160129,0.0416731,-0.999003,2
0,0,0,0,0,5072,963,6035,16955,22990,0.0202104,0.0409354,-0.998957,2
0,0,0,0,0,2824,524,3348,9775,13123,0.021537,0.0397518,-0.998978,2
0,0,0,0,0,2558,454,3012,9980,12992,0.0196749,0.0397272,-0.999017,2
0,0,0,0,0,5429,993,6422,17931,24353,0.0188652,0.0395067,-0.999041,2
0,0,0,0,0,2319,410,2729,8531,11260,0.0193876,0.0391249,-0.999046,2
0,0,0,0,0,2192,399,2591,8038,10629,0.0202591,0.0393444,-0.99902,2
0,0,0,0,0,5036,869,5905,17042,22947,0.0206754,0.0411149,-0.998941,2
0,0,0,0,0,2676,462,3138,10153,13291,0.0209928,0.0418606,-0.998903,2
0,0,0,0,0,1865,332,2197,7365,9562,0.0218604,0.0410255,-0.998919,2
0,0,0,0,0,4452,797,5249,17687,22936,0.0195883,0.0375852,-0.999102,2
0,0,0,0,0,2529,456,2985,10432,13417,0.0185822,0.0355345,-0.999195,2
0,0,0,0,0,2674,435,3109,8946,12055,0.0176211,0.0343959,-0.999253,2
0,0,0,0,0,3775,637,4412,13160,17572,0.0177058,0.0354067,-0.999216,2
0,0,0,0,0,3825,662,4487,11186,15673,0.0186414,0.0364854,-0.99916,2
0,0,0,0,0,2323,421,2744,8194,10938,0.0169603,0.0374619,-0.999154,2
0,0,0,0,0,3198,577,3775,11515,15290,0.0155096,0.0370814,-0.999192,2
0,0,0,0,0,5530,924,6454,14263,20717,0.0191432,0.036822,-0.999138,2
0,0,0,0,0,2194,376,2570,7913,10483,0.0186898,0.0376045,-0.999118,2
0,0,0,0,0,3688,672,4360,13170,17530,0.0179942,0.0380201,-0.999115,2
0,0,0,0,0,2883,520,3403,10287,13690,0.0161704,0.0383095,-0.999135,2
0,0,0,0,0,4951,867,5818,15198,21016,0.0153691,0.0384808,-0.999141,2
0,0,0,0,0,2668,461,3129,8246,11375,0.0178681,0.0373829,-0.999141,2
0,0,0,0,0,2092,372,2464,7912,10376,0.0177811,0.0376022,-0.999135,2
0,0,0,0,0,5185,904,6089,14889,20978,0.0174749,0.0373253,-0.99915,2
0,0,0,0,0,2261,394,2655,8236,10891,0.0161498,0.0374368,-0.999168,2
0,0,0,0,0,3778,658,4436,12981,17417,0.015028,0.0369129,-0.999205,2
0,0,0,0,0,3726,641,4367,12235,16602,0.0147568,0.0370517,-0.999204,2
0,0,0,0,0,2879,504,3383,10579,13962,0.013824,0.036857,-0.999225,2
0,0,0,0,0,2364,415,2779,7662,10441,0.0137391,0.0356128,-0.999271,2
0,0,0,0,0,3884,569,4453,10588,15041,0.0139275,0.035198,-0.999283,2
0,0,0,0,0,3262,575,3837,10949,14786,0.0130128,0.0343685,-0.999325,2
0,0,0,0,0,3055,534,3589,9471,13060,0.0134384,0.0348512,-0.999302,2
0,0,0,0,0,3065,560,3625,10233,13858,0.0125461,0.0352995,-0.999298,2
0,0,0,0,0,4956,822,5778,13976,19754,0.0123127,0.0364308,-0.99926,2
0,0,0,0,0,3434,590,4024,10846,14870,0.0122036,0.0371386,-0.999236,2
0,0,0,0,0,4488,754,5242,13170,18412,0.0132719,0.0381467,-0.999184,2
0,0,0,0,0,2542,467,3009,8397,11406,0.0155702,0.0384799,-0.999138,2
0,0,0,0,0,4999,836,5835,15571,21406,0.0158486,0.0375926,-0.999167,2
0,0,0,0,0,2700,462,3162,9776,12938,0.0155716,0.0355904,-0.999245,2
0,0,0,0,0,4054,752,4806,13575,18381,0.0163417,0.0344634,-0.999272,2
0,0,0,0,0,3013,548,3561,10192,13753,0.0157053,0.0349002,-0.999268,2
0,0,0,0,0,2846,497,3343,9619,12962,0.0156074,0.0360842,-0.999227,2
0,0,0,0,0,4936,861,5797,15791,21588,0.0154643,0.0367203,-0.999206,2
0,0,0,0,0,5570,961,6531,12575,19106,0.015214,0.0369385,-0.999202,2
0,0,0,0,0,1929,331,2260,6856,9116,0.0163523,0.0370166,-0.999181,2
0,0,0,0,0,5030,831,5861,16034,21895,0.0194258,0.0365882,-0.999142,2
0,0,0,0,0,2669,471,3140,10705,13845,0.0201138,0.0363244,-0.999138,2
0,0,0,0,0,4007,732,4739,15789,20528,0.0193009,0.0350971,-0.999197,2
0,0,0,0,0,2485,420,2905,9322,12227,0.0182892,0.0340585,-0.999253,2
0,0,0,0,0,3464,643,4107,12715,16822,0.0188426,0.0335096,-0.999261,2
0,0,0,0,0,3425,607,4032,12635,16667,0.0186466,0.0339993,-0.999248,2
0,0,0,0,0,2663,464,3127,9894,13021,0.0177372,0.0349716,-0.999231,2
0,0,0,0,0,4948,859,5807,14622,20429,0.0170107,0.0348237,-0.999249,2
0,0,0,0,0,4843,864,5707,13869,19576,0.0174575,0.0343528,-0.999257,2
0,0,0,0,0,2300,387,2687,8111,10798,0.0164507,0.0346521,-0.999264,2
0,0,0,0,0,3920,641,4561,13657,18218,0.0168652,0.0345356,-0.999261,2
0,0,0,0,0,3910,682,4592,14254,18846,0.0165463,0.0350621,-0.999248,2
0,0,0,0,0,2297,406,2703,8374,11077,0.0160248,0.0345196,-0.999276,2
0,0,0,0,0,4030,706,4736,14847,19583,0.0171995,0.0343424,-0.999262,2
0,0,0,0,0,4105,737,4842,11486,16328,0.0160947,0.0344087,-0.999279,2
0,0,0,0,0,2011,361,2372,7584,9956,0.0157164,0.033446,-0.999317,2
0,0,0,0,0,4037,733,4770,14125,18895,0.0152395,0.033003,-0.999339,2
0,0,0,0,0,3027,539,3566,10412,13978,0.0148442,0.0329362,-0.999347,2
0,0,0,0,0,2996,516,3512,9939,13451,0.0183822,0.032381,-0.999307,2
0,0,0,0,0,5500,1005,6505,16777,23282,0.0187386,0.0330871,-0.999277,2
0,0,0,0,0,2674,484,3158,9148,12306,0.0179068,0.0337345,-0.99927,2
0,0,0,0,0,2912,541,3453,10438,13891,0.0161756,0.0333727,-0.999312,2
0,0,0,0,0,3670,672,4342,12634,16976,0.0158083,0.0332549,-0.999322,2
0,0,0,0,0,2738,506,3244,9365,12609,0.0163943,0.0332829,-0.999311,2
0,0,0,0,0,2696,478,3174,9395,12569,0.0163028,0.0336522,-0.9993,2
0,0,0,0,0,3348,598,3946,12305,16251,0.0181004,0.0336423,-0.99927,2
0,0,0,0,0,2557,456,3013,9348,12361,0.0177731,0.0335414,-0.999279,2
0,0,0,0,0,3484,550,4034,11205,15239,0.0177617,0.0331198,-0.999294,2
0,0,0,0,0,3051,537,3588,11265,14853,0.017287,0.0321306,-0.999334,2
0,0,0,0,0,2435,443,2878,8770,11648,0.0165868,0.0316823,-0.99936,2
0,0,0,0,0,2829,506,3335,9870,13205,0.0165232,0.0317884,-0.999358,2
0,0,0,0,0,5345,961,6306,14860,21166,0.0172253,0.0323423,-0.999328,2
0,0,0,0,0,2671,482,3153,9723,12876,0.0192693,0.032456,-0.999287,2
0,0,0,0,0,2326,379,2705,8400,11105,0.0188108,0.033077,-0.999276,2
0,0,0,0,0,4894,915,5809,17249,23058,0.0177308,0.0321486,-0.999326,2
0,0,0,0,0,4890,832,5722,12603,18325,0.0169225,0.032044,-0.999343,2
0,0,0,0,0,1874,332,2206,6540,8746,0.0175161,0.0324164,-0.999321,2
0,0,0,0,0,3564,627,4191,12550,16741,0.0169499,0.0326072,-0.999325,2
0,0,0,0,0,4471,757,5228,14078,19306,0.0168476,0.0321613,-0.999341,2
0,0,0,0,0,2582,438,3020,9156,12176,0.0186846,0.0313288,-0.999335,2
0,0,0,0,0,3705,666,4371,13711,18082,0.017355,0.0312757,-0.99936,2
0,0,0,0,0,3477,599,4076,12512,16588,0.0157798,0.0310642,-0.999393,2
0,0,0,0,0,4427,750,5177,14379,19556,0.0161975,0.0309577,-0.99939,2
0,0,0,0,0,2559,445,3004,8958,11962,0.0158477,0.030401,-0.999412,2
0,0,0,0,0,4844,831,5675,14647,20322,0.0128324,0.0301002,-0.999464,2
0,0,0,0,0,2668,478,3146,8625,11771,0.0115787,0.0317929,-0.999427,2
0,0,0,0,0,5378,1031,6409,16186,22595,0.0115784,0.03569,-0.999296,2
0,0,0,0,0,3484,640,4124,11565,15689,0.0118613,0.0411284,-0.999084,2
0,0,0,0,0,2684,489,3173,10092,13265,0.0185564,0.0449264,-0.998818,2
0,0,0,0,0,4044,774,4818,16617,21435,0.0217579,0.0432804,-0.998826,2
0,0,0,0,0,2456,439,2895,11656,14551,0.0190703,0.0347158,-0.999215,2
0,0,0,0,0,2805,514,3319,12698,16017,0.0204936,0.0235855,-0.999512,2
0,0,0,0,0,2688,483,3171,11202,14373,0.0254452,0.0174013,-0.999525,2
0,0,0,0,0,2938,572,3510,10460,13970,0.0282921,0.0183855,-0.999431,2
0,0,0,0,0,2703,492,3195,11197,14392,0.0230329,0.0254577,-0.99941,2
0,0,0,0,0,2618,466,3084,9338,12422,0.0132511,0.0346778,-0.999311,2
0,0,0,0,0,2592,640,3232,9470,12702,0.0129888,0.0472772,-0.998797,2
0,0,0,0,0,5559,997,6556,19306,25862,0.0109603,0.0990166,-0.995026,2
0,0,0,0,0,3265,423,3688,9716,13404,0.00296787,0.109052,-0.994032,2
0,0,0,0,0,1345,259,1604,7411,9015,-0.00253981,0.102179,-0.994763,2
0,0,0,0,0,1330,249,1579,7904,9483,-0.00710916,0.121051,-0.992621,2
0,0,0,0,0,5911,982,6893,24196,31089,-0.0224774,0.217932,-0.975706,2
0,0,0,0,0,1994,341,2335,11186,13521,-0.022251,0.215798,-0.976184,2
0,0,0,0,0,1373,243,1616,10732,12348,-0.0391408,0.259422,-0.964971,2
0,0,0,0,0,1860,344,2204,17945,20149,-0.0460629,0.281771,-0.958376,2
0,0,0,0,0,2027,373,2400,22713,25113,-0.0549858,0.305217,-0.950694,2
0,0,0,0,0,6157,1099,7256,39621,46877,-0.0622436,0.489697,-0.869668,2
0,0,0,0,0,1458,258,1716,23159,24875,-0.0553126,0.468924,-0.881505,2
0,0,0,0,0,1398,345,1743,27764,29507,-0.0446519,0.392936,-0.918481,2
0,0,0,0,0,1391,284,1675,32760,34435,-0.0332099,0.300077,-0.953337,2
0,0,0,0,0,1395,316,1711,34200,35911,-0.021471,0.224447,-0.97425,2
0,0,0,0,0,1638,269,1907,36788,38695,0.0128985,0.123941,-0.992206,2
0,0,0,0,0,1481,258,1739,35084,36823,0.0273944,0.110793,-0.993466,2
0,0,0,0,0,1494,273,1767,34449,36216,0.0375065,0.128329,-0.991022,2
0,0,0,0,0,1493,264,1757,35677,37434,0.0316694,0.108778,-0.993561,2
0,0,0,0,0,1486,304,1790,35409,37199,0.0304624,0.108773,-0.9936,2
0,0,0,0,0,1789,278,2067,35137,37204,0.0260804,0.113791,-0.993162,2
0,0,0,0,0,1480,260,1740,34868,36608,0.0221215,0.134417,-0.990678,2
0,0,0,0,0,1421,259,1680,34456,36136,0.0171899,0.149123,-0.988669,2
0,0,0,0,0,3483,540,4023,41215,45238,-0.0100649,0.191001,-0.981538,2
0,0,0,0,0,1560,346,1906,33827,35733,-0.0213859,0.19406,-0.980757,2
0,0,0,0,0,1960,254,2214,32622,34836,-0.0325594,0.203819,-0.978467,2
0,0,0,0,0,1365,291,1656,31317,32973,-0.0412196,0.197079,-0.979521,2
0,0,0,0,0,1353,247,1600,30300,31900,-0.0354352,0.195054,-0.980152,2
0,0,0,0,0,1354,233,1587,28653,30240,-0.0220348,0.193591,-0.980835,2
0,0,0,0,0,1335,314,1649,24713,26362,-0.00389976,0.196191,-0.980558,2
0,0,0,0,0,1368,234,1602,13563,15165,0.00792535,0.212684,-0.977089,2
0,0,0,0,0,1560,259,1819,6646,8465,0.0294114,0.218109,-0.975481,2
0,0,0,0,0,3312,522,3834,8941,12775,0.0457677,0.143349,-0.988613,2
0,0,0,0,0,1604,277,1881,4568,6449,0.0603972,0.107806,-0.992336,2
0,0,0,0,0,2954,506,3460,9955,13415,0.0869061,0.00751897,-0.996188,2
0,0,0,0,0,6022,1067,7089,31857,38946,0.050874,0.106478,-0.993013,2
0,0,0,0,0,1572,272,1844,4540,6384,0.039049,0.0696718,-0.996805,2
0,0,0,0,0,1551,268,1819,5543,7362,0.0161247,0.133891,-0.990865,2
0,0,0,0,0,3326,618,3944,18396,22340,-0.0511562,0.289674,-0.955757,2
0,0,0,0,0,3611,669,4280,20266,24546,-0.0811076,0.372609,-0.924437,2
0,0,0,0,0,2127,388,2515,12033,14548,-0.0759248,0.464446,-0.882341,2
0,0,0,0,0,2224,423,2647,16188,18835,-0.0759241,0.568511,-0.819165,2
0,0,0,0,0,2925,549,3474,19844,23318,-0.0611824,0.639155,-0.766641,2
0,0,0,0,0,2054,373,2427,13596,16023,-0.0506304,0.698738,-0.713584,2
0,0,0,0,0,2016,352,2368,-1000,-1000,-1,-1,-1,2
0,0,0,0,0,2278,407,2685,29144,31829,-0.00791225,0.100807,-0.994875,2
0,0,0,0,0,1420,347,1767,27955,29722,-0.0304483,0.108401,-0.993641,2
0,0,0,0,0,1465,275,1740,21909,23649,-0.0416948,0.130249,-0.990604,2
0,0,0,0,0,1585,283,1868,24339,26207,-0.0526095,0.118403,-0.991571,2
0,0,0,0,0,1484,277,1761,23513,25274,-0.0625213,0.139279,-0.988278,2
0,0,0,0,0,1635,321,1956,34924,36880,-0.0653114,0.116381,-0.991055,2
0,0,0,0,0,1326,309,1635,33162,34797,-0.0531715,0.156303,-0.986277,2
0,0,0,0,0,1289,247,1536,33708,35244,-0.0533356,0.197858,-0.978779,2
0,0,0,0,0,1692,272,1964,34770,36734,-0.0602773,0.215849,-0.974564,2
0,0,0,0,0,2001,379,2380,46348,48728,-0.0809115,0.335164,-0.938679,2
0,0,0,0,0,1279,229,1508,35068,36576,-0.0888192,0.31161,-0.94605,2
0,0,0,0,0,1173,229,1402,34854,36256,-0.0889729,0.266272,-0.959783,2
0,0,0,0,0,1196,278,1474,35284,36758,-0.0881389,0.26132,-0.96122,2
0,0,0,0,0,1205,355,1560,36017,37577,-0.0943885,0.299819,-0.949315,2
0,0,0,0,0,1246,267,1513,35378,36891,-0.0876366,0.29733,-0.950744,2
0,0,0,0,0,1200,225,1425,35554,36979,-0.0714973,0.321389,-0.944244,2
0,0,0,0,0,1242,264,1506,35792,37298,-0.0506042,0.318104,-0.946704,2
0,0,0,0,0,1219,262,1481,35282,36763,-0.0310831,0.343536,-0.938625,2
0,0,0,0,0,1730,287,2017,34677,36694,-0.0115287,0.378904,-0.925364,2
0,0,0,0,0,1132,226,1358,29830,31188,-0.00939224,0.38638,-0.922292,2
0,0,0,0,0,1123,227,1350,24226,25576,0.000377251,0.421097,-0.907015,2
0,0,0,0,0,3973,816,4789,27769,32558,0.00580589,0.538302,-0.842732,2
0,0,0,0,0,1288,253,1541,7220,8761,0.000387819,0.586989,-0.809595,2
0,0,0,0,0,5462,1061,6523,-1000,-1000,-1,-1,-1,2
0,0,0,0,0,1531,296,1827,27464,29291,-0.0429587,0.168085,-0.984836,2
0,0,0,0,0,3546,652,4198,35510,39708,-0.102737,0.294495,-0.950115,2
0,0,0,0,0,1255,242,1497,23228,24725,-0.132847,0.370476,-0.919293,2
0,0,0,0,0,1445,275,1720,22889,24609,-0.134892,0.374433,-0.91739,2
0,0,0,0,0,1372,262,1634,25154,26788,-0.126478,0.377432,-0.917359,2
0,0,0,0,0,1394,263,1657,29093,30750,-0.0995942,0.3419,-0.934444,2
0,0,0,0,0,1503,287,1790,33404,35194,-0.0652306,0.280043,-0.957769,2
0,0,0,0,0,1431,259,1690,35400,37090,-0.0445766,0.206266,-0.97748,2
0,0,0,0,0,1523,273,1796,34163,35959,-0.0535815,0.153676,-0.986667,2
0,0,0,0,0,1457,271,1728,33532,35260,-0.067542,0.121882,-0.990244,2
0,0,0,0,0,1505,307,1812,33000,34812,-0.0951241,0.154219,-0.983447,2
0,0,0,0,0,1466,312,1778,32149,33927,-0.0876587,0.138551,-0.986468,2
0,0,0,0,0,1464,293,1757,32094,33851,-0.075843,0.169455,-0.982615,2
0,0,0,0,0,1450,267,1717,32905,34622,-0.046417,0.160062,-0.986015,2
0,0,0,0,0,1531,261,1792,33158,34950,-0.0367485,0.168096,-0.985086,2
0,0,0,0,0,4077,742,4819,41634,46453,-0.0365508,0.190381,-0.98103,2
0,0,0,0,0,1476,298,1774,33139,34913,-0.0258059,0.185617,-0.982284,2
0,0,0,0,0,1427,263,1690,33195,34885,-0.0140843,0.196389,-0.980425,2
0,0,0,0,0,1475,260,1735,32463,34198,-0.00905116,0.182138,-0.983231,2
0,0,0,0,0,1417,256,1673,31677,33350,-0.0325432,0.19174,-0.980906,2
0,0,0,0,0,1412,255,1667,31066,32733,-0.0457047,0.187641,-0.981174,2
0,0,0,0,0,1403,252,1655,30257,31912,-0.0435872,0.174497,-0.983693,2
0,0,0,0,0,3699,649,4348,37668,42016,-0.0510625,0.191679,-0.980129,2
0,0,0,0,0,1391,249,1640,28417,30057,-0.0386808,0.173756,-0.984029,2
0,0,0,0,0,1396,252,1648,28055,29703,-0.0289445,0.18096,-0.983064,2
0,0,0,0,0,1386,291,1677,25367,27044,-0.0255877,0.181045,-0.983142,2
0,0,0,0,0,1366,367,1733,19415,21148,-0.00947078,0.191695,-0.981409,2
0,0,0,0,0,1502,249,1751,10847,12598,0.0336995,0.258403,-0.965449,2
0,0,0,0,0,2128,333,2461,3500,5961,0.0108417,0.196354,-0.980473,2
0,0,0,0,0,6297,1038,7335,10409,17744,0.00590358,0.16881,-0.985631,2
0,0,0,0,0,4268,734,5002,7980,12982,-0.00498063,0.105722,-0.994383,2
0,0,0,0,0,6157,1017,7174,16918,24092,0.0335583,0.236155,-0.971136,2
0,0,0,0,0,2549,440,2989,4691,7680,0.0131209,0.234784,-0.971959,2
0,0,0,0,0,1802,316,2118,4511,6629,-0.0137975,0.168393,-0.985623,2
0,0,0,0,0,1372,246,1618,4174,5792,-0.0100889,0.185839,-0.982529,2
0,0,0,0,0,2627,553,3180,7524,10704,-0.0792045,0.172589,-0.981804,2
0,0,0,0,0,5934,1065,6999,15316,22315,-0.107075,0.213786,-0.970995,2
0,0,0,0,0,2536,460,2996,9984,12980,-0.155127,0.212041,-0.96487,2
0,0,0,0,0,2034,377,2411,9817,12228,-0.19686,0.20478,-0.958807,2
0,0,0,0,0,2668,497,3165,11848,15013,-0.220721,0.237894,-0.94588,2
0,0,0,0,0,3958,737,4695,18673,23368,-0.224899,0.266979,-0.937092,2
0,0,0,0,0,2090,388,2478,10846,13324,-0.214617,0.300852,-0.929208,2
0,0,0,0,0,1738,332,2070,9704,11774,-0.198221,0.335437,-0.920972,2
0,0,0,0,0,2488,468,2956,16159,19115,-0.184664,0.356691,-0.91579,2
0,0,0,0,0,6046,1113,7159,20846,28005,-0.185635,0.358712,-0.914803,2
0,0,0,0,0,1633,313,1946,8264,10210,-0.189534,0.357494,-0.91448,2
0,0,0,0,0,1635,308,1943,9472,11415,-0.192402,0.357822,-0.913753,2
0,0,0,0,0,2530,477,3007,14769,17776,-0.190825,0.370228,-0.90913,2
0,0,0,0,0,3681,677,4358,22002,26360,-0.190977,0.40278,-0.895152,2
0,0,0,0,0,2071,391,2462,11330,13792,-0.183095,0.411246,-0.892946,2
0,0,0,0,0,6110,1124,7234,14282,21516,-0.157461,0.429544,-0.889212,2
0,0,0,0,0,2253,410,2663,13586,16249,-0.159669,0.44866,-0.879324,2
0,0,0,0,0,2001,349,2350,12286,14636,-0.1573,0.480524,-0.862759,2
0,0,0,0,0,2367,418,2785,17512,20297,-0.150435,0.495387,-0.855547,2
0,0,0,0,0,2367,433,2800,17997,20797,-0.145195,0.493873,-0.857326,2
0,0,0,0,0,1766,324,2090,11433,13523,-0.140067,0.497378,-0.856152,2
0,0,0,0,0,6318,1151,7469,23187,30656,-0.134021,0.498396,-0.856528,2
0,0,0,0,0,6617,1120,7737,26473,34210,-0.129783,0.496465,-0.8583,2
0,0,0,0,0,1972,345,2317,11628,13945,-0.130007,0.492357,-0.86063,2
0,0,0,0,0,1349,243,1592,9110,10702,-0.130497,0.490943,-0.861363,2
0,0,0,0,0,1349,350,1699,9543,11242,-0.130544,0.489917,-0.861939,2
0,0,0,0,0,1737,354,2091,11617,13708,-0.130477,0.489306,-0.862297,2
0,0,0,0,0,6195,1151,7346,30701,38047,-0.129618,0.480163,-0.86755,2
0,0,0,0,0,1998,350,2348,13010,15358,-0.129156,0.468252,-0.874105,2
0,0,0,0,0,1355,244,1599,10084,11683,-0.128941,0.46813,-0.874202,2
0,0,0,0,0,1711,300,2011,12177,14188,-0.128474,0.460435,-0.878347,2
0,0,0,0,0,5863,1006,6869,25266,32135,-0.128975,0.454868,-0.88117,2
0,0,0,0,0,1637,302,1939,10480,12419,-0.128953,0.45455,-0.881337,2
0,0,0,0,0,1692,334,2026,13935,15961,-0.129486,0.451623,-0.882762,2
0,0,0,0,0,2432,436,2868,18029,20897,-0.127109,0.435711,-0.891066,2
0,0,0,0,0,2454,440,2894,17577,20471,-0.129743,0.440559,-0.888299,2
0,0,0,0,0,2048,379,2427,1027,3454,-0.122243,0.396563,-0.909832,2
0,0,0,0,0,6303,1160,7463,4370,11833,-0.114228,0.374287,-0.92025,2
0,0,0,0,0,4274,604,4878,3302,8180,-0.109377,0.365914,-0.924199,2
0,0,0,0,0,2263,406,2669,2261,4930,-0.104506,0.353228,-0.929682,2
0,0,0,0,0,2065,376,2441,1303,3744,-0.10287,0.355258,-0.929091,2
0,0,0,0,0,6438,1170,7608,3678,11286,-0.101514,0.360586,-0.927186,2
0,0,0,0,0,6459,1165,7624,6871,14495,-0.097626,0.343873,-0.933927,2
0,0,0,0,0,3330,599,3929,3001,6930,-0.0973659,0.343941,-0.93393,2
0,0,0,0,0,6281,1212,7493,5699,13192,-0.0965141,0.348181,-0.932446,2
0,0,0,0,0,6290,1180,7470,5616,13086,-0.0960089,0.350967,-0.931453,2
0,0,0,0,0,4275,819,5094,5507,10601,-0.0954147,0.345183,-0.933673,2
0,0,0,0,0,6231,1142,7373,7274,14647,-0.095852,0.334175,-0.937624,2
0,0,0,0,0,4282,823,5105,2274,7379,-0.0957976,0.329939,-0.939129,2
0,0,0,0,0,5870,1069,6939,7660,14599,-0.0931855,0.315145,-0.944458,2
0,0,0,0,0,4006,760,4766,4551,9317,-0.0926173,0.306424,-0.947379,2
0,0,0,0,0,6260,1179,7439,5967,13406,-0.0918826,0.297528,-0.950282,2
0,0,0,0,0,4930,829,5759,5624,11383,-0.0903177,0.286144,-0.953921,2
0,0,0,0,0,6340,1194,7534,5913,13447,-0.0899368,0.280279,-0.955696,2
0,0,0,0,0,3534,633,4167,2362,6529,-0.0895671,0.276979,-0.956693,2
0,0,0,0,0,2228,428,2656,3838,6494,-0.0879265,0.270569,-0.958677,2
0,0,0,0,0,2852,535,3387,5853,9240,-0.0834942,0.250724,-0.964451,2
0,0,0,0,0,7220,1197,8417,7679,16096,-0.0807417,0.246555,-0.96576,2
0,0,0,0,0,4054,795,4849,6903,11752,-0.0768495,0.238732,-0.96804,2
0,0,0,0,0,2883,533,3416,4229,7645,-0.0757878,0.235741,-0.968856,2
0,0,0,0,0,4645,903,5548,4577,10125,-0.0767032,0.232955,-0.969458,2
0,0,0,0,0,5134,845,5979,9028,15007,-0.0724883,0.221213,-0.972528,2
0,0,0,0,0,2779,682,3461,5067,8528,-0.0692388,0.217426,-0.973618,2
0,0,0,0,0,6440,1259,7699,12167,19866,-0.0709382,0.216655,-0.973667,2
0,0,0,0,0,3293,516,3809,4142,7951,-0.0709784,0.218514,-0.973249,2
0,0,0,0,0,1919,377,2296,2645,4941,-0.0695453,0.2168,-0.973736,2
0,0,0,0,0,2668,513,3181,6326,9507,-0.067326,0.213035,-0.974723,2
