Downsample[ns],BuildFilTree[ns],SearchFil[ns],DeleteFil[ns],BuildTreeSub[ns],SearchSub[ns],DeleteSub[ns],PreProcTotal[ns],Plane[ns],Total[ns],nx,ny,nz,planeCount
5492,0,0,0,0,1082,266,6840,431,7271,-0.0229969,0.0363344,-0.999075,0
5316,0,0,0,0,976,250,6542,708,7250,0.0181683,0.00408249,-0.999827,0
5484,0,0,0,0,977,246,6707,701,7408,0.019529,0.00106448,-0.999809,0
5652,0,0,0,0,1316,276,7244,749,7993,0.0212721,0.000981583,-0.999773,0
5214,0,0,0,0,1012,268,6494,790,7284,0.022001,0.000946985,-0.999757,0
5557,0,0,0,0,945,266,6768,738,7506,0.0223699,-0.000284407,-0.99975,0
5139,0,0,0,0,983,269,6391,794,7185,0.0217553,-0.000254519,-0.999763,0
5535,0,0,0,0,934,234,6703,733,7436,0.0227144,0.00236743,-0.999739,0
5228,0,0,0,0,907,234,6369,727,7096,0.0216469,0.000713399,-0.999765,0
5146,0,0,0,0,970,245,6361,754,7115,0.0221454,0.00879796,-0.999716,0
5282,0,0,0,0,948,272,6502,968,7470,0.0201309,0.0104385,-0.999743,0
3572,0,0,0,0,669,185,4426,502,4928,0.0199454,0.00779377,-0.999771,0
4784,0,0,0,0,854,212,5850,684,6534,0.0209384,0.00895946,-0.999741,0
5419,0,0,0,0,1003,269,6691,766,7457,0.017764,0.0112562,-0.999779,0
5622,0,0,0,0,975,272,6869,741,7610,0.020506,0.0112681,-0.999726,0
5388,0,0,0,0,1032,271,6691,837,7528,0.0189602,0.0117863,-0.999751,0
5537,0,0,0,0,1003,277,6817,740,7557,0.0156765,0.00934044,-0.999834,0
5245,0,0,0,0,904,233,6382,761,7143,0.0209909,0.0121348,-0.999706,0
5204,0,0,0,0,953,240,6397,815,7212,0.0198397,0.0109477,-0.999743,0
5184,0,0,0,0,957,251,6392,773,7165,0.0209895,0.0113428,-0.999715,0
6031,0,0,0,0,1003,253,7287,757,8044,0.0202677,0.0103927,-0.999741,0
3577,0,0,0,0,628,123,4328,387,4715,0.021657,0.00848805,-0.999729,0
5392,0,0,0,0,984,238,6614,755,7369,0.0202575,0.00879961,-0.999756,0
6116,0,0,0,0,1018,238,7372,775,8147,0.0192739,0.00939762,-0.99977,0
5311,0,0,0,0,945,292,6548,718,7266,0.021096,0.00909804,-0.999736,0
4818,0,0,0,0,749,166,5733,532,6265,0.0200312,0.00926263,-0.999756,0
5587,0,0,0,0,978,271,6836,719,7555,0.0218721,0.00967713,-0.999714,0
6751,0,0,0,0,650,188,7589,536,8125,0.0208666,0.010758,-0.999724,0
4859,0,0,0,0,655,215,5729,657,6386,0.0206809,0.00893164,-0.999746,0
2759,0,0,0,0,509,142,3410,383,3793,0.02212,0.0065632,-0.999734,0
6449,0,0,0,0,901,266,7616,759,8375,0.0194877,0.0086414,-0.999773,0
5371,0,0,0,0,934,266,6571,734,7305,0.0205765,0.00966241,-0.999742,0
5479,0,0,0,0,921,267,6667,800,7467,0.0201467,0.0104167,-0.999743,0
5416,0,0,0,0,981,268,6665,745,7410,0.0205896,0.0106693,-0.999731,0
5258,0,0,0,0,927,270,6455,739,7194,0.0198849,0.0110361,-0.999741,0
5405,0,0,0,0,949,300,6654,962,7616,0.0223105,0.00959103,-0.999705,0
4968,0,0,0,0,824,238,6030,653,6683,0.0199399,0.00966063,-0.999754,0
5239,0,0,0,0,982,262,6483,721,7204,0.0184581,0.0129943,-0.999745,0
5633,0,0,0,0,969,233,6835,746,7581,0.0192701,0.0112118,-0.999751,0
3462,0,0,0,0,471,123,4056,371,4427,0.0201716,0.0102822,-0.999744,0
5784,0,0,0,0,1045,315,7144,815,7959,0.0189792,0.0111565,-0.999758,0
5442,0,0,0,0,898,231,6571,726,7297,0.0195722,0.00939898,-0.999764,0
5258,0,0,0,0,936,242,6436,782,7218,0.0195661,0.0112686,-0.999745,0
5587,0,0,0,0,942,241,6770,791,7561,0.0185244,0.0105258,-0.999773,0
5283,0,0,0,0,888,228,6399,710,7109,0.018292,0.0106872,-0.999776,0
5434,0,0,0,0,952,263,6649,798,7447,0.0202375,0.0108883,-0.999736,0
5555,0,0,0,0,1257,253,7065,771,7836,0.0182879,0.00908727,-0.999791,0
5197,0,0,0,0,884,248,6329,772,7101,0.0189176,0.00911869,-0.999779,0
5319,0,0,0,0,921,244,6484,721,7205,0.0190466,0.0120829,-0.999746,0
5197,0,0,0,0,889,245,6331,761,7092,0.0198829,0.0103358,-0.999749,0
5794,0,0,0,0,922,247,6963,750,7713,0.0193475,0.0124164,-0.999736,0
5271,0,0,0,0,901,246,6418,720,7138,0.0212025,0.00976565,-0.999728,0
5388,0,0,0,0,972,234,6594,716,7310,0.0190003,0.0129261,-0.999736,0
5419,0,0,0,0,902,231,6552,718,7270,0.0188646,0.0110911,-0.999761,0
5361,0,0,0,0,978,267,6606,731,7337,0.0188449,0.0111158,-0.999761,0
5658,0,0,0,0,1143,272,7073,745,7818,0.0191766,0.00966686,-0.999769,0
5256,0,0,0,0,941,269,6466,763,7229,0.0189906,0.0113167,-0.999756,0
5319,0,0,0,0,950,268,6537,765,7302,0.0196867,0.0102972,-0.999753,0
5347,0,0,0,0,1006,271,6624,741,7365,0.0205218,0.00997068,-0.99974,0
5296,0,0,0,0,943,268,6507,754,7261,0.0195432,0.00965445,-0.999762,0
5801,0,0,0,0,951,235,6987,711,7698,0.0197992,0.00904394,-0.999763,0
5351,0,0,0,0,963,267,6581,747,7328,0.0180468,0.0102942,-0.999784,0
5276,0,0,0,0,955,270,6501,788,7289,0.0197131,0.00922588,-0.999763,0
5264,0,0,0,0,942,265,6471,751,7222,0.0191048,0.01018,-0.999766,0
5279,0,0,0,0,953,270,6502,741,7243,0.0180788,0.0107881,-0.999778,0
5331,0,0,0,0,933,272,6536,823,7359,0.0188995,0.0091653,-0.999779,0
5540,0,0,0,0,927,234,6701,773,7474,0.0192448,0.0102621,-0.999762,0
5408,0,0,0,0,892,232,6532,702,7234,0.0192345,0.00997711,-0.999765,0
5589,0,0,0,0,902,233,6724,751,7475,0.0189127,0.0096512,-0.999775,0
5428,0,0,0,0,971,235,6634,717,7351,0.0197481,0.00877555,-0.999766,0
5226,0,0,0,0,1034,323,6583,789,7372,0.0205526,0.0107703,-0.999731,0
5264,0,0,0,0,905,235,6404,849,7253,0.0193855,0.00851663,-0.999776,0
5343,0,0,0,0,942,269,6554,741,7295,0.0205397,0.0101285,-0.999738,0
5253,0,0,0,0,901,231,6385,748,7133,0.0193412,0.0101161,-0.999762,0
6010,0,0,0,0,900,249,7159,735,7894,0.0178428,0.00869296,-0.999803,0
5590,0,0,0,0,760,206,6556,555,7111,0.0182571,0.00983068,-0.999785,0
5851,0,0,0,0,908,289,7048,713,7761,0.0164153,0.0102041,-0.999813,0
5384,0,0,0,0,910,247,6541,751,7292,0.0186966,0.00990738,-0.999776,0
5682,0,0,0,0,987,251,6920,714,7634,0.0181721,0.00973763,-0.999787,0
5350,0,0,0,0,1020,247,6617,744,7361,0.019398,0.00984617,-0.999763,0
5264,0,0,0,0,998,238,6500,768,7268,0.0189838,0.00803848,-0.999788,0
6071,0,0,0,0,950,289,7310,725,8035,0.0185656,0.00653534,-0.999806,0
5340,0,0,0,0,702,185,6227,503,6730,0.0173513,0.00722707,-0.999823,0
3575,0,0,0,0,665,174,4414,508,4922,0.0211552,0.00509897,-0.999763,0
5326,0,0,0,0,921,244,6491,767,7258,0.0175159,0.0071845,-0.999821,0
5495,0,0,0,0,974,268,6737,770,7507,0.0213348,0.00425668,-0.999763,0
5342,0,0,0,0,938,256,6536,753,7289,0.0203,0.00503578,-0.999781,0
5258,0,0,0,0,897,265,6420,761,7181,0.0196251,0.00468022,-0.999796,0
5286,0,0,0,0,904,241,6431,704,7135,0.019663,0.00629865,-0.999787,0
5779,0,0,0,0,887,228,6894,701,7595,0.0203423,0.00714484,-0.999768,0
5258,0,0,0,0,979,232,6469,706,7175,0.0205409,0.00544948,-0.999774,0
5215,0,0,0,0,898,229,6342,738,7080,0.019488,0.00418278,-0.999801,0
5567,0,0,0,0,900,230,6697,716,7413,0.0195184,0.00440001,-0.9998,0
5188,0,0,0,0,886,226,6300,729,7029,0.0203396,0.00366171,-0.999786,0
5285,0,0,0,0,931,249,6465,751,7216,0.0202333,0.00432063,-0.999786,0
5274,0,0,0,0,908,241,6423,679,7102,0.0206426,0.00349783,-0.999781,0
5272,0,0,0,0,881,253,6406,488,6894,0.0205654,0.00189948,-0.999787,0
5222,0,0,0,0,918,240,6380,738,7118,0.0202306,0.00375447,-0.999788,0
5256,0,0,0,0,868,228,6352,732,7084,0.0214487,0.00375133,-0.999763,0
5301,0,0,0,0,897,241,6439,694,7133,0.0213111,0.0025458,-0.99977,0
5562,0,0,0,0,885,235,6682,768,7450,0.0216386,0.00136042,-0.999765,0
5338,0,0,0,0,838,215,6391,713,7104,0.022302,0.000923184,-0.999751,0
5261,0,0,0,0,852,230,6343,691,7034,0.0237831,0.000654675,-0.999717,0
5412,0,0,0,0,827,225,6464,737,7201,0.0207263,0.00320633,-0.99978,0
5628,0,0,0,0,1160,259,7047,738,7785,0.024174,-0.000478897,-0.999708,0
5459,0,0,0,0,974,227,6660,772,7432,0.0223554,-0.00298188,-0.999746,0
5218,0,0,0,0,821,201,6240,766,7006,0.0208029,0.00073248,-0.999783,0
5379,0,0,0,0,751,236,6366,737,7103,0.0237239,0.00486711,-0.999707,0
5710,0,0,0,0,818,194,6722,722,7444,0.0241794,0.0103702,-0.999654,0
5233,0,0,0,0,789,225,6247,784,7031,0.0237172,0.0183123,-0.999551,0
5377,0,0,0,0,820,247,6444,783,7227,0.0259025,0.0337205,-0.999096,0
5487,0,0,0,0,795,229,6511,729,7240,0.0294512,0.0556071,-0.998018,0
5349,0,0,0,0,786,190,6325,223,6548,0.0178079,0.100056,-0.994822,0
5517,0,0,0,0,767,187,6471,273,6744,0.020122,0.0854163,-0.996142,0
5547,0,0,0,0,763,184,6494,260,6754,0.0240877,0.0788742,-0.996594,0
5547,0,0,0,0,841,209,6597,251,6848,0.0247856,0.0979368,-0.994884,0
5548,0,0,0,0,740,177,6465,288,6753,0.0229206,0.11292,-0.99334,0
5580,0,0,0,0,666,174,6420,279,6699,0.0448021,0.100626,-0.993915,0
6091,0,0,0,0,670,163,6924,298,7222,0.0612047,0.118356,-0.991083,0
5441,0,0,0,0,604,184,6229,266,6495,0.071172,0.114701,-0.990847,0
6000,0,0,0,0,561,149,6710,359,7069,0.071558,0.114955,-0.99079,0
5383,0,0,0,0,656,180,6219,314,6533,0.066909,0.111242,-0.991538,0
6012,0,0,0,0,559,172,6743,350,7093,0.0640559,0.126129,-0.989944,0
5265,0,0,0,0,571,120,5956,251,6207,0.0575824,0.118475,-0.991286,0
5240,0,0,0,0,669,179,6088,387,6475,0.0515737,0.128458,-0.990373,0
6152,0,0,0,0,614,168,6934,368,7302,0.0606265,0.118062,-0.991154,0
5240,0,0,0,0,540,143,5923,462,6385,0.0642862,0.135729,-0.988658,0
6060,0,0,0,0,590,175,6825,437,7262,0.0627184,0.133975,-0.988998,0
4955,0,0,0,0,576,138,5669,421,6090,0.0595381,0.14932,-0.986995,0
4868,0,0,0,0,579,135,5582,411,5993,0.0389558,0.186449,-0.981692,0
4751,0,0,0,0,496,131,5378,493,5871,0.0261067,0.21109,-0.977118,0
4798,0,0,0,0,592,151,5541,457,5998,0.0235749,0.22382,-0.974345,0
4581,0,0,0,0,509,140,5230,513,5743,0.0188176,0.200281,-0.979558,0
4589,0,0,0,0,464,112,5165,563,5728,0.020872,0.170281,-0.985174,0
4369,0,0,0,0,384,110,4863,604,5467,0.0245117,0.144743,-0.989166,0
4502,0,0,0,0,399,100,5001,618,5619,0.0316451,0.134033,-0.990471,0
4272,0,0,0,0,379,96,4747,637,5384,0.035923,0.133121,-0.990449,0
4363,0,0,0,0,312,87,4762,582,5344,0.0405453,0.130538,-0.990614,0
4637,0,0,0,0,317,113,5067,640,5707,0.0423937,0.141423,-0.989041,0
4449,0,0,0,0,381,95,4925,667,5592,0.0469619,0.144989,-0.988318,0
4467,0,0,0,0,414,107,4988,597,5585,0.0421162,0.133266,-0.990185,0
4437,0,0,0,0,449,117,5003,618,5621,0.034662,0.130817,-0.9908,0
4573,0,0,0,0,507,143,5223,611,5834,0.0160698,0.145703,-0.989198,0
4596,0,0,0,0,601,156,5353,534,5887,0.0030008,0.156756,-0.987633,0
4555,0,0,0,0,570,167,5292,509,5801,0.00321248,0.170241,-0.985397,0
3248,0,0,0,0,491,131,3870,385,4255,0.0134179,0.17619,-0.984265,0
4130,0,0,0,0,536,136,4802,379,5181,0.0291779,0.172372,-0.9846,0
6101,0,0,0,0,848,213,7162,527,7689,0.0410005,0.165928,-0.985285,0
5069,0,0,0,0,887,268,6224,540,6764,0.0301718,0.177259,-0.983702,0
5222,0,0,0,0,990,277,6489,607,7096,0.0296796,0.1426,-0.989335,0
5273,0,0,0,0,1114,280,6667,655,7322,0.0462378,0.146441,-0.988138,0
5563,0,0,0,0,1087,272,6922,682,7604,0.0549327,0.140291,-0.988585,0
5432,0,0,0,0,1372,358,7162,856,8018,0.050015,0.148582,-0.987634,0
5768,0,0,0,0,1534,382,7684,911,8595,0.0367307,0.225269,-0.973604,0
6021,0,0,0,0,1506,372,7899,669,8568,0.0267455,0.17187,-0.984757,0
4468,0,0,0,0,780,197,5445,612,6057,0.0263508,0.12995,-0.99117,0
6300,0,0,0,0,1472,415,8187,1335,9522,0.0218559,0.14035,-0.989861,0
6088,0,0,0,0,1569,364,8021,1416,9437,0.0148803,0.14871,-0.988769,0
7042,0,0,0,0,1453,340,8835,1223,10058,-0.00296357,0.235517,-0.971866,0
5432,0,0,0,0,957,227,6616,897,7513,0.00318246,0.193815,-0.981033,0
2658,0,0,0,0,541,126,3325,476,3801,0.0102284,0.132797,-0.99109,0
5976,0,0,0,0,1349,296,7621,1357,8978,0.000279329,0.146394,-0.989226,0
5842,0,0,0,0,1116,268,7226,1917,9143,-0.0101434,0.13424,-0.990897,0
6926,0,0,0,0,1144,291,8361,1831,10192,-0.0167327,0.206664,-0.978269,0
5543,0,0,0,0,925,231,6699,1427,8126,-0.0164338,0.163104,-0.986472,0
2751,0,0,0,0,445,103,3299,482,3781,-0.0130068,0.116055,-0.993158,0
2287,0,0,0,0,487,136,2910,479,3389,-0.0156925,0.105194,-0.994328,0
5772,0,0,0,0,1022,263,7057,967,8024,-0.0219175,0.133909,-0.990751,0
5724,0,0,0,0,1003,272,6999,910,7909,-0.0213595,0.130652,-0.991198,0
5451,0,0,0,0,1004,247,6702,812,7514,-0.0131518,0.130399,-0.991374,0
5836,0,0,0,0,992,250,7078,826,7904,-0.00326337,0.1301,-0.991496,0
5267,0,0,0,0,1007,257,6531,691,7222,-0.00297306,0.118399,-0.992962,0
5103,0,0,0,0,941,228,6272,731,7003,-0.00646129,0.10335,-0.994624,0
5342,0,0,0,0,1159,244,6745,721,7466,-0.0178291,0.0969835,-0.995126,0
4878,0,0,0,0,817,300,5995,709,6704,-0.0220991,0.0883942,-0.99584,0
4695,0,0,0,0,843,226,5764,723,6487,-0.0257392,0.0901857,-0.995592,0
4490,0,0,0,0,777,186,5453,664,6117,-0.0199008,0.101676,-0.994618,0
4505,0,0,0,0,789,218,5512,602,6114,-0.0096779,0.126045,-0.991977,0
4413,0,0,0,0,736,185,5334,517,5851,0.00314549,0.155619,-0.987812,0
4588,0,0,0,0,830,202,5620,537,6157,0.00768699,0.179205,-0.983782,0
4235,0,0,0,0,733,179,5147,450,5597,-0.000657246,0.237908,-0.971287,0
4269,0,0,0,0,760,194,5223,388,5611,-0.0181631,0.27482,-0.961324,0
4122,0,0,0,0,787,232,5141,387,5528,-0.0227086,0.293717,-0.955623,0
4836,0,0,0,0,866,222,5924,335,6259,-0.0138257,0.311902,-0.950014,0
4989,0,0,0,0,935,235,6159,353,6512,-0.0109895,0.277495,-0.960664,0
4851,0,0,0,0,978,270,6099,252,6351,-0.00780646,0.225619,-0.974184,0
3469,0,0,0,0,768,227,4464,193,4657,-0.00196425,0.179187,-0.983813,0
3481,0,0,0,0,695,191,4367,165,4532,-0.00585875,0.167231,-0.9859,0
5106,0,0,0,0,988,275,6369,206,6575,-0.0100904,0.192439,-0.981257,0
4999,0,0,0,0,977,243,6219,212,6431,-0.00392738,0.218385,-0.975855,0
3473,0,0,0,0,662,166,4301,154,4455,0.00426802,0.216115,-0.976359,0
5067,0,0,0,0,1062,283,6412,240,6652,0.000550313,0.201549,-0.979478,0
5012,0,0,0,0,1026,285,6323,398,6721,-0.0256754,0.165258,-0.985916,0
5068,0,0,0,0,956,250,6274,331,6605,-0.0399417,0.181273,-0.982621,0
4546,0,0,0,0,869,224,5639,279,5918,-0.0502455,0.162892,-0.985364,0
5172,0,0,0,0,941,248,6361,311,6672,-0.0426556,0.182124,-0.98235,0
5513,0,0,0,0,848,243,6604,288,6892,-0.0234375,0.163438,-0.986275,0
4789,0,0,0,0,865,234,5888,315,6203,-0.0156843,0.160122,-0.986973,0
4564,0,0,0,0,858,208,5630,203,5833,0.212136,0.433346,-0.875905,0
4790,0,0,0,0,819,195,5804,210,6014,0.158899,0.21665,-0.963231,0
5286,0,0,0,0,794,207,6287,234,6521,0.113215,0.261355,-0.95858,0
5021,0,0,0,0,699,216,5936,293,6229,0.0238827,0.257634,-0.965947,0
4698,0,0,0,0,636,167,5501,294,5795,-0.015163,0.251271,-0.967798,0
4508,0,0,0,0,966,249,5723,491,6214,-0.0472724,0.273954,-0.96058,0
5436,0,0,0,0,792,224,6452,396,6848,-0.0618705,0.257068,-0.964411,0
5238,0,0,0,0,830,216,6284,279,6563,-0.084674,0.256548,-0.962815,0
5095,0,0,0,0,852,223,6170,261,6431,-0.0800116,0.215479,-0.973225,0
3005,0,0,0,0,698,169,3872,165,4037,-0.054905,0.16919,-0.984053,0
3044,0,0,0,0,512,131,3687,156,3843,-0.0451583,0.180069,-0.982617,0
4973,0,0,0,0,927,217,6117,303,6420,-0.0320559,0.167766,-0.985305,0
4630,0,0,0,0,738,216,5584,283,5867,-0.0263685,0.133356,-0.990717,0
4770,0,0,0,0,719,176,5665,311,5976,-0.0300131,0.0934962,-0.995167,0
5175,0,0,0,0,615,159,5949,360,6309,-0.0163202,0.0991731,-0.994936,0
4780,0,0,0,0,665,164,5609,357,5966,-0.0171218,0.0887824,-0.995904,0
4880,0,0,0,0,778,192,5850,381,6231,0.011564,0.156311,-0.98764,0
5496,0,0,0,0,664,201,6361,244,6605,0.0262076,0.155845,-0.987434,0
3426,0,0,0,0,428,120,3974,255,4229,0.0390633,0.182659,-0.9824,0
4975,0,0,0,0,595,183,5753,453,6206,0.048608,0.160419,-0.985851,0
4948,0,0,0,0,531,137,5616,425,6041,0.0448619,0.17876,-0.982869,0
5120,0,0,0,0,530,146,5796,492,6288,0.0324158,0.210763,-0.977,0
5237,0,0,0,0,491,155,5883,528,6411,0.0163699,0.210678,-0.977419,0
5160,0,0,0,0,459,128,5747,557,6304,0.017012,0.186503,-0.982307,0
4912,0,0,0,0,405,142,5459,602,6061,0.0220344,0.167604,-0.985608,0
4840,0,0,0,0,392,119,5351,600,5951,0.0281577,0.160648,-0.98661,0
4724,0,0,0,0,385,117,5226,593,5819,0.0303733,0.153796,-0.987636,0
5539,0,0,0,0,376,117,6032,614,6646,0.0312161,0.143749,-0.989122,0
4392,0,0,0,0,452,148,4992,488,5480,0.0250894,0.132274,-0.990896,0
4785,0,0,0,0,428,125,5338,498,5836,0.0304638,0.125524,-0.991623,0
4877,0,0,0,0,503,140,5520,555,6075,0.0407426,0.139451,-0.98939,0
4760,0,0,0,0,520,139,5419,525,5944,0.0457625,0.152858,-0.987188,0
5164,0,0,0,0,625,154,5943,550,6493,0.0403112,0.152272,-0.987516,0
5617,0,0,0,0,710,172,6499,575,7074,-0.00981489,0.23141,-0.972807,0
4533,0,0,0,0,682,195,5410,347,5757,-0.00794578,0.182879,-0.983103,0
3216,0,0,0,0,525,131,3872,334,4206,-0.00110848,0.136469,-0.990644,0
4738,0,0,0,0,821,230,5789,490,6279,-0.0266498,0.160525,-0.986672,0
5154,0,0,0,0,1050,280,6484,521,7005,-0.0436472,0.179819,-0.982731,0
5225,0,0,0,0,1046,255,6526,441,6967,-0.0140762,0.166413,-0.985956,0
5682,0,0,0,0,1365,286,7333,426,7759,0.021282,0.171313,-0.984987,0
5623,0,0,0,0,1254,300,7177,491,7668,0.0239508,0.172751,-0.984674,0
5654,0,0,0,0,1316,333,7303,663,7966,0.0177294,0.153752,-0.98795,0
5683,0,0,0,0,1244,308,7235,774,8009,0.00646956,0.144908,-0.989424,0
5685,0,0,0,0,1217,293,7195,831,8026,-0.0137523,0.132039,-0.991149,0
6153,0,0,0,0,1239,356,7748,982,8730,-0.027075,0.128888,-0.991289,0
5364,0,0,0,0,1159,295,6818,1033,7851,-0.0222654,0.102654,-0.994468,0
5221,0,0,0,0,1083,281,6585,1184,7769,-0.0183027,0.0891304,-0.995852,0
5022,0,0,0,0,923,230,6175,1203,7378,-0.0208877,0.108509,-0.993876,0
4943,0,0,0,0,1025,214,6182,1094,7276,-0.012937,0.121628,-0.992491,0
4455,0,0,0,0,941,190,5586,918,6504,-0.0125405,0.126004,-0.99195,0
4511,0,0,0,0,777,194,5482,812,6294,-0.00963591,0.128874,-0.991614,0
5546,0,0,0,0,1024,280,6850,977,7827,-0.0188452,0.131707,-0.99111,0
5838,0,0,0,0,1584,417,7839,1159,8998,-0.0130945,0.132616,-0.991081,0
5781,0,0,0,0,1110,294,7185,921,8106,-0.0153241,0.115963,-0.993135,0
5551,0,0,0,0,1058,261,6870,850,7720,-0.0162018,0.121988,-0.992399,0
5505,0,0,0,0,1014,252,6771,776,7547,0.00522131,0.223301,-0.974736,0
5439,0,0,0,0,1019,295,6753,785,7538,0.000880769,0.177867,-0.984054,0
5166,0,0,0,0,962,245,6373,817,7190,0.00151309,0.167921,-0.985799,0
4956,0,0,0,0,951,232,6139,685,6824,0.0098975,0.191976,-0.98135,0
5008,0,0,0,0,963,267,6238,666,6904,0.00392714,0.257416,-0.966293,0
4975,0,0,0,0,1033,237,6245,658,6903,-0.00321293,0.259969,-0.965612,0
5086,0,0,0,0,985,272,6343,455,6798,-0.00925465,0.308596,-0.951148,0
5244,0,0,0,0,1043,306,6593,486,7079,-0.0114803,0.337006,-0.941432,0
5124,0,0,0,0,979,278,6381,431,6812,-0.0210025,0.345523,-0.938175,0
2717,0,0,0,0,522,143,3382,202,3584,-0.0172619,0.368521,-0.929459,0
5018,0,0,0,0,979,251,6248,355,6603,-0.00971659,0.385433,-0.922685,0
5136,0,0,0,0,1060,266,6462,417,6879,0.0145953,0.339251,-0.940583,0
3481,0,0,0,0,717,187,4385,306,4691,0.0313566,0.288924,-0.956838,0
5122,0,0,0,0,967,257,6346,461,6807,0.0359998,0.257258,-0.965672,0
5090,0,0,0,0,931,228,6249,414,6663,0.0264948,0.40699,-0.913048,0
5226,0,0,0,0,910,230,6366,525,6891,0.008878,0.356365,-0.934305,0
5005,0,0,0,0,694,162,5861,329,6190,-0.00823402,0.289232,-0.957224,0
3721,0,0,0,0,640,203,4564,208,4772,-0.039098,0.321476,-0.94611,0
5187,0,0,0,0,873,236,6296,314,6610,-0.0637411,0.336519,-0.939517,0
5258,0,0,0,0,817,203,6278,319,6597,-0.0507078,0.316704,-0.947168,0
5180,0,0,0,0,762,212,6154,265,6419,-0.0145598,0.295637,-0.955189,0
3670,0,0,0,0,444,132,4246,158,4404,0.0286873,0.251811,-0.967351,0
4939,0,0,0,0,598,167,5704,-1000,-1000,-1,-1,-1,0
4927,0,0,0,0,615,153,5695,361,6056,0.014633,0.205947,-0.978454,0
3449,0,0,0,0,436,102,3987,197,4184,0.00475263,0.16615,-0.986089,0
5249,0,0,0,0,641,161,6051,367,6418,0.0103723,0.190178,-0.981695,0
5022,0,0,0,0,524,150,5696,414,6110,0.0234823,0.226603,-0.973704,0
4959,0,0,0,0,584,181,5724,463,6187,0.0229555,0.229938,-0.972934,0
4874,0,0,0,0,482,130,5486,537,6023,0.02378,0.197886,-0.979936,0
4801,0,0,0,0,443,134,5378,550,5928,0.0200758,0.189309,-0.981712,0
4730,0,0,0,0,461,134,5325,598,5923,0.0160942,0.174102,-0.984596,0
4911,0,0,0,0,490,138,5539,691,6230,0.0170822,0.159083,-0.987117,0
4932,0,0,0,0,510,160,5602,580,6182,0.0211668,0.160129,-0.986869,0
5142,0,0,0,0,741,145,6028,617,6645,0.027201,0.149457,-0.988394,0
4972,0,0,0,0,632,166,5770,562,6332,0.0376481,0.155913,-0.987053,0
5038,0,0,0,0,672,182,5892,534,6426,0.0356034,0.143906,-0.988951,0
5048,0,0,0,0,761,181,5990,489,6479,0.0321288,0.152938,-0.987713,0
5275,0,0,0,0,722,190,6187,492,6679,0.0248937,0.149813,-0.988401,0
5132,0,0,0,0,784,218,6134,528,6662,0.00795146,0.150828,-0.988528,0
5253,0,0,0,0,825,226,6304,540,6844,0.00175332,0.145478,-0.98936,0
5383,0,0,0,0,896,238,6517,580,7097,0.0073421,0.142583,-0.989756,0
5419,0,0,0,0,898,241,6558,577,7135,0.0167961,0.127931,-0.991641,0
5338,0,0,0,0,1051,259,6648,581,7229,0.0489129,0.180181,-0.982417,0
5461,0,0,0,0,1018,252,6731,567,7298,0.0758639,0.163183,-0.983675,0
5248,0,0,0,0,839,193,6280,477,6757,0.0638924,0.113069,-0.991531,0
4017,0,0,0,0,858,214,5089,372,5461,0.0902247,0.100327,-0.990855,0
6082,0,0,0,0,1337,300,7719,643,8362,0.0531422,0.17038,-0.983944,0
5983,0,0,0,0,1196,282,7461,677,8138,0.0262241,0.18225,-0.982903,0
6178,0,0,0,0,1125,293,7596,775,8371,0.00632932,0.153996,-0.988051,0
5757,0,0,0,0,1002,246,7005,954,7959,-0.00648795,0.110519,-0.993853,0
5413,0,0,0,0,1049,228,6690,1109,7799,-0.00799065,0.0784339,-0.996887,0
5493,0,0,0,0,931,245,6669,1043,7712,-0.00272508,0.0573919,-0.998348,0
3529,0,0,0,0,488,198,4215,499,4714,0.000633366,0.0338243,-0.999428,0
5404,0,0,0,0,937,219,6560,936,7496,0.00329218,0.0365959,-0.999325,0
5406,0,0,0,0,879,220,6505,925,7430,-0.00585535,0.031602,-0.999483,0
5466,0,0,0,0,926,255,6647,919,7566,-0.012222,0.0343045,-0.999337,0
5535,0,0,0,0,946,277,6758,821,7579,-0.0201663,0.0908524,-0.99566,0
5565,0,0,0,0,904,253,6722,613,7335,-0.0142615,0.0723825,-0.997275,0
3897,0,0,0,0,646,180,4723,552,5275,-0.0148584,0.0525389,-0.998508,0
5362,0,0,0,0,971,272,6605,781,7386,-0.00819857,0.067964,-0.997654,0
5374,0,0,0,0,1095,270,6739,777,7516,-0.00922449,0.0624578,-0.998005,0
5485,0,0,0,0,996,270,6751,719,7470,-0.00856905,0.0613253,-0.998081,0
5313,0,0,0,0,985,247,6545,681,7226,-0.00287356,0.0796527,-0.996819,0
5552,0,0,0,0,926,246,6724,715,7439,-0.0104745,0.0795862,-0.996773,0
5276,0,0,0,0,967,244,6487,721,7208,-0.00936681,0.188277,-0.982071,0
5147,0,0,0,0,984,281,6412,703,7115,-0.00714564,0.178165,-0.983975,0
4534,0,0,0,0,710,192,5436,447,5883,-0.010656,0.113049,-0.993532,0
2701,0,0,0,0,505,128,3334,325,3659,-0.0116352,0.111808,-0.993662,0
5932,0,0,0,0,976,272,7180,667,7847,-0.00416641,0.184704,-0.982785,0
4878,0,0,0,0,925,271,6074,575,6649,0.00422073,0.332506,-0.943092,0
4975,0,0,0,0,942,236,6153,511,6664,0.00908308,0.331689,-0.943345,0
4959,0,0,0,0,972,240,6171,426,6597,0.00675813,0.285164,-0.958455,0
3418,0,0,0,0,639,163,4220,311,4531,0.00391231,0.25805,-0.966124,0
4291,0,0,0,0,896,229,5416,399,5815,0.00245735,0.265451,-0.964121,0
4742,0,0,0,0,904,228,5874,435,6309,0.0237291,0.261897,-0.964804,0
4766,0,0,0,0,986,301,6053,483,6536,0.0348925,0.271457,-0.961818,0
4878,0,0,0,0,879,223,5980,414,6394,0.0319781,0.261676,-0.964626,0
5598,0,0,0,0,927,265,6790,443,7233,0.0371183,0.255085,-0.966206,0
5004,0,0,0,0,968,257,6229,574,6803,0.0464798,0.218399,-0.974752,0
5181,0,0,0,0,920,220,6321,558,6879,0.0307309,0.179649,-0.983251,0
5095,0,0,0,0,863,239,6197,504,6701,0.0125491,0.162206,-0.986677,0
4992,0,0,0,0,852,215,6059,687,6746,-0.00664132,0.165401,-0.986204,0
5161,0,0,0,0,963,252,6376,605,6981,-0.0168089,0.173104,-0.98476,0
4996,0,0,0,0,1005,261,6262,622,6884,0.00397729,0.166904,-0.985965,0
5478,0,0,0,0,977,236,6691,670,7361,0.0294667,0.161704,-0.986399,0
5081,0,0,0,0,928,260,6269,702,6971,0.043363,0.149365,-0.987831,0
5120,0,0,0,0,1019,238,6377,555,6932,0.0398267,0.136095,-0.989895,0
5154,0,0,0,0,986,234,6374,436,6810,0.0391387,0.128366,-0.990954,0
5125,0,0,0,0,958,247,6330,441,6771,0.0369763,0.123438,-0.991663,0
5428,0,0,0,0,1415,285,7128,482,7610,0.0431638,0.1167,-0.992229,0
5343,0,0,0,0,940,265,6548,335,6883,0.0525222,0.108019,-0.99276,0
3558,0,0,0,0,660,201,4419,242,4661,0.0564784,0.107403,-0.99261,0
4849,0,0,0,0,878,209,5936,266,6202,0.054658,0.11729,-0.991592,0
5086,0,0,0,0,886,238,6210,332,6542,0.0546716,0.123505,-0.990837,0
5071,0,0,0,0,976,231,6278,486,6764,0.0553036,0.121282,-0.991076,0
5074,0,0,0,0,1012,226,6312,424,6736,0.0620718,0.121627,-0.990633,0
5109,0,0,0,0,962,225,6296,446,6742,0.0602416,0.121085,-0.990812,0
4650,0,0,0,0,906,234,5790,378,6168,0.0499637,0.12126,-0.991363,0
4859,0,0,0,0,865,216,5940,409,6349,0.0529856,0.124934,-0.990749,0
5109,0,0,0,0,909,219,6237,437,6674,0.0522424,0.118663,-0.991559,0
4604,0,0,0,0,830,216,5650,426,6076,0.0561068,0.111115,-0.992223,0
4539,0,0,0,0,877,228,5644,375,6019,0.0562781,0.101842,-0.993207,0
5133,0,0,0,0,894,238,6265,360,6625,0.051065,0.0852665,-0.995049,0
4931,0,0,0,0,836,225,5992,213,6205,0.0422265,0.0635523,-0.997085,0
4754,0,0,0,0,794,202,5750,861,6611,0.0209608,-0.00453375,-0.99977,0
4521,0,0,0,0,819,229,5569,880,6449,0.0242328,-1.37097e-05,-0.999706,0
5079,0,0,0,0,898,252,6229,975,7204,0.0253964,0.00920271,-0.999635,0
4649,0,0,0,0,844,231,5724,837,6561,0.0307648,0.0225116,-0.999273,0
5061,0,0,0,0,881,236,6178,937,7115,0.0363583,0.022314,-0.99909,0
5143,0,0,0,0,872,245,6260,995,7255,0.0364914,0.0237774,-0.999051,0
5162,0,0,0,0,846,231,6239,1002,7241,0.03534,0.0235901,-0.999097,0
5128,0,0,0,0,850,233,6211,979,7190,0.0356645,0.0149817,-0.999251,0
4897,0,0,0,0,849,211,5957,838,6795,0.0320755,0.0127659,-0.999404,0
5122,0,0,0,0,870,234,6226,997,7223,0.0311684,0.00993775,-0.999465,0
5190,0,0,0,0,853,295,6338,1019,7357,0.0333942,0.0131032,-0.999356,0
5212,0,0,0,0,954,223,6389,1008,7397,0.0322439,0.0112872,-0.999416,0
5033,0,0,0,0,908,221,6162,1059,7221,0.031342,0.0123439,-0.999433,0
5335,0,0,0,0,924,254,6513,1067,7580,0.031965,0.0114267,-0.999424,0
5170,0,0,0,0,952,250,6372,976,7348,0.0313079,0.0121597,-0.999436,0
5244,0,0,0,0,883,278,6405,1293,7698,0.0308839,0.0104286,-0.999469,0
5389,0,0,0,0,868,276,6533,1035,7568,0.0365364,0.012522,-0.999254,0
5539,0,0,0,0,1060,222,6821,908,7729,0.0343492,0.014049,-0.999311,0
5017,0,0,0,0,840,213,6070,953,7023,0.0286186,0.0226107,-0.999335,0
5418,0,0,0,0,937,234,6589,938,7527,0.0291725,0.0122716,-0.999499,0
4978,0,0,0,0,896,236,6110,688,6798,0.031413,0.0152216,-0.999391,0
3643,0,0,0,0,594,163,4400,781,5181,0.0325916,0.0113328,-0.999405,0
4936,0,0,0,0,806,222,5964,834,6798,0.0328999,0.0112853,-0.999395,0
5286,0,0,0,0,1053,233,6572,985,7557,0.0296138,0.0104381,-0.999507,0
5825,0,0,0,0,884,243,6952,1008,7960,0.0299816,0.00889892,-0.999511,0
5201,0,0,0,0,888,171,6260,735,6995,0.0287744,0.0106269,-0.999529,0
3575,0,0,0,0,864,203,4642,640,5282,0.0333919,0.0135994,-0.99935,0
4724,0,0,0,0,768,225,5717,911,6628,0.0301472,0.0136043,-0.999453,0
7298,0,0,0,0,1162,308,8768,1077,9845,0.0367634,0.0188052,-0.999147,0
4551,0,0,0,0,808,236,5595,857,6452,0.03428,0.0174789,-0.999259,0
5200,0,0,0,0,856,220,6276,940,7216,0.0364864,0.0165382,-0.999197,0
5009,0,0,0,0,902,234,6145,942,7087,0.0336325,0.0144119,-0.99933,0
5105,0,0,0,0,963,247,6315,982,7297,0.0331,0.0170468,-0.999307,0
5021,0,0,0,0,940,283,6244,1051,7295,0.0343,0.0165704,-0.999274,0
5182,0,0,0,0,860,254,6296,949,7245,0.0371572,0.0187464,-0.999134,0
5054,0,0,0,0,912,262,6228,980,7208,0.0370507,0.0195697,-0.999122,0
5088,0,0,0,0,942,256,6286,970,7256,0.0370966,0.0171853,-0.999164,0
5132,0,0,0,0,893,274,6299,954,7253,0.0337839,0.0195536,-0.999238,0
5060,0,0,0,0,847,220,6127,965,7092,0.0361621,0.0179884,-0.999184,0
5141,0,0,0,0,854,220,6215,929,7144,0.0350614,0.0172709,-0.999236,0
5508,0,0,0,0,848,221,6577,938,7515,0.0337271,0.0189015,-0.999252,0
5309,0,0,0,0,909,268,6486,923,7409,0.0336028,0.0171515,-0.999288,0
5025,0,0,0,0,845,233,6103,907,7010,0.0339214,0.0194261,-0.999236,0
5009,0,0,0,0,886,275,6170,917,7087,0.0327797,0.0192277,-0.999278,0
5020,0,0,0,0,867,230,6117,941,7058,0.0337921,0.0192806,-0.999243,0
5044,0,0,0,0,873,233,6150,904,7054,0.0347935,0.0166683,-0.999256,0
5060,0,0,0,0,902,220,6182,986,7168,0.0348338,0.0184416,-0.999223,0
4619,0,0,0,0,621,168,5408,641,6049,0.03372,0.0165591,-0.999294,0
2627,0,0,0,0,471,132,3230,497,3727,0.0337285,0.0176336,-0.999275,0
5155,0,0,0,0,862,251,6268,975,7243,0.0350222,0.020844,-0.999169,0
5010,0,0,0,0,888,256,6154,926,7080,0.0335963,0.0197721,-0.99924,0
5512,0,0,0,0,938,238,6688,925,7613,0.0358526,0.0161109,-0.999227,0
5290,0,0,0,0,892,233,6415,995,7410,0.0336947,0.0134246,-0.999342,0
5056,0,0,0,0,844,261,6161,941,7102,0.0321729,0.0124193,-0.999405,0
5042,0,0,0,0,859,252,6153,918,7071,0.0318942,0.0153997,-0.999373,0
5111,0,0,0,0,889,282,6282,965,7247,0.0321892,0.0144984,-0.999377,0
5047,0,0,0,0,914,254,6215,930,7145,0.0322985,0.015872,-0.999352,0
5105,0,0,0,0,968,255,6328,947,7275,0.0320468,0.0142284,-0.999385,0
5286,0,0,0,0,909,270,6465,957,7422,0.0311286,0.0174882,-0.999362,0
5203,0,0,0,0,880,257,6340,980,7320,0.0320747,0.0180196,-0.999323,0
4994,0,0,0,0,872,221,6087,973,7060,0.0320879,0.0153295,-0.999367,0
5087,0,0,0,0,884,256,6227,1072,7299,0.0321696,0.0162093,-0.999351,0
5069,0,0,0,0,977,251,6297,958,7255,0.0319082,0.0160797,-0.999361,0
5846,0,0,0,0,904,271,7021,964,7985,0.0298449,0.0146584,-0.999447,0
5112,0,0,0,0,860,272,6244,990,7234,0.0318714,0.0117804,-0.999423,0
5192,0,0,0,0,977,265,6434,969,7403,0.034658,0.0144731,-0.999294,0
5064,0,0,0,0,1005,222,6291,973,7264,0.036176,0.0154507,-0.999226,0
5191,0,0,0,0,924,222,6337,1024,7361,0.0346759,0.0152058,-0.999283,0
5043,0,0,0,0,908,221,6172,1009,7181,0.0339262,0.011413,-0.999359,0
5403,0,0,0,0,936,220,6559,969,7528,0.0328153,0.0136456,-0.999368,0
5471,0,0,0,0,943,222,6636,958,7594,0.0350463,0.0160799,-0.999256,0
5101,0,0,0,0,846,234,6181,922,7103,0.0325971,0.0131763,-0.999382,0
5141,0,0,0,0,869,279,6289,938,7227,0.0330587,0.0127828,-0.999372,0
4960,0,0,0,0,851,235,6046,949,6995,0.032595,0.0119842,-0.999397,0
6250,0,0,0,0,865,233,7348,966,8314,0.0314561,0.00998507,-0.999455,0
5113,0,0,0,0,908,235,6256,917,7173,0.0302983,0.00998457,-0.999491,0
5036,0,0,0,0,913,237,6186,980,7166,0.0308544,0.0123065,-0.999448,0
5067,0,0,0,0,953,237,6257,939,7196,0.0331345,0.0160558,-0.999322,0
5107,0,0,0,0,879,235,6221,903,7124,0.0322894,0.0156136,-0.999357,0
5161,0,0,0,0,951,237,6349,952,7301,0.0336668,0.0189293,-0.999254,0
5205,0,0,0,0,848,233,6286,917,7203,0.0331916,0.018258,-0.999282,0
5206,0,0,0,0,852,232,6290,949,7239,0.0336801,0.0169374,-0.999289,0
5105,0,0,0,0,869,218,6192,935,7127,0.0311415,0.0144695,-0.99941,0
5081,0,0,0,0,876,219,6176,901,7077,0.0313176,0.0161999,-0.999378,0
5044,0,0,0,0,876,248,6168,913,7081,0.031018,0.0158337,-0.999393,0
5197,0,0,0,0,850,220,6267,933,7200,0.0303997,0.0157099,-0.999414,0
5078,0,0,0,0,882,219,6179,946,7125,0.0305948,0.0154296,-0.999413,0
5069,0,0,0,0,912,241,6222,940,7162,0.0294152,0.0154014,-0.999449,0
5069,0,0,0,0,871,234,6174,972,7146,0.0302936,0.0132785,-0.999453,0
5049,0,0,0,0,904,252,6205,986,7191,0.0302674,0.0144246,-0.999438,0
2758,0,0,0,0,451,123,3332,547,3879,0.0311363,0.0138693,-0.999419,0
2814,0,0,0,0,541,139,3494,555,4049,0.0301737,0.0147778,-0.999436,0
5122,0,0,0,0,901,239,6262,922,7184,0.0287221,0.0139317,-0.99949,0
5076,0,0,0,0,963,274,6313,929,7242,0.0327209,0.0137643,-0.99937,0
5127,0,0,0,0,883,289,6299,940,7239,0.033197,0.0133423,-0.99936,0
5058,0,0,0,0,914,249,6221,924,7145,0.0327188,0.0108979,-0.999405,0
5128,0,0,0,0,956,253,6337,929,7266,0.0325869,0.0134717,-0.999378,1
5276,0,0,0,0,893,243,6412,932,7344,0.0313206,0.016381,-0.999375,1
5116,0,0,0,0,885,257,6258,948,7206,0.0325422,0.0149307,-0.999359,1
5114,0,0,0,0,850,234,6198,902,7100,0.0292497,0.0147822,-0.999463,1
5802,0,0,0,0,988,250,7040,974,8014,0.0303108,0.0128568,-0.999458,1
5040,0,0,0,0,1107,271,6418,986,7404,0.0297925,0.0126884,-0.999476,1
3517,0,0,0,0,640,153,4310,632,4942,0.0308123,0.0127415,-0.999444,1
4630,0,0,0,0,849,199,5678,817,6495,0.0296988,0.0148941,-0.999448,1
5075,0,0,0,0,860,232,6167,912,7079,0.0321736,0.014691,-0.999374,1
5508,0,0,0,0,932,271,6711,905,7616,0.0292025,0.0168083,-0.999432,1
5072,0,0,0,0,979,233,6284,1002,7286,0.0291994,0.0160204,-0.999445,1
5060,0,0,0,0,925,250,6235,917,7152,0.0310911,0.0149295,-0.999405,1
4893,0,0,0,0,882,219,5994,950,6944,0.0322549,0.0157445,-0.999356,1
4635,0,0,0,0,822,283,5740,829,6569,0.0329597,0.00931713,-0.999413,1
5084,0,0,0,0,894,284,6262,942,7204,0.0314301,0.00990483,-0.999457,1
5145,0,0,0,0,904,262,6311,941,7252,0.031727,0.00930698,-0.999453,1
4959,0,0,0,0,873,195,6027,914,6941,0.031241,0.00804374,-0.99948,1
5205,0,0,0,0,937,255,6397,938,7335,0.030705,0.00910468,-0.999487,1
5079,0,0,0,0,968,226,6273,954,7227,0.0302127,0.0088776,-0.999504,1
5182,0,0,0,0,928,226,6336,953,7289,0.031253,0.00684443,-0.999488,1
5125,0,0,0,0,931,243,6299,952,7251,0.0308592,0.00805356,-0.999491,1
5069,0,0,0,0,964,220,6253,992,7245,0.0319877,0.00702769,-0.999464,1
5130,0,0,0,0,902,224,6256,952,7208,0.0325684,0.00240654,-0.999467,1
5446,0,0,0,0,894,248,6588,967,7555,0.0338961,0.00343803,-0.999419,1
5270,0,0,0,0,938,257,6465,940,7405,0.0330187,0.00377312,-0.999448,1
4898,0,0,0,0,869,216,5983,925,6908,0.0321505,0.00436467,-0.999473,1
5164,0,0,0,0,914,255,6333,970,7303,0.0302516,0.00150064,-0.999541,1
5149,0,0,0,0,867,235,6251,931,7182,0.032718,0.0046348,-0.999454,1
5169,0,0,0,0,890,221,6280,926,7206,0.0313158,0.00383562,-0.999502,1
5248,0,0,0,0,902,232,6382,1051,7433,0.0327403,0.00478274,-0.999452,1
5074,0,0,0,0,922,249,6245,919,7164,0.0310823,0.00256482,-0.999514,1
4940,0,0,0,0,866,242,6048,989,7037,0.0313866,0.00442467,-0.999498,1
4553,0,0,0,0,772,217,5542,849,6391,0.0295172,0.00436935,-0.999555,1
5294,0,0,0,0,931,258,6483,966,7449,0.0304381,0.00267967,-0.999533,1
5151,0,0,0,0,851,220,6222,961,7183,0.0341254,0.00178238,-0.999416,1
5105,0,0,0,0,958,260,6323,1020,7343,0.0286479,0.00147571,-0.999589,1
5085,0,0,0,0,941,259,6285,955,7240,0.0308443,0.00311847,-0.999519,1
5508,0,0,0,0,940,223,6671,936,7607,0.0311994,0.00241343,-0.99951,1
5310,0,0,0,0,895,258,6463,949,7412,0.0292909,0.00389277,-0.999563,1
4996,0,0,0,0,1001,258,6255,965,7220,0.027235,0.000715983,-0.999629,1
5163,0,0,0,0,900,250,6313,1002,7315,0.0273146,-0.00174212,-0.999625,1
5129,0,0,0,0,760,201,6090,837,6927,0.029703,0.000855319,-0.999558,1
4531,0,0,0,0,780,212,5523,851,6374,0.03262,0.00430882,-0.999459,1
5048,0,0,0,0,765,199,6012,853,6865,0.0329726,0.0076245,-0.999427,1
4637,0,0,0,0,802,224,5663,837,6500,0.0292047,0.00270167,-0.99957,1
4819,0,0,0,0,827,234,5880,908,6788,0.0304758,0.000201982,-0.999535,1
4623,0,0,0,0,824,227,5674,917,6591,0.0303247,-0.000909404,-0.99954,1
4636,0,0,0,0,792,246,5674,883,6557,0.0317152,-0.000766308,-0.999497,1
4614,0,0,0,0,828,214,5656,862,6518,0.0292727,0.00204965,-0.999569,1
5472,0,0,0,0,834,261,6567,1026,7593,0.0286238,0.00595822,-0.999572,1
5097,0,0,0,0,911,236,6244,947,7191,0.02705,0.00784119,-0.999603,1
5632,0,0,0,0,884,262,6778,1003,7781,0.0331671,0.00897321,-0.99941,1
5578,0,0,0,0,982,276,6836,946,7782,0.0339716,0.00499534,-0.99941,1
5513,0,0,0,0,888,227,6628,988,7616,0.0310106,0.00501178,-0.999506,1
5182,0,0,0,0,867,238,6287,1054,7341,0.0323494,-0.00370582,-0.99947,1
5210,0,0,0,0,888,264,6362,977,7339,0.0287645,-0.0022392,-0.999584,1
5200,0,0,0,0,888,242,6330,953,7283,0.0260911,0.00318553,-0.999654,1
5327,0,0,0,0,952,245,6524,1000,7524,0.0265158,0.00673732,-0.999626,1
5448,0,0,0,0,974,239,6661,1037,7698,0.0311963,0.0100732,-0.999463,1
5734,0,0,0,0,956,232,6922,976,7898,0.0362797,0.0132283,-0.999254,1
5362,0,0,0,0,961,265,6588,952,7540,0.0334609,0.0100555,-0.999389,1
5073,0,0,0,0,991,234,6298,951,7249,0.0338059,0.00594211,-0.999411,1
5075,0,0,0,0,970,246,6291,995,7286,0.0302644,0.0112547,-0.999479,1
5849,0,0,0,0,948,248,7045,924,7969,0.0296034,0.0159544,-0.999434,1
5018,0,0,0,0,1023,247,6288,988,7276,0.0308394,0.0143146,-0.999422,1
5139,0,0,0,0,972,248,6359,1012,7371,0.0332856,0.0163399,-0.999312,1
5089,0,0,0,0,920,246,6255,994,7249,0.0332106,0.0272679,-0.999076,1
5321,0,0,0,0,1007,276,6604,987,7591,0.0370726,0.0474872,-0.998184,1
5311,0,0,0,0,931,238,6480,953,7433,0.0372021,0.0571743,-0.997671,1
5397,0,0,0,0,1019,241,6657,1024,7681,0.0419992,0.0773885,-0.996116,1
5390,0,0,0,0,1032,234,6656,193,6849,0.0601933,0.130897,-0.989567,1
6103,0,0,0,0,1057,251,7411,602,8013,0.0542693,0.188448,-0.980583,1
5370,0,0,0,0,1047,253,6670,510,7180,0.0647139,0.195679,-0.97853,1
5372,0,0,0,0,1023,312,6707,445,7152,0.0629362,0.185366,-0.980652,1
5328,0,0,0,0,1005,243,6576,351,6927,0.0556986,0.174408,-0.983097,1
5325,0,0,0,0,929,241,6495,401,6896,0.0383699,0.160565,-0.986279,1
5274,0,0,0,0,989,243,6506,390,6896,0.0358426,0.120873,-0.992021,1
5380,0,0,0,0,1017,297,6694,426,7120,0.0472528,0.095974,-0.994262,1
5411,0,0,0,0,1001,280,6692,384,7076,0.0507018,0.080641,-0.995453,1
5346,0,0,0,0,946,286,6578,425,7003,0.0502942,0.0660136,-0.99655,1
5272,0,0,0,0,978,260,6510,450,6960,0.0390356,0.0752212,-0.996402,1
5196,0,0,0,0,964,243,6403,463,6866,0.032355,0.0696401,-0.997047,1
5300,0,0,0,0,978,300,6578,579,7157,0.0260929,0.0776811,-0.996637,1
5237,0,0,0,0,907,227,6371,475,6846,0.0347258,0.0743862,-0.996625,1
5022,0,0,0,0,956,249,6227,569,6796,0.0353355,0.107634,-0.993562,1
5094,0,0,0,0,868,229,6191,593,6784,0.042723,0.0950321,-0.994557,1
5172,0,0,0,0,838,216,6226,623,6849,0.0450603,0.121407,-0.991579,1
5269,0,0,0,0,798,217,6284,658,6942,0.0442148,0.111021,-0.992834,1
5432,0,0,0,0,736,196,6364,678,7042,0.046427,0.115119,-0.992266,1
5205,0,0,0,0,653,171,6029,777,6806,0.0449744,0.0956014,-0.994403,1
5287,0,0,0,0,659,159,6105,700,6805,0.0439584,0.127047,-0.990922,1
5883,0,0,0,0,688,162,6733,754,7487,0.0396448,0.11234,-0.992879,1
5109,0,0,0,0,731,198,6038,667,6705,0.0412124,0.139973,-0.989297,1
5163,0,0,0,0,673,176,6012,695,6707,0.0363109,0.121832,-0.991886,1
5175,0,0,0,0,743,180,6098,518,6616,0.0284712,0.13785,-0.990044,1
5308,0,0,0,0,792,186,6286,561,6847,0.0186826,0.123607,-0.992155,1
6391,0,0,0,0,851,259,7501,671,8172,0.0128676,0.133122,-0.991016,1
5506,0,0,0,0,838,153,6497,294,6791,0.0102356,0.148034,-0.988929,1
3984,0,0,0,0,671,177,4832,203,5035,0.0263455,0.150415,-0.988272,1
5611,0,0,0,0,939,270,6820,325,7145,0.0824874,0.0441872,-0.995612,1
4870,0,0,0,0,867,243,5980,440,6420,0.0800978,-0.00211086,-0.996785,1
5395,0,0,0,0,944,237,6576,526,7102,0.0538734,-0.0147514,-0.998439,1
4590,0,0,0,0,831,251,5672,474,6146,0.0378177,-0.0081322,-0.999252,1
5283,0,0,0,0,1397,362,7042,659,7701,0.0518132,0.00184941,-0.998655,1
4967,0,0,0,0,883,266,6116,413,6529,0.0949034,0.0584086,-0.993771,1
4856,0,0,0,0,630,179,5665,314,5979,0.107568,0.0285755,-0.993787,1
3399,0,0,0,0,673,184,4256,314,4570,0.0918325,0.0192008,-0.995589,1
5249,0,0,0,0,1099,267,6615,497,7112,0.0943137,0.0429705,-0.994615,1
5119,0,0,0,0,1148,247,6514,581,7095,0.0797671,0.0557453,-0.995254,1
5322,0,0,0,0,1089,258,6669,408,7077,0.0956318,0.0626434,-0.993444,1
5829,0,0,0,0,1231,304,7364,462,7826,0.082806,0.0621698,-0.994625,1
5825,0,0,0,0,1320,348,7493,614,8107,0.0578972,0.0651052,-0.996197,1
6282,0,0,0,0,1419,360,8061,760,8821,0.0267167,0.0432577,-0.998707,1
7005,0,0,0,0,1291,313,8609,801,9410,0.00236471,0.0407236,-0.999168,1
5792,0,0,0,0,1153,276,7221,719,7940,-0.0159628,0.0153009,-0.999756,1
6058,0,0,0,0,1280,349,7687,934,8621,-0.0120586,-0.0232558,-0.999657,1
6266,0,0,0,0,1258,308,7832,940,8772,-0.00794031,-0.0292006,-0.999542,1
6414,0,0,0,0,1198,297,7909,1010,8919,0.0066326,-0.0821832,-0.996595,1
5577,0,0,0,0,1108,287,6972,989,7961,0.0061566,-0.0962671,-0.995336,1
5256,0,0,0,0,1013,250,6519,949,7468,-0.00493024,-0.0950796,-0.995458,1
5351,0,0,0,0,1033,279,6663,845,7508,-0.0168383,-0.0715419,-0.997296,1
6234,0,0,0,0,1085,299,7618,951,8569,-0.0226613,-0.0572732,-0.998101,1
6522,0,0,0,0,1063,287,7872,861,8733,-0.0293346,-0.0286042,-0.99916,1
5715,0,0,0,0,960,241,6916,671,7587,-0.0333073,-0.0180565,-0.999282,1
5683,0,0,0,0,1075,301,7059,651,7710,-0.0158256,-0.0269658,-0.999511,1
5685,0,0,0,0,1000,273,6958,663,7621,-0.00086045,-0.011713,-0.999931,1
5573,0,0,0,0,1064,291,6928,621,7549,0.00790601,0.0209906,-0.999748,1
5651,0,0,0,0,986,277,6914,730,7644,0.0183362,0.00135855,-0.999831,1
5418,0,0,0,0,1197,299,6914,759,7673,0.0146422,0.00589614,-0.999875,1
5488,0,0,0,0,1047,246,6781,585,7366,-0.00922997,-0.00468422,-0.999946,1
5155,0,0,0,0,982,246,6383,546,6929,-0.0190247,-0.0177077,-0.999662,1
5149,0,0,0,0,1054,271,6474,587,7061,-0.0234376,-0.010007,-0.999675,1
7239,0,0,0,0,734,205,8178,369,8547,-0.0147512,0.0171081,-0.999745,1
2618,0,0,0,0,514,145,3277,284,3561,-0.00860171,-0.0237239,-0.999682,1
4962,0,0,0,0,1042,247,6251,614,6865,-0.00708346,-0.0126324,-0.999895,1
5139,0,0,0,0,993,245,6377,540,6917,-0.00718326,0.00684885,-0.999951,1
5037,0,0,0,0,911,241,6189,486,6675,-0.0285177,0.174318,-0.984276,1
6067,0,0,0,0,919,268,7254,542,7796,-0.0213509,0.113476,-0.993311,1
4979,0,0,0,0,982,241,6202,486,6688,-0.0173694,0.0590241,-0.998105,1
4196,0,0,0,0,857,213,5266,416,5682,-0.0160987,0.0729609,-0.997205,1
5245,0,0,0,0,1132,271,6648,503,7151,-0.00564669,0.0881823,-0.996088,1
5504,0,0,0,0,1104,296,6904,498,7402,0.0159679,0.0782806,-0.996803,1
5250,0,0,0,0,1150,291,6691,532,7223,0.0179981,0.0713695,-0.997288,1
5661,0,0,0,0,1118,303,7082,720,7802,0.0147928,0.0604912,-0.998059,1
5328,0,0,0,0,1145,307,6780,623,7403,0.00229509,0.0538702,-0.998545,1
5490,0,0,0,0,1163,333,6986,635,7621,-0.00337773,0.0442975,-0.999013,1
5257,0,0,0,0,1140,323,6720,801,7521,0.00393995,0.0419725,-0.999111,1
5009,0,0,0,0,1125,386,6520,921,7441,0.00857703,0.0446747,-0.998965,1
5308,0,0,0,0,1131,277,6716,817,7533,0.00874642,0.0573603,-0.998315,1
5073,0,0,0,0,1052,268,6393,780,7173,0.00702043,0.0815334,-0.996646,1
5276,0,0,0,0,1164,278,6718,944,7662,0.00165592,0.113498,-0.993537,1
5228,0,0,0,0,1122,300,6650,904,7554,-0.00145712,0.109426,-0.993994,1
5215,0,0,0,0,1165,350,6730,837,7567,0.00813068,0.105774,-0.994357,1
5284,0,0,0,0,1267,332,6883,902,7785,0.0129827,0.0970607,-0.995194,1
5423,0,0,0,0,1149,282,6854,833,7687,0.0168393,0.0895433,-0.995841,1
6214,0,0,0,0,1318,318,7850,941,8791,0.00270367,0.093568,-0.995609,1
6017,0,0,0,0,1545,331,7893,695,8588,0.0048929,0.103583,-0.994609,1
5651,0,0,0,0,1150,340,7141,423,7564,-0.00921457,0.0499483,-0.998709,1
5492,0,0,0,0,1422,438,7352,487,7839,-0.0056584,0.0118042,-0.999914,1
5455,0,0,0,0,1038,319,6812,345,7157,-0.00589,0.0188447,-0.999805,1
5181,0,0,0,0,952,263,6396,345,6741,0.00256424,0.00943597,-0.999952,1
5398,0,0,0,0,926,244,6568,380,6948,0.00843347,0.0190056,-0.999784,1
5348,0,0,0,0,812,229,6389,413,6802,0.0100517,0.0366678,-0.999277,1
6854,0,0,0,0,727,222,7803,477,8280,0.0030443,0.0319727,-0.999484,1
5416,0,0,0,0,702,205,6323,475,6798,0.0126569,0.0473781,-0.998797,1
5378,0,0,0,0,596,174,6148,504,6652,0.0239127,0.0324853,-0.999186,1
5065,0,0,0,0,452,145,5662,349,6011,0.0490062,-0.0441804,-0.997821,1
3452,0,0,0,0,272,87,3811,288,4099,0.0695091,-0.0827087,-0.994147,1
5136,0,0,0,0,454,103,5693,403,6096,0.0781145,-0.0605791,-0.995102,1
4793,0,0,0,0,458,112,5363,358,5721,0.0814566,-0.0707219,-0.994165,1
4776,0,0,0,0,480,154,5410,329,5739,0.0688757,-0.110142,-0.991526,1
4896,0,0,0,0,498,134,5528,422,5950,0.0427407,-0.102956,-0.993767,1
7559,0,0,0,0,807,275,8641,493,9134,0.045261,-0.0840082,-0.995437,1
4878,0,0,0,0,635,159,5672,404,6076,0.0544096,-0.069959,-0.996065,1
4876,0,0,0,0,665,168,5709,480,6189,0.0443359,-0.0700869,-0.996555,1
4752,0,0,0,0,707,191,5650,400,6050,0.0500792,-0.032899,-0.998203,1
4839,0,0,0,0,760,212,5811,406,6217,0.0642224,0.0120816,-0.997863,1
4984,0,0,0,0,873,227,6084,341,6425,0.110824,-0.0223412,-0.993589,1
5091,0,0,0,0,929,241,6261,615,6876,0.0621972,0.00445224,-0.998054,1
5309,0,0,0,0,1046,242,6597,331,6928,0.0378698,0.0260914,-0.998942,1
5335,0,0,0,0,1009,247,6591,355,6946,-0.0124775,0.108114,-0.99406,1
3769,0,0,0,0,747,175,4691,271,4962,-0.0172431,0.14554,-0.989202,1
5429,0,0,0,0,1017,285,6731,384,7115,-0.00579444,0.140474,-0.990067,1
5344,0,0,0,0,1066,261,6671,412,7083,0.00537555,0.144351,-0.989512,1
5679,0,0,0,0,1104,297,7080,411,7491,-0.00336288,0.205882,-0.978571,1
5910,0,0,0,0,1287,300,7497,506,8003,-0.00438682,0.178634,-0.983906,1
5808,0,0,0,0,966,239,7013,310,7323,0.00283464,0.0819083,-0.996636,1
6583,0,0,0,0,1397,359,8339,774,9113,-0.0110529,0.0529194,-0.998538,1
6647,0,0,0,0,1369,387,8403,876,9279,-0.0123397,0.0494963,-0.998698,1
6029,0,0,0,0,1369,311,7709,1050,8759,-0.0205418,0.0145726,-0.999683,1
6956,0,0,0,0,1173,291,8420,1154,9574,-0.0134552,-0.0326514,-0.999376,1
6241,0,0,0,0,1379,337,7957,983,8940,-0.0164297,-0.0427217,-0.998952,1
5153,0,0,0,0,983,242,6378,763,7141,-0.0242593,-0.0471112,-0.998595,1
6608,0,0,0,0,1086,299,7993,795,8788,-0.0236826,-0.0406907,-0.998891,1
6001,0,0,0,0,1040,255,7296,738,8034,-0.0162982,-0.0362772,-0.999209,1
5801,0,0,0,0,1102,284,7187,689,7876,-0.0120341,-0.0532399,-0.998509,1
5687,0,0,0,0,1455,374,7516,761,8277,-0.0121859,-0.0375337,-0.999221,1
5761,0,0,0,0,1037,279,7077,571,7648,0.00668513,-0.00452663,-0.999967,1
5443,0,0,0,0,1000,253,6696,565,7261,0.0056765,-0.014492,-0.999879,1
5556,0,0,0,0,1041,288,6885,532,7417,0.00807588,-0.0256138,-0.999639,1
4915,0,0,0,0,976,264,6155,444,6599,0.0041203,-0.0411907,-0.999143,1
5501,0,0,0,0,1088,311,6900,579,7479,-0.0245355,0.0654511,-0.997554,1
6832,0,0,0,0,984,272,8088,475,8563,-0.0375157,0.0456518,-0.998253,1
2765,0,0,0,0,512,143,3420,233,3653,-0.0321756,-0.0141394,-0.999382,1
3137,0,0,0,0,595,161,3893,263,4156,-0.0397896,-0.0121001,-0.999135,1
4719,0,0,0,0,832,243,5794,480,6274,-0.0445239,-0.00875832,-0.99897,1
5056,0,0,0,0,886,287,6229,537,6766,-0.0489059,0.0773683,-0.995802,1
4966,0,0,0,0,894,239,6099,406,6505,-0.0458729,0.0398752,-0.998151,1
4303,0,0,0,0,611,158,5072,274,5346,-0.0417704,0.0200079,-0.998927,1
4082,0,0,0,0,733,195,5010,337,5347,-0.033832,2.32451e-05,-0.999428,1
5214,0,0,0,0,908,266,6388,398,6786,-0.0209862,0.0122337,-0.999705,1
5310,0,0,0,0,1248,368,6926,426,7352,-0.00584986,0.00688305,-0.999959,1
5108,0,0,0,0,948,274,6330,344,6674,-0.00621658,0.000267993,-0.999981,1
5113,0,0,0,0,966,245,6324,334,6658,0.00414881,0.00836044,-0.999956,1
4773,0,0,0,0,853,219,5845,289,6134,0.00490188,0.0352948,-0.999365,1
5190,0,0,0,0,1025,277,6492,318,6810,0.00911313,0.0473134,-0.998839,1
5609,0,0,0,0,963,273,6845,296,7141,-0.00729161,0.0256401,-0.999645,1
5046,0,0,0,0,938,282,6266,265,6531,-0.0281075,0.0317435,-0.999101,1
5180,0,0,0,0,927,263,6370,230,6600,-0.0484545,-0.0125464,-0.998747,1
5006,0,0,0,0,919,260,6185,202,6387,-0.0790056,0.0580015,-0.995185,1
5066,0,0,0,0,930,262,6258,240,6498,-0.0375811,-0.00475291,-0.999282,1
4512,0,0,0,0,834,209,5555,233,5788,-0.0205901,-0.00928997,-0.999745,1
5083,0,0,0,0,998,242,6323,310,6633,-0.0167018,0.00102446,-0.99986,1
4940,0,0,0,0,1136,297,6373,272,6645,-0.0104109,0.00503587,-0.999933,1
5190,0,0,0,0,1007,256,6453,378,6831,-0.00472059,0.00990103,-0.99994,1
5333,0,0,0,0,1111,318,6762,473,7235,-0.014414,0.0129622,-0.999812,1
5368,0,0,0,0,1132,303,6803,438,7241,-0.0123932,0.0111214,-0.999861,1
5287,0,0,0,0,1107,301,6695,331,7026,-0.0182218,0.0360722,-0.999183,1
5389,0,0,0,0,1038,263,6690,243,6933,-0.0239963,0.0701699,-0.997246,1
5459,0,0,0,0,1491,283,7233,336,7569,-0.0297006,0.0911075,-0.995398,1
4910,0,0,0,0,897,229,6036,284,6320,-0.0274672,0.0657104,-0.997461,1
5240,0,0,0,0,920,249,6409,300,6709,-0.0239103,0.0614241,-0.997825,1
5031,0,0,0,0,845,217,6093,350,6443,-0.00731762,0.0218412,-0.999735,1
5846,0,0,0,0,907,230,6983,416,7399,0.00697895,0.015521,-0.999855,1
5599,0,0,0,0,761,277,6637,410,7047,0.0157682,-0.000649513,-0.999875,1
5404,0,0,0,0,682,168,6254,408,6662,0.0112045,0.0484213,-0.998764,1
5503,0,0,0,0,642,160,6305,428,6733,-0.000894218,0.0380885,-0.999274,1
6138,0,0,0,0,584,181,6903,441,7344,9.63653e-05,0.0265969,-0.999646,1
4922,0,0,0,0,397,111,5430,429,5859,0.00703063,-0.00789851,-0.999944,1
4799,0,0,0,0,368,105,5272,411,5683,0.0139081,-0.00494898,-0.999891,1
4695,0,0,0,0,366,100,5161,395,5556,0.0190983,-0.0211657,-0.999594,1
4702,0,0,0,0,404,125,5231,425,5656,0.0224448,-0.0166213,-0.99961,1
4440,0,0,0,0,479,137,5056,401,5457,0.00566402,-0.0119474,-0.999913,1
4950,0,0,0,0,662,177,5789,400,6189,-0.0108697,-0.00949852,-0.999896,1
4487,0,0,0,0,546,174,5207,347,5554,-0.019085,-0.0171951,-0.99967,1
4748,0,0,0,0,616,171,5535,317,5852,0.0029053,-0.0262334,-0.999652,1
4501,0,0,0,0,660,183,5344,322,5666,0.0236884,-0.00462785,-0.999709,1
5038,0,0,0,0,865,222,6125,312,6437,0.0707447,-0.0165464,-0.997357,1
5695,0,0,0,0,886,247,6828,389,7217,0.124106,-0.0505407,-0.990981,1
5186,0,0,0,0,1045,259,6490,427,6917,0.132979,-0.00957918,-0.991073,1
5459,0,0,0,0,1216,309,6984,480,7464,0.0808491,0.0742974,-0.993953,1
6081,0,0,0,0,1418,372,7871,624,8495,0.0697982,0.158551,-0.984881,1
6570,0,0,0,0,1443,374,8387,561,8948,0.0552688,0.177713,-0.982529,1
4029,0,0,0,0,754,194,4977,299,5276,0.0519917,0.154993,-0.986547,1
5117,0,0,0,0,1125,267,6509,509,7018,0.043272,0.130988,-0.990439,1
6340,0,0,0,0,1354,372,8066,707,8773,0.0132152,0.0635813,-0.997889,1
5938,0,0,0,0,1356,330,7624,851,8475,-0.017987,-0.0383771,-0.999101,1
6254,0,0,0,0,1241,332,7827,1022,8849,-0.0360993,-0.0381872,-0.998618,1
5982,0,0,0,0,1225,323,7530,829,8359,-0.0471945,-0.0254178,-0.998562,1
6090,0,0,0,0,1140,277,7507,720,8227,-0.0482679,-0.0235848,-0.998556,1
5116,0,0,0,0,972,246,6334,600,6934,-0.0558139,-0.00233918,-0.998438,1
5142,0,0,0,0,996,274,6412,587,6999,-0.0547504,-0.0116059,-0.998433,1
5065,0,0,0,0,1186,312,6563,548,7111,-0.0551052,-0.0215481,-0.998248,1
5667,0,0,0,0,1126,261,7054,582,7636,-0.0435751,-0.033831,-0.998477,1
5618,0,0,0,0,1136,259,7013,533,7546,-0.0347051,-0.0509689,-0.998097,1
5662,0,0,0,0,1020,260,6942,551,7493,-0.0170232,0.0681238,-0.997532,1
5967,0,0,0,0,1077,290,7334,515,7849,-0.0222746,0.0519547,-0.998401,1
2776,0,0,0,0,513,124,3413,202,3615,-0.0323298,-0.0275212,-0.999098,1
3968,0,0,0,0,700,178,4846,337,5183,-0.0253573,-0.0177542,-0.999521,1
4671,0,0,0,0,829,212,5712,370,6082,-0.0222708,0.0131852,-0.999665,1
4546,0,0,0,0,828,237,5611,395,6006,-0.0360629,0.0560365,-0.997777,1
4853,0,0,0,0,861,225,5939,403,6342,-0.0334737,0.0638388,-0.997399,1
4925,0,0,0,0,893,256,6074,373,6447,-0.0242552,0.0764501,-0.996778,1
4935,0,0,0,0,836,247,6018,352,6370,-0.0129518,0.080126,-0.996701,1
4523,0,0,0,0,735,191,5449,249,5698,-0.00362983,0.0932505,-0.995636,1
4883,0,0,0,0,902,250,6035,318,6353,-0.00453124,0.0652966,-0.997856,1
4773,0,0,0,0,848,251,5872,232,6104,-0.0141513,0.0915062,-0.995704,1
4732,0,0,0,0,795,214,5741,211,5952,0.00334522,0.0817239,-0.996649,1
4762,0,0,0,0,782,226,5770,210,5980,-0.00971322,0.0465253,-0.99887,1
5271,0,0,0,0,796,222,6289,249,6538,-0.0336177,0.0857584,-0.995749,1
4712,0,0,0,0,669,204,5585,270,5855,-0.0269008,0.086362,-0.995901,1
4517,0,0,0,0,743,216,5476,293,5769,-0.0220817,0.0546384,-0.998262,1
4528,0,0,0,0,790,194,5512,263,5775,-0.000899781,0.0456111,-0.998959,1
4917,0,0,0,0,883,275,6075,388,6463,0.00193897,0.0340903,-0.999417,1
5038,0,0,0,0,861,236,6135,313,6448,0.00437961,0.0488769,-0.998795,1
4624,0,0,0,0,828,226,5678,286,5964,0.00285377,0.0538996,-0.998542,1
4830,0,0,0,0,897,225,5952,327,6279,-0.0168336,0.066068,-0.997673,1
4774,0,0,0,0,972,253,5999,273,6272,-0.033841,0.077732,-0.9964,1
4860,0,0,0,0,945,255,6060,208,6268,-0.032057,0.103082,-0.994156,1
5123,0,0,0,0,964,243,6330,266,6596,-0.0259672,0.0870939,-0.995862,1
5065,0,0,0,0,855,241,6161,281,6442,-0.0244252,0.0599965,-0.9979,1
4999,0,0,0,0,865,224,6088,257,6345,-0.0172969,0.036392,-0.999188,1
4434,0,0,0,0,558,155,5147,161,5308,-0.0114486,0.0145476,-0.999829,1
4388,0,0,0,0,655,193,5236,233,5469,-0.00497012,-0.0148893,-0.999877,1
4868,0,0,0,0,780,233,5881,342,6223,-0.00212988,-0.0303518,-0.999537,1
4371,0,0,0,0,638,177,5186,230,5416,0.00415179,-0.0284462,-0.999587,1
4421,0,0,0,0,630,177,5228,271,5499,0.0119403,-0.0373749,-0.99923,1
4975,0,0,0,0,713,181,5869,323,6192,0.0190576,-0.0348345,-0.999211,1
4935,0,0,0,0,685,178,5798,314,6112,0.019649,-0.0270107,-0.999442,1
5684,0,0,0,0,733,179,6596,326,6922,0.0218355,-0.023502,-0.999485,1
4711,0,0,0,0,596,176,5483,300,5783,0.0238517,-0.014077,-0.999616,1
5209,0,0,0,0,737,188,6134,412,6546,0.0270998,-0.00661763,-0.999611,1
4725,0,0,0,0,578,152,5455,346,5801,0.0241619,-0.0115676,-0.999641,1
5489,0,0,0,0,642,188,6319,408,6727,0.0168378,0.000538493,-0.999858,1
4942,0,0,0,0,556,145,5643,433,6076,0.00394998,-0.000872964,-0.999992,1
4787,0,0,0,0,536,135,5458,336,5794,-0.00738071,0.00755098,-0.999944,1
5292,0,0,0,0,628,156,6076,418,6494,-0.00272872,-0.0149886,-0.999884,1
5087,0,0,0,0,498,120,5705,337,6042,-0.00207005,-0.0365174,-0.999331,1
4682,0,0,0,0,449,136,5267,368,5635,-0.00426799,-0.0525586,-0.998609,1
4717,0,0,0,0,497,128,5342,347,5689,-0.00387171,-0.0807723,-0.996725,1
4899,0,0,0,0,496,138,5533,491,6024,0.000443206,-0.0782041,-0.996937,1
4900,0,0,0,0,484,146,5530,421,5951,-0.00111351,-0.0888355,-0.996046,1
4882,0,0,0,0,485,132,5499,426,5925,0.00551344,-0.0704402,-0.997501,1
4787,0,0,0,0,476,130,5393,411,5804,0.00641462,-0.11305,-0.993569,1
4754,0,0,0,0,445,143,5342,331,5673,0.00338417,-0.238649,-0.9711,1
4973,0,0,0,0,410,130,5513,361,5874,0.00457914,-0.260187,-0.965547,1
4685,0,0,0,0,485,133,5303,312,5615,0.00943041,-0.13644,-0.990604,1
4759,0,0,0,0,550,179,5488,470,5958,0.0144707,-0.141351,-0.989854,1
4650,0,0,0,0,615,154,5419,398,5817,0.00711885,-0.103931,-0.994559,1
4641,0,0,0,0,677,190,5508,424,5932,-0.00338223,-0.131492,-0.991311,1
4780,0,0,0,0,627,183,5590,400,5990,-0.0104538,-0.0936099,-0.995554,1
4761,0,0,0,0,711,212,5684,528,6212,-0.0178677,-0.0706311,-0.997342,1
4786,0,0,0,0,724,184,5694,419,6113,-0.0251906,-0.030585,-0.999215,1
4819,0,0,0,0,710,189,5718,455,6173,-0.0331076,-0.0194911,-0.999262,1
4786,0,0,0,0,745,192,5723,486,6209,-0.032528,-0.0170368,-0.999326,1
4869,0,0,0,0,858,220,5947,422,6369,-0.0282657,0.106062,-0.993958,1
5026,0,0,0,0,977,250,6253,330,6583,0.036895,0.198769,-0.979352,1
5277,0,0,0,0,1135,285,6697,354,7051,0.108093,0.163654,-0.980578,1
5577,0,0,0,0,1312,304,7193,340,7533,0.202051,0.0590803,-0.977591,1
5692,0,0,0,0,1330,315,7337,386,7723,0.189373,0.0622138,-0.979932,1
5874,0,0,0,0,1368,373,7615,482,8097,0.14826,0.0868128,-0.985131,1
6544,0,0,0,0,1383,394,8321,594,8915,0.0893699,0.104109,-0.990542,1
6316,0,0,0,0,1422,361,8099,617,8716,0.0424764,0.0923343,-0.994822,1
4495,0,0,0,0,989,263,5747,470,6217,0.006208,0.063167,-0.997984,1
6294,0,0,0,0,1498,391,8183,732,8915,0.00400315,0.0499352,-0.998744,1
6531,0,0,0,0,1468,408,8407,740,9147,0.00802795,0.0211946,-0.999743,1
5950,0,0,0,0,1333,361,7644,804,8448,-0.0154582,-0.0612128,-0.998005,1
5860,0,0,0,0,1114,319,7293,954,8247,-0.0214786,-0.0594129,-0.998002,1
5574,0,0,0,0,1152,285,7011,804,7815,-0.0466318,-0.00727034,-0.998886,1
5570,0,0,0,0,954,256,6780,701,7481,-0.0619145,-0.00224857,-0.998079,1
5700,0,0,0,0,946,248,6894,650,7544,-0.0674739,-0.00426476,-0.997712,1
5465,0,0,0,0,951,265,6681,610,7291,-0.0615408,-0.00414945,-0.998096,1
5883,0,0,0,0,1001,236,7120,540,7660,-0.0538923,0.00764829,-0.998517,1
6197,0,0,0,0,962,237,7396,568,7964,-0.0441965,-0.00550651,-0.999008,1
5479,0,0,0,0,920,262,6661,489,7150,-0.0412784,-0.0199993,-0.998948,1
5365,0,0,0,0,991,276,6632,457,7089,-0.0381105,0.00562941,-0.999258,1
5300,0,0,0,0,901,229,6430,430,6860,-0.0396099,0.0175018,-0.999062,1
5428,0,0,0,0,1041,246,6715,466,7181,-0.0431937,0.0475724,-0.997933,1
5165,0,0,0,0,906,250,6321,413,6734,-0.038727,0.0638833,-0.997206,1
5469,0,0,0,0,1032,227,6728,392,7120,-0.0422274,0.077956,-0.996062,1
4917,0,0,0,0,883,228,6028,383,6411,-0.0403508,0.0980879,-0.994359,1
4771,0,0,0,0,858,253,5882,368,6250,-0.044797,0.0804773,-0.995749,1
4890,0,0,0,0,893,233,6016,358,6374,-0.0462821,0.0700622,-0.996468,1
4638,0,0,0,0,869,199,5706,272,5978,-0.0606015,0.0887988,-0.994204,1
4633,0,0,0,0,725,245,5603,292,5895,-0.0695174,0.126617,-0.989513,1
4679,0,0,0,0,619,176,5474,187,5661,-0.0803028,0.170046,-0.982159,1
4565,0,0,0,0,736,198,5499,229,5728,-0.0491036,0.116097,-0.992023,1
4625,0,0,0,0,728,176,5529,254,5783,-0.0525625,0.15644,-0.986288,1
4768,0,0,0,0,716,191,5675,225,5900,-0.0825037,0.149711,-0.985282,1
4926,0,0,0,0,739,235,5900,289,6189,-0.0670029,0.143275,-0.987412,1
5094,0,0,0,0,860,249,6203,270,6473,-0.0494379,0.0697603,-0.996338,1
5387,0,0,0,0,862,223,6472,274,6746,-0.024797,0.0128623,-0.99961,1
4995,0,0,0,0,856,261,6112,260,6372,-0.0269013,-0.0063896,-0.999618,1
4712,0,0,0,0,842,232,5786,238,6024,-0.0271787,-0.0189504,-0.999451,1
5430,0,0,0,0,1030,259,6719,326,7045,0.0338207,0.465133,-0.884594,1
5374,0,0,0,0,993,275,6642,223,6865,0.0718661,0.469694,-0.879899,1
6253,0,0,0,0,931,229,7413,247,7660,0.054503,0.496672,-0.866226,1
5299,0,0,0,0,797,221,6317,260,6577,0.0686931,0.549347,-0.832766,1
5219,0,0,0,0,821,227,6267,260,6527,0.0072854,0.500459,-0.865729,1
5115,0,0,0,0,696,175,5986,295,6281,-0.051213,0.0170808,-0.998542,1
5295,0,0,0,0,691,167,6153,236,6389,-0.0804003,-0.0460376,-0.995699,1
6291,0,0,0,0,697,186,7174,256,7430,-0.0763816,-0.0546604,-0.995579,1
5382,0,0,0,0,594,173,6149,227,6376,-0.0574041,-0.0958038,-0.993744,1
2753,0,0,0,0,298,85,3136,159,3295,-0.0376084,-0.0493793,-0.998072,1
5303,0,0,0,0,446,121,5870,387,6257,-0.0319537,-0.032808,-0.998951,1
5141,0,0,0,0,348,96,5585,280,5865,-0.0453719,-0.0992343,-0.994029,1
4851,0,0,0,0,314,90,5255,311,5566,-0.0466746,-0.0438857,-0.997946,1
5407,0,0,0,0,298,117,5822,337,6159,-0.0510014,-0.0241167,-0.998407,1
4830,0,0,0,0,287,86,5203,325,5528,-0.048295,-0.0278421,-0.998445,1
5827,0,0,0,0,314,91,6232,378,6610,-0.0444915,-0.0280537,-0.998616,1
4800,0,0,0,0,520,148,5468,407,5875,-0.0358169,-0.0202731,-0.999153,1
4549,0,0,0,0,380,109,5038,327,5365,-0.0472324,-0.0459669,-0.997826,1
4963,0,0,0,0,508,124,5595,418,6013,-0.0618399,-0.0189671,-0.997906,1
4829,0,0,0,0,537,158,5524,390,5914,-0.0726755,-0.0121295,-0.997282,1
4760,0,0,0,0,556,195,5511,395,5906,-0.077707,-0.0111273,-0.996914,1
4540,0,0,0,0,566,150,5256,321,5577,-0.0621756,-0.0272863,-0.997692,1
4660,0,0,0,0,585,186,5431,347,5778,-0.0613367,-0.0376593,-0.997406,1
4471,0,0,0,0,557,150,5178,361,5539,-0.0680307,-0.0453053,-0.996654,1
4522,0,0,0,0,572,153,5247,424,5671,-0.0603784,-0.0314183,-0.997681,1
4569,0,0,0,0,710,185,5464,427,5891,-0.0515859,-0.0175028,-0.998515,1
4687,0,0,0,0,681,189,5557,300,5857,-0.024507,0.0126059,-0.99962,1
4957,0,0,0,0,809,207,5973,296,6269,0.028558,0.00520983,-0.999579,1
5017,0,0,0,0,886,235,6138,349,6487,0.0952009,-0.0373479,-0.994757,1
5549,0,0,0,0,1042,283,6874,407,7281,0.0550475,0.00148866,-0.998483,1
6468,0,0,0,0,1418,305,8191,483,8674,0.00964944,0.0795787,-0.996782,1
6110,0,0,0,0,1282,310,7702,536,8238,-0.0142165,0.10742,-0.994112,1
6270,0,0,0,0,1370,341,7981,536,8517,-0.00590577,0.125606,-0.992063,1
6315,0,0,0,0,1352,336,8003,543,8546,0.0207544,0.158639,-0.987119,1
6028,0,0,0,0,1337,320,7685,569,8254,0.0266301,0.166675,-0.985652,1
5932,0,0,0,0,1170,297,7399,546,7945,0.00416221,0.152502,-0.988294,1
5863,0,0,0,0,1037,257,7157,536,7693,-0.0415602,-0.0565838,-0.997532,1
5660,0,0,0,0,966,243,6869,835,7704,-0.0632175,-0.0844261,-0.994422,1
5862,0,0,0,0,1000,239,7101,766,7867,-0.0679445,-0.0804324,-0.994442,1
6214,0,0,0,0,1001,272,7487,701,8188,-0.0641303,-0.0578778,-0.996262,1
5615,0,0,0,0,1015,270,6900,648,7548,-0.0594937,-0.0552224,-0.9967,1
6226,0,0,0,0,951,266,7443,632,8075,-0.0526311,-0.0548195,-0.997108,1
5590,0,0,0,0,946,282,6818,573,7391,-0.0506059,-0.0743127,-0.99595,1
5787,0,0,0,0,923,250,6960,520,7480,-0.0320975,-0.062029,-0.997558,1
5592,0,0,0,0,1022,256,6870,521,7391,-0.0333519,-0.0675218,-0.99716,1
5630,0,0,0,0,948,255,6833,486,7319,-0.0411606,-0.0663662,-0.996946,1
5507,0,0,0,0,944,255,6706,490,7196,-0.0349675,0.0696688,-0.996957,1
5510,0,0,0,0,953,295,6758,441,7199,-0.0551329,0.0706432,-0.995977,1
3552,0,0,0,0,476,149,4177,222,4399,-0.0597402,-0.00729516,-0.998187,1
2111,0,0,0,0,365,110,2586,174,2760,-0.0669054,-0.0181988,-0.997593,1
4945,0,0,0,0,791,287,6023,381,6404,-0.0724802,0.0111917,-0.997307,1
4610,0,0,0,0,728,206,5544,399,5943,-0.0778947,0.0443929,-0.995973,1
4744,0,0,0,0,745,198,5687,356,6043,-0.0658386,0.0407469,-0.996998,1
4453,0,0,0,0,685,197,5335,389,5724,-0.0671518,0.0289848,-0.997322,1
4506,0,0,0,0,660,175,5341,296,5637,-0.0518243,0.038094,-0.997929,1
4452,0,0,0,0,673,183,5308,271,5579,-0.0450188,0.0577156,-0.997318,1
4546,0,0,0,0,585,175,5306,216,5522,-0.0691082,0.0642621,-0.995537,1
4470,0,0,0,0,580,171,5221,286,5507,-0.0485643,0.0135914,-0.998728,1
4509,0,0,0,0,519,156,5184,195,5379,-0.0677389,0.0272259,-0.997332,1
5467,0,0,0,0,487,161,6115,243,6358,0.089538,0.217023,-0.972051,1
4569,0,0,0,0,488,123,5180,239,5419,0.0462346,0.218166,-0.974816,1
4899,0,0,0,0,519,133,5551,240,5791,0.0686831,0.143564,-0.987255,1
5027,0,0,0,0,641,188,5856,241,6097,0.142444,0.237807,-0.960811,1
5250,0,0,0,0,748,208,6206,249,6455,0.0658296,0.0620725,-0.995898,1
5359,0,0,0,0,762,226,6347,239,6586,0.0725017,0.0311283,-0.996882,1
5200,0,0,0,0,868,213,6281,250,6531,0.151581,0.00539826,-0.98843,1
5340,0,0,0,0,960,233,6533,178,6711,-0.122841,-0.112436,-0.986037,1
4714,0,0,0,0,846,205,5765,-1000,-1000,-1,-1,-1,1
4550,0,0,0,0,817,187,5554,206,5760,-0.0511893,0.120255,-0.991422,1
5153,0,0,0,0,882,198,6233,210,6443,-0.068289,-0.0186206,-0.997492,1
4944,0,0,0,0,693,196,5833,-1000,-1000,-1,-1,-1,1
4991,0,0,0,0,635,167,5793,248,6041,-0.0356235,-0.0606425,-0.997524,1
5064,0,0,0,0,601,173,5838,254,6092,-0.0237399,-0.0315904,-0.999219,1
5398,0,0,0,0,583,169,6150,284,6434,-0.0197585,-0.0144573,-0.9997,1
5495,0,0,0,0,574,164,6233,298,6531,-0.0204704,-0.00635965,-0.99977,1
5388,0,0,0,0,611,151,6150,380,6530,-0.0277961,-0.0417945,-0.998739,1
5401,0,0,0,0,595,146,6142,400,6542,-0.0271225,-0.0596802,-0.997849,1
5233,0,0,0,0,621,152,6006,443,6449,-0.0193604,-0.0715737,-0.997247,1
5301,0,0,0,0,619,153,6073,437,6510,0.00396746,-0.087008,-0.9962,1
5100,0,0,0,0,606,149,5855,417,6272,0.0035382,-0.0918076,-0.995771,1
4960,0,0,0,0,538,142,5640,372,6012,-0.0126267,-0.0705107,-0.997431,1
4784,0,0,0,0,503,136,5423,385,5808,-0.0246219,-0.0760646,-0.996799,1
4842,0,0,0,0,477,127,5446,387,5833,-0.0326523,-0.0491381,-0.998258,1
4691,0,0,0,0,453,125,5269,477,5746,-0.0409872,-0.0363302,-0.998499,1
4619,0,0,0,0,490,190,5299,443,5742,-0.0383171,-0.0366962,-0.998592,1
5220,0,0,0,0,474,131,5825,431,6256,-0.0300156,-0.0254178,-0.999226,1
4596,0,0,0,0,415,137,5148,456,5604,-0.0340627,-0.0255655,-0.999093,1
4424,0,0,0,0,452,142,5018,499,5517,-0.013796,-0.0321619,-0.999387,1
4235,0,0,0,0,445,111,4791,440,5231,-0.00813074,-0.023879,-0.999682,1
4396,0,0,0,0,770,182,5348,578,5926,-0.0527595,0.073446,-0.995903,1
3767,0,0,0,0,406,122,4295,307,4602,-0.0554084,0.00342296,-0.998458,1
2365,0,0,0,0,383,108,2856,253,3109,-0.059026,-0.0422487,-0.997362,1
5062,0,0,0,0,919,262,6243,478,6721,-0.0875735,-0.047558,-0.995022,1
5071,0,0,0,0,976,239,6286,554,6840,-0.0885782,-0.0615706,-0.994164,1
6098,0,0,0,0,1123,295,7516,575,8091,-0.0773401,-0.0608763,-0.995145,1
5580,0,0,0,0,1273,317,7170,602,7772,-0.0902311,-0.0727439,-0.993261,1
6170,0,0,0,0,1437,349,7956,709,8665,-0.0706857,-0.045055,-0.996481,1
6549,0,0,0,0,1633,415,8597,780,9377,-0.0432939,-0.0427844,-0.998146,1
6414,0,0,0,0,1602,415,8431,820,9251,-0.035731,-0.0492356,-0.998148,1
6708,0,0,0,0,1478,381,8567,854,9421,-0.0319462,-0.0572781,-0.997847,1
6077,0,0,0,0,1494,361,7932,958,8890,-0.027349,-0.0951561,-0.995087,1
6299,0,0,0,0,1364,325,7988,963,8951,-0.0363029,-0.107561,-0.993536,1
5775,0,0,0,0,1272,299,7346,813,8159,-0.045719,-0.0890307,-0.994979,1
5978,0,0,0,0,1125,310,7413,695,8108,-0.0447304,-0.0712426,-0.996456,1
5628,0,0,0,0,1093,303,7024,609,7633,-0.0417559,-0.0717407,-0.996549,1
5891,0,0,0,0,1118,274,7283,612,7895,-0.0316459,-0.0406434,-0.998672,1
5734,0,0,0,0,1020,274,7028,500,7528,-0.0285918,-0.0550428,-0.998075,1
5989,0,0,0,0,1014,271,7274,508,7782,-0.0363339,-0.0794837,-0.996174,1
5826,0,0,0,0,997,289,7112,488,7600,-0.0432764,-0.0675255,-0.996779,1
5760,0,0,0,0,987,288,7035,497,7532,-0.0481209,-0.0594487,-0.997071,1
5470,0,0,0,0,979,275,6724,467,7191,-0.0559463,-0.0288252,-0.998018,1
5139,0,0,0,0,906,253,6298,413,6711,-0.058298,-0.013683,-0.998205,1
5141,0,0,0,0,833,239,6213,398,6611,-0.0685138,-0.013539,-0.997558,1
4521,0,0,0,0,688,199,5408,357,5765,-0.0577038,0.0113423,-0.998269,1
4348,0,0,0,0,644,189,5181,391,5572,-0.0452829,0.0317809,-0.998469,1
4377,0,0,0,0,692,176,5245,282,5527,-0.0303719,0.10232,-0.994288,1
4388,0,0,0,0,626,168,5182,277,5459,-0.0313317,0.115526,-0.99281,1
4269,0,0,0,0,584,168,5021,288,5309,-0.0316932,0.110793,-0.993338,1
4243,0,0,0,0,583,161,4987,253,5240,-0.0363394,0.241847,-0.969634,1
4236,0,0,0,0,537,158,4931,214,5145,-0.0479569,0.232696,-0.971366,1
4482,0,0,0,0,608,186,5276,214,5490,-0.0762057,0.247073,-0.965996,1
4783,0,0,0,0,697,165,5645,360,6005,-0.0615853,0.0624439,-0.996147,1
5050,0,0,0,0,851,224,6125,331,6456,-0.0395398,0.106652,-0.99351,1
5073,0,0,0,0,888,243,6204,221,6425,-0.0169078,0.188753,-0.981879,1
5852,0,0,0,0,1049,291,7192,259,7451,0.0194103,0.196499,-0.980312,1
5502,0,0,0,0,1058,305,6865,313,7178,0.0298252,0.17613,-0.983915,1
5468,0,0,0,0,1133,306,6907,290,7197,0.00678204,0.169911,-0.985436,1
5735,0,0,0,0,1284,318,7337,274,7611,-0.0252212,0.125968,-0.991714,1
5275,0,0,0,0,1024,260,6559,265,6824,0.0442841,0.100213,-0.99398,1
5152,0,0,0,0,707,208,6067,177,6244,0.0413447,-0.0169453,-0.999001,1
3810,0,0,0,0,728,197,4735,165,4900,0.0162843,-0.069563,-0.997445,1
5565,0,0,0,0,1007,278,6850,238,7088,0.00952384,-0.0763838,-0.997033,1
5472,0,0,0,0,890,235,6597,253,6850,-0.00927317,-0.0606816,-0.998114,1
5581,0,0,0,0,937,242,6760,240,7000,-0.0279607,0.00346182,-0.999603,1
5404,0,0,0,0,849,232,6485,252,6737,-0.0363645,0.0122367,-0.999264,1
5998,0,0,0,0,896,215,7109,284,7393,-0.0385876,-0.0279183,-0.998865,1
5390,0,0,0,0,805,265,6460,350,6810,-0.030422,-0.0413426,-0.998682,1
5932,0,0,0,0,761,197,6890,337,7227,-0.0199099,-0.0500445,-0.998549,1
5512,0,0,0,0,731,204,6447,347,6794,-0.0140305,-0.0549479,-0.998391,1
5381,0,0,0,0,684,177,6242,336,6578,-0.00846629,-0.0522405,-0.998599,1
5272,0,0,0,0,561,150,5983,367,6350,-0.0081783,-0.0498035,-0.998726,1
5478,0,0,0,0,428,119,6025,413,6438,0.000320364,0.042881,-0.99908,1
4520,0,0,0,0,285,85,4890,405,5295,-0.00125864,0.00659972,-0.999977,1
3949,0,0,0,0,177,53,4179,253,4432,-0.0038983,-0.0736359,-0.997278,1
4268,0,0,0,0,300,87,4655,431,5086,-0.0182095,-0.0755477,-0.996976,1
5482,0,0,0,0,334,99,5915,391,6306,-0.0308471,-0.0397797,-0.998732,1
4161,0,0,0,0,280,93,4534,327,4861,-0.0193595,-0.0651073,-0.99769,1
4041,0,0,0,0,291,92,4424,369,4793,-0.0226843,-0.0642812,-0.997674,1
4389,0,0,0,0,362,124,4875,399,5274,-0.0202838,-0.0318596,-0.999287,1
5306,0,0,0,0,442,149,5897,480,6377,-0.0318258,0.00160823,-0.999492,1
4787,0,0,0,0,536,136,5459,425,5884,-0.0487413,-0.0310982,-0.998327,1
4438,0,0,0,0,483,151,5072,421,5493,-0.0484609,-0.0298949,-0.998378,1
4335,0,0,0,0,512,127,4974,280,5254,-0.0330389,0.0347034,-0.998851,1
4612,0,0,0,0,548,141,5301,270,5571,0.011226,0.135946,-0.990653,1
5399,0,0,0,0,673,166,6238,252,6490,0.0496868,0.260982,-0.964064,1
5544,0,0,0,0,847,214,6605,315,6920,0.0389544,0.31936,-0.946832,1
5406,0,0,0,0,1127,299,6832,379,7211,0.0223895,0.365789,-0.930429,1
5523,0,0,0,0,1311,313,7147,336,7483,0.0176134,0.396567,-0.917837,1
6218,0,0,0,0,1433,347,7998,324,8322,0.0237121,0.451113,-0.892152,1
6554,0,0,0,0,1659,449,8662,387,9049,0.0292588,0.499947,-0.865562,1
6413,0,0,0,0,1621,442,8476,413,8889,0.0304437,0.558877,-0.828691,1
4967,0,0,0,0,1270,270,6507,319,6826,0.0476984,0.641005,-0.766053,1
5663,0,0,0,0,1261,345,7269,-1000,-1000,-1,-1,-1,1
5628,0,0,0,0,1168,316,7112,710,7822,-0.00953833,-0.049511,-0.998728,1
5451,0,0,0,0,1091,360,6902,819,7721,-0.0108425,-0.0674265,-0.997665,1
6050,0,0,0,0,1067,296,7413,576,7989,-0.0225867,-0.0726338,-0.997103,1
5231,0,0,0,0,1044,258,6533,554,7087,-0.0387413,-0.0764074,-0.996324,1
6066,0,0,0,0,1127,314,7507,563,8070,-0.0401881,-0.0809168,-0.99591,1
6746,0,0,0,0,1237,319,8302,587,8889,-0.0431468,-0.0928041,-0.994749,1
7075,0,0,0,0,1200,290,8565,554,9119,-0.0441618,-0.0870897,-0.995221,1
6053,0,0,0,0,1151,332,7536,514,8050,-0.0404704,-0.0867884,-0.995404,1
4845,0,0,0,0,749,186,5780,322,6102,-0.0396162,-0.102309,-0.993963,1
4976,0,0,0,0,872,233,6081,383,6464,-0.024288,-0.0969565,-0.994992,1
5363,0,0,0,0,945,277,6585,456,7041,-0.0375331,-0.106654,-0.993588,1
5088,0,0,0,0,867,231,6186,398,6584,-0.0480423,-0.0696718,-0.996412,1
5129,0,0,0,0,811,206,6146,391,6537,-0.0561135,-0.0460831,-0.99736,1
4707,0,0,0,0,835,223,5765,391,6156,-0.0695833,-0.044412,-0.996587,1
5325,0,0,0,0,693,200,6218,344,6562,-0.058915,-0.022943,-0.997999,1
4285,0,0,0,0,585,173,5043,391,5434,-0.042558,-0.0181844,-0.998929,1
4654,0,0,0,0,685,202,5541,433,5974,-0.0317611,0.0065278,-0.999474,1
4229,0,0,0,0,562,184,4975,334,5309,-0.0282786,0.0217927,-0.999363,1
4093,0,0,0,0,622,172,4887,396,5283,-0.0210578,0.0569595,-0.998154,1
4186,0,0,0,0,519,143,4848,264,5112,-0.0142983,0.147488,-0.98896,1
4386,0,0,0,0,562,235,5183,218,5401,-0.00894387,0.163683,-0.986473,1
4184,0,0,0,0,764,209,5157,275,5432,-0.0294596,0.0358372,-0.998923,1
2908,0,0,0,0,388,113,3409,151,3560,-0.00461767,0.112786,-0.993609,1
3945,0,0,0,0,565,157,4667,201,4868,-0.00164523,0.0979638,-0.995189,1
4533,0,0,0,0,602,183,5318,219,5537,0.0162132,0.190325,-0.981587,1
4638,0,0,0,0,752,210,5600,249,5849,-0.0204582,0.202282,-0.979114,1
5056,0,0,0,0,892,243,6191,255,6446,-0.073633,0.143426,-0.986918,1
5646,0,0,0,0,1022,275,6943,260,7203,-0.0816005,0.0791331,-0.993519,1
5741,0,0,0,0,1157,299,7197,231,7428,-0.023843,0.0584427,-0.998006,1
5722,0,0,0,0,1141,282,7145,224,7369,-0.0184182,0.0791546,-0.996692,1
5545,0,0,0,0,1059,309,6913,218,7131,-0.00799009,0.0747103,-0.997173,1
5578,0,0,0,0,972,260,6810,215,7025,-0.0116584,0.0656025,-0.997778,1
6267,0,0,0,0,882,225,7374,261,7635,-0.0196189,0.0478019,-0.998664,1
5327,0,0,0,0,708,180,6215,292,6507,0.000991858,0.0451293,-0.998981,1
5301,0,0,0,0,532,145,5978,307,6285,-0.00235175,0.0096663,-0.999951,1
4623,0,0,0,0,457,121,5201,350,5551,0.00543696,-0.0131297,-0.999899,1
4827,0,0,0,0,438,113,5378,357,5735,0.0102048,-0.0159488,-0.999821,1
4656,0,0,0,0,478,147,5281,378,5659,-0.00139931,-0.0318379,-0.999492,1
4448,0,0,0,0,444,127,5019,358,5377,-0.00383686,-0.0532414,-0.998574,1
4810,0,0,0,0,443,116,5369,365,5734,-0.00130746,-0.0563872,-0.998408,1
4321,0,0,0,0,426,124,4871,332,5203,0.00679124,-0.0774724,-0.996971,1
5624,0,0,0,0,389,119,6132,336,6468,0.00987778,-0.0697421,-0.997516,1
4245,0,0,0,0,349,114,4708,326,5034,0.0101563,-0.0830679,-0.996492,1
4408,0,0,0,0,318,108,4834,318,5152,0.00981059,-0.0957081,-0.995361,1
4178,0,0,0,0,302,92,4572,286,4858,0.00559737,-0.127994,-0.991759,1
4227,0,0,0,0,281,83,4591,352,4943,0.00555288,-0.139812,-0.990162,1
4438,0,0,0,0,266,86,4790,251,5041,0.0265913,-0.22825,-0.973239,1
4133,0,0,0,0,270,74,4477,249,4726,0.0288838,-0.206191,-0.978085,1
3926,0,0,0,0,277,95,4298,280,4578,0.0452307,-0.268592,-0.962192,1
3994,0,0,0,0,257,69,4320,260,4580,0.0515177,-0.347792,-0.936155,1
3840,0,0,0,0,304,82,4226,313,4539,0.0387282,-0.434831,-0.899679,1
3966,0,0,0,0,373,87,4426,258,4684,0.0699738,-0.371169,-0.925925,1
3796,0,0,0,0,343,97,4236,266,4502,0.0184256,-0.463359,-0.885979,1
3790,0,0,0,0,348,116,4254,401,4655,0.00578792,-0.323488,-0.946215,1
3817,0,0,0,0,426,136,4379,397,4776,0.0127089,-0.202231,-0.979255,1
4000,0,0,0,0,444,121,4565,429,4994,0.0170113,-0.0956007,-0.995274,1
3971,0,0,0,0,448,115,4534,361,4895,0.00994976,-0.068359,-0.997611,1
3919,0,0,0,0,406,142,4467,431,4898,0.00766237,-0.0302127,-0.999514,1
4103,0,0,0,0,451,123,4677,361,5038,0.00132847,-0.0132273,-0.999912,1
3995,0,0,0,0,614,139,4748,288,5036,0.0726475,-0.00209345,-0.997355,1
4338,0,0,0,0,656,147,5141,316,5457,0.141627,0.0377621,-0.9892,1
4471,0,0,0,0,766,240,5477,465,5942,0.187494,-0.0239394,-0.981974,1
6070,0,0,0,0,1193,242,7505,512,8017,0.201785,-0.0692136,-0.976981,1
4628,0,0,0,0,1032,258,5918,571,6489,0.221182,-0.0847209,-0.971545,1
4799,0,0,0,0,988,255,6042,609,6651,0.215522,-0.0799888,-0.973217,1
4987,0,0,0,0,1167,271,6425,644,7069,0.221924,-0.0492875,-0.973817,1
5441,0,0,0,0,1236,317,6994,722,7716,0.213084,-0.0212733,-0.976802,1
5953,0,0,0,0,1763,382,8098,709,8807,0.181075,0.0300555,-0.98301,1
5654,0,0,0,0,1551,427,7632,738,8370,0.160782,0.082273,-0.983555,1
6386,0,0,0,0,1491,414,8291,688,8979,0.13173,0.0988956,-0.98634,1
5899,0,0,0,0,1682,373,7954,650,8604,0.1092,0.106687,-0.988278,1
6227,0,0,0,0,1620,399,8246,698,8944,0.0813385,0.105845,-0.99105,1
6075,0,0,0,0,1581,467,8123,833,8956,0.063146,0.10083,-0.992898,1
6254,0,0,0,0,1637,370,8261,672,8933,0.0445654,0.108651,-0.99308,1
6549,0,0,0,0,1515,364,8428,708,9136,0.0290102,0.0888757,-0.99562,1
6211,0,0,0,0,1413,347,7971,731,8702,0.025161,0.0789868,-0.996558,1
6225,0,0,0,0,1461,415,8101,788,8889,0.0343555,0.0768066,-0.996454,1
6329,0,0,0,0,1616,332,8277,767,9044,0.0177684,0.0100439,-0.999792,1
4155,0,0,0,0,802,217,5174,633,5807,0.0017103,-0.0102748,-0.999946,1
5867,0,0,0,0,1128,283,7278,775,8053,-0.00910546,-0.00462048,-0.999948,1
5885,0,0,0,0,1106,294,7285,612,7897,-0.00786446,0.00762175,-0.99994,1
5741,0,0,0,0,1113,299,7153,545,7698,0.00535425,0.0234081,-0.999712,1
6167,0,0,0,0,1116,321,7604,496,8100,0.00576424,0.0683518,-0.997645,1
5584,0,0,0,0,1058,272,6914,418,7332,-0.0153863,0.0339649,-0.999305,1
5183,0,0,0,0,892,227,6302,370,6672,-0.0292031,-0.0231323,-0.999306,1
5436,0,0,0,0,950,287,6673,431,7104,-0.0413599,-0.0334139,-0.998585,1
5469,0,0,0,0,917,224,6610,396,7006,-0.04288,-0.030623,-0.998611,1
4856,0,0,0,0,844,242,5942,419,6361,-0.0409245,-0.0354603,-0.998533,1
4631,0,0,0,0,711,186,5528,389,5917,-0.0320339,-0.0291898,-0.999061,1
4823,0,0,0,0,690,206,5719,368,6087,-0.0251636,-0.0530282,-0.998276,1
4397,0,0,0,0,656,190,5243,366,5609,-0.0301853,-0.0738267,-0.996814,1
4439,0,0,0,0,646,180,5265,356,5621,-0.0254991,-0.0741644,-0.99692,1
4209,0,0,0,0,594,203,5006,355,5361,-0.0201218,-0.11496,-0.993166,1
4344,0,0,0,0,634,175,5153,374,5527,-0.0195575,-0.101723,-0.99462,1
4207,0,0,0,0,518,145,4870,369,5239,-0.0155984,-0.107519,-0.994081,1
4232,0,0,0,0,532,140,4904,322,5226,-0.0133514,-0.0965489,-0.995239,1
4174,0,0,0,0,546,137,4857,325,5182,-0.02802,-0.096118,-0.994976,1
4119,0,0,0,0,478,144,4741,325,5066,-0.0314009,-0.0635882,-0.997482,1
4247,0,0,0,0,476,144,4867,300,5167,-0.0349283,-0.00315536,-0.999385,1
4008,0,0,0,0,496,133,4637,291,4928,-0.0408736,0.0251159,-0.998849,1
4307,0,0,0,0,473,130,4910,259,5169,-0.0431314,0.0216547,-0.998835,1
4154,0,0,0,0,460,127,4741,204,4945,-0.0296376,0.0523296,-0.99819,1
3927,0,0,0,0,440,124,4491,181,4672,-0.0138499,0.0715798,-0.997339,1
4184,0,0,0,0,481,133,4798,282,5080,-0.0138512,0.111318,-0.993688,1
4827,0,0,0,0,883,179,5889,225,6114,0.0503823,0.186879,-0.98109,1
4605,0,0,0,0,729,187,5521,230,5751,0.0338712,0.248088,-0.968145,1
4613,0,0,0,0,722,195,5530,219,5749,-0.0630292,0.406425,-0.911508,1
5092,0,0,0,0,1241,272,6605,302,6907,-0.153603,0.578319,-0.80122,1
6167,0,0,0,0,981,285,7433,-1000,-1000,-1,-1,-1,1
5523,0,0,0,0,1115,314,6952,357,7309,0.356737,0.0775658,-0.930979,1
5972,0,0,0,0,1150,311,7433,228,7661,-0.221946,0.181196,-0.958075,1
5566,0,0,0,0,1568,422,7556,237,7793,-0.290946,0.248964,-0.923779,1
4010,0,0,0,0,737,209,4956,264,5220,-0.140711,0.642864,-0.752945,1
4835,0,0,0,0,953,291,6079,307,6386,-0.180268,0.608381,-0.772901,1
5674,0,0,0,0,1051,262,6987,288,7275,-0.15068,0.673182,-0.723962,1
5419,0,0,0,0,1056,289,6764,300,7064,-0.145306,0.666516,-0.731193,1
5389,0,0,0,0,1023,285,6697,-1000,-1000,-1,-1,-1,1
5297,0,0,0,0,997,246,6540,305,6845,0.0422369,0.011926,-0.999036,1
5293,0,0,0,0,937,224,6454,323,6777,0.0357586,0.0541339,-0.997893,1
5220,0,0,0,0,843,207,6270,369,6639,0.0216632,0.0308962,-0.999288,1
5268,0,0,0,0,773,197,6238,366,6604,-0.000620428,0.104743,-0.994499,1
5951,0,0,0,0,667,196,6814,396,7210,-0.0121038,0.116619,-0.993103,1
4854,0,0,0,0,442,120,5416,389,5805,0.000882443,0.107027,-0.994256,1
4667,0,0,0,0,411,117,5195,402,5597,0.0138959,0.0362777,-0.999245,1
4766,0,0,0,0,299,106,5171,382,5553,0.0239011,0.0858449,-0.996022,1
4415,0,0,0,0,247,65,4727,381,5108,0.0143078,0.0161418,-0.999767,1
3151,0,0,0,0,175,41,3367,271,3638,0.0167887,-0.00460512,-0.999848,1
4050,0,0,0,0,145,48,4243,449,4692,0.0280018,-0.0074575,-0.99958,1
4102,0,0,0,0,136,50,4288,390,4678,0.0430138,0.0167455,-0.998934,1
4008,0,0,0,0,134,57,4199,405,4604,0.0191645,-0.0309434,-0.999337,1
4172,0,0,0,0,133,58,4363,376,4739,0.0193699,-0.0357792,-0.999172,1
4210,0,0,0,0,163,55,4428,403,4831,0.021067,-0.0367103,-0.999104,1
3888,0,0,0,0,162,68,4118,392,4510,0.00967438,-0.0438312,-0.998992,1
4157,0,0,0,0,183,77,4417,438,4855,-0.00945426,-0.0370151,-0.99927,1
3959,0,0,0,0,257,81,4297,432,4729,-0.0180335,-0.0428737,-0.998918,1
4460,0,0,0,0,348,90,4898,485,5383,-0.038441,-0.0346607,-0.99866,1
4123,0,0,0,0,443,110,4676,524,5200,-0.0546858,-0.0314593,-0.998008,1
4654,0,0,0,0,604,152,5410,540,5950,-0.0649384,-0.0070815,-0.997864,1
5083,0,0,0,0,839,188,6110,428,6538,-0.0577133,-0.00602675,-0.998315,1
4942,0,0,0,0,986,250,6178,350,6528,-0.0654626,0.115392,-0.991161,1
5265,0,0,0,0,1238,318,6821,267,7088,0.0340123,0.210525,-0.976997,1
5612,0,0,0,0,1445,337,7394,333,7727,0.0693212,0.314892,-0.946593,1
5916,0,0,0,0,1575,429,7920,427,8347,0.114876,0.333648,-0.935672,1
4202,0,0,0,0,1179,273,5654,318,5972,0.132097,0.346196,-0.928816,1
6183,0,0,0,0,1622,395,8200,443,8643,0.145032,0.38749,-0.910394,1
5605,0,0,0,0,1377,336,7318,374,7692,0.141075,0.393957,-0.908238,1
6101,0,0,0,0,1493,370,7964,474,8438,0.128752,0.406428,-0.904566,1
6238,0,0,0,0,1435,367,8040,494,8534,0.108452,0.402209,-0.909102,1
6023,0,0,0,0,1423,382,7828,527,8355,0.0857951,0.400936,-0.91208,1
6012,0,0,0,0,1254,296,7562,553,8115,0.0825376,0.416446,-0.905406,1
5810,0,0,0,0,1267,275,7352,471,7823,0.0934889,0.488953,-0.867286,1
5781,0,0,0,0,1050,250,7081,480,7561,0.101408,0.566947,-0.817489,1
5372,0,0,0,0,916,229,6517,412,6929,0.131403,0.669365,-0.731221,1
5669,0,0,0,0,945,258,6872,-1000,-1000,-1,-1,-1,1
5727,0,0,0,0,969,267,6963,526,7489,-0.0118403,0.04787,-0.998783,1
5324,0,0,0,0,905,257,6486,535,7021,-0.00672329,0.0602081,-0.998163,1
5525,0,0,0,0,787,207,6519,494,7013,0.00692273,0.0905126,-0.995871,1
4924,0,0,0,0,793,208,5925,463,6388,-0.00609417,0.0730977,-0.997306,1
4528,0,0,0,0,623,164,5315,396,5711,-0.0146128,0.104355,-0.994433,1
4261,0,0,0,0,571,153,4985,355,5340,-0.0177434,0.108861,-0.993899,1
4767,0,0,0,0,547,152,5466,351,5817,-0.0180423,0.120298,-0.992574,1
4255,0,0,0,0,572,173,5000,368,5368,-0.0042942,0.189289,-0.981912,1
4251,0,0,0,0,524,169,4944,349,5293,-0.010593,0.142072,-0.9898,1
4259,0,0,0,0,533,173,4965,353,5318,0.0084458,0.202832,-0.979177,1
4198,0,0,0,0,622,154,4974,289,5263,-0.00672196,0.177984,-0.98401,1
4243,0,0,0,0,558,138,4939,281,5220,0.0153698,0.21363,-0.976794,1
3882,0,0,0,0,399,119,4400,181,4581,0.0144406,0.211108,-0.977356,1
4500,0,0,0,0,560,150,5210,211,5421,0.0111345,0.214307,-0.976703,1
4284,0,0,0,0,592,192,5068,271,5339,0.0088528,0.201992,-0.979347,1
4378,0,0,0,0,640,178,5196,213,5409,0.000820804,0.170267,-0.985398,1
5155,0,0,0,0,646,170,5971,218,6189,0.0119204,0.150337,-0.988563,1
3894,0,0,0,0,627,155,4676,207,4883,0.0621736,0.177628,-0.982132,1
5445,0,0,0,0,703,176,6324,250,6574,0.0430574,0.143445,-0.988721,1
7598,0,0,0,0,419,105,8122,126,8248,0.0285861,0.106881,-0.993861,1
1842,0,0,0,0,257,62,2161,120,2281,0.00364797,0.07169,-0.99742,1
1209,0,0,0,0,182,48,1439,78,1517,0.0123953,0.0767318,-0.996975,1
4396,0,0,0,0,648,174,5218,271,5489,0.00685906,0.0801561,-0.996759,1
4618,0,0,0,0,649,172,5439,282,5721,0.0135961,0.0996418,-0.994931,1
4386,0,0,0,0,666,174,5226,267,5493,0.0236888,0.114624,-0.993126,1
4776,0,0,0,0,690,178,5644,325,5969,0.021691,0.134073,-0.990734,1
4574,0,0,0,0,733,189,5496,175,5671,0.0910254,0.303264,-0.948549,1
4644,0,0,0,0,766,202,5612,249,5861,0.0400904,0.158334,-0.986571,1
4664,0,0,0,0,956,229,5849,290,6139,0.0604711,0.167841,-0.983958,1
4790,0,0,0,0,1029,248,6067,275,6342,0.0720988,0.144272,-0.986908,1
4864,0,0,0,0,1116,296,6276,264,6540,0.0763535,0.148569,-0.98595,1
4936,0,0,0,0,1137,296,6369,251,6620,0.0733548,0.131317,-0.988623,1
4994,0,0,0,0,1113,266,6373,287,6660,0.0777306,0.148488,-0.985855,1
4837,0,0,0,0,1111,269,6217,325,6542,0.0649145,0.143593,-0.987506,1
5121,0,0,0,0,1064,319,6504,313,6817,0.0440302,0.107588,-0.99322,1
5149,0,0,0,0,1095,295,6539,311,6850,0.010294,0.0580201,-0.998262,1
4977,0,0,0,0,1038,294,6309,225,6534,-0.0216593,-0.0114162,-0.9997,1
5044,0,0,0,0,1065,327,6436,241,6677,0.00643596,0.023124,-0.999712,1
5003,0,0,0,0,1065,289,6357,492,6849,0.0214489,0.0575723,-0.998111,1
5176,0,0,0,0,1122,297,6595,206,6801,-0.0100238,-0.000365604,-0.99995,1
4770,0,0,0,0,950,244,5964,188,6152,0.0337574,0.0965362,-0.994757,1
4938,0,0,0,0,1072,273,6283,293,6576,0.00528339,0.0215481,-0.999754,1
4474,0,0,0,0,912,235,5621,365,5986,0.0271603,0.049379,-0.998411,1
5030,0,0,0,0,1071,261,6362,205,6567,0.00780247,0.0188988,-0.999791,1
4991,0,0,0,0,1112,267,6370,440,6810,0.0239736,0.0540557,-0.99825,1
4900,0,0,0,0,1059,259,6218,207,6425,-0.00963619,0.0734643,-0.997251,1
4949,0,0,0,0,1088,266,6303,195,6498,-0.00603722,0.0479336,-0.998832,1
4876,0,0,0,0,1059,263,6198,426,6624,0.0316911,0.0534719,-0.998066,1
4963,0,0,0,0,1068,262,6293,196,6489,-0.0158803,-0.000188049,-0.999874,1
4896,0,0,0,0,1040,302,6238,-1000,-1000,-1,-1,-1,1
5049,0,0,0,0,1011,261,6321,452,6773,0.0179892,0.0696616,-0.997408,1
5273,0,0,0,0,1066,259,6598,224,6822,0.00801462,0.0327724,-0.999431,1
6554,0,0,0,0,1069,265,7888,448,8336,0.0181159,0.0689309,-0.997457,1
5388,0,0,0,0,1056,259,6703,229,6932,0.0055504,0.0301961,-0.999529,1
4969,0,0,0,0,1035,260,6264,438,6702,0.0144605,0.0636428,-0.997868,1
5009,0,0,0,0,1108,290,6407,250,6657,0.0296199,0.0558571,-0.997999,1
4867,0,0,0,0,1058,260,6185,231,6416,0.00457735,0.0300712,-0.999537,1
4957,0,0,0,0,1021,274,6252,417,6669,0.0152225,0.0622334,-0.997946,1
4753,0,0,0,0,1012,280,6045,236,6281,0.0234041,0.0640277,-0.997674,1
4852,0,0,0,0,1002,263,6117,208,6325,0.00642258,0.038546,-0.999236,1
5621,0,0,0,0,1094,306,7021,451,7472,0.0200372,0.073045,-0.997127,1
4880,0,0,0,0,1008,258,6146,235,6381,-0.00209283,0.0286684,-0.999587,1
5037,0,0,0,0,1120,267,6424,397,6821,0.0171047,0.0652379,-0.997723,1
4913,0,0,0,0,1019,261,6193,194,6387,0.0248876,0.0532939,-0.998269,1
5042,0,0,0,0,1057,261,6360,190,6550,0.0262063,0.0540651,-0.998193,1
4846,0,0,0,0,1137,261,6244,190,6434,0.0266891,0.0547024,-0.998146,1
5282,0,0,0,0,1008,293,6583,240,6823,0.0246818,0.050742,-0.998407,1
4902,0,0,0,0,1143,288,6333,243,6576,0.0245836,0.048894,-0.998501,1
5218,0,0,0,0,1065,331,6614,206,6820,-0.0364696,-0.00537685,-0.99932,1
4869,0,0,0,0,1134,290,6293,230,6523,-0.00811955,0.0257362,-0.999636,1
4852,0,0,0,0,1019,277,6148,421,6569,0.0174807,0.0587751,-0.998118,1
4827,0,0,0,0,1029,271,6127,211,6338,0.0299284,0.0599769,-0.997751,1
4890,0,0,0,0,1009,273,6172,248,6420,0.00382066,0.0314679,-0.999497,1
4912,0,0,0,0,1038,263,6213,422,6635,0.014674,0.0605268,-0.998059,1
4809,0,0,0,0,1075,256,6140,200,6340,0.0205033,0.0488844,-0.998594,1
4928,0,0,0,0,1097,258,6283,200,6483,-0.0825678,-0.0168321,-0.996443,1
4830,0,0,0,0,1055,255,6140,271,6411,-0.0202482,0.0134453,-0.999705,1
4820,0,0,0,0,1002,256,6078,177,6255,-0.0119854,0.0159103,-0.999802,1
4894,0,0,0,0,1014,265,6173,182,6355,-0.275404,-0.0125663,-0.961246,1
4924,0,0,0,0,1063,258,6245,235,6480,0.0228129,0.0210496,-0.999518,1
4924,0,0,0,0,1086,261,6271,438,6709,0.0160872,0.0620584,-0.997943,1
4901,0,0,0,0,1064,268,6233,211,6444,0.0173825,0.0548082,-0.998346,1
5055,0,0,0,0,1011,257,6323,191,6514,0.0092049,0.0443432,-0.998974,1
4832,0,0,0,0,1061,260,6153,466,6619,0.00816882,0.0887735,-0.996018,1
5004,0,0,0,0,1013,260,6277,210,6487,0.00340517,0.0312405,-0.999506,1
4878,0,0,0,0,1036,336,6250,433,6683,0.0111841,0.0761408,-0.997034,1
5060,0,0,0,0,1052,380,6492,233,6725,0.0206841,0.0532946,-0.998365,1
4978,0,0,0,0,1053,285,6316,202,6518,0.0267904,0.0618572,-0.997725,1
4995,0,0,0,0,1000,270,6265,194,6459,0.00854473,0.0378137,-0.999248,1
5038,0,0,0,0,1020,275,6333,420,6753,0.0169882,0.0646799,-0.997762,1
4931,0,0,0,0,1503,393,6827,243,7070,0.00556313,0.0339814,-0.999407,1
4887,0,0,0,0,1013,261,6161,387,6548,0.0118792,0.0753833,-0.997084,1
3325,0,0,0,0,690,176,4191,139,4330,0.0303842,0.0608648,-0.997683,1
3313,0,0,0,0,721,200,4234,149,4383,0.0281231,0.0518753,-0.998257,1
4429,0,0,0,0,903,232,5564,237,5801,0.0258431,0.0507623,-0.998376,1
4984,0,0,0,0,1025,259,6268,187,6455,0.0270052,0.0492674,-0.99842,1
4892,0,0,0,0,1009,257,6158,185,6343,0.0256457,0.0494748,-0.998446,1
4822,0,0,0,0,1004,254,6080,268,6348,0.0194743,0.0469061,-0.998709,1
4981,0,0,0,0,1028,256,6265,187,6452,0.0223866,0.0422199,-0.998857,1
4862,0,0,0,0,1054,258,6174,207,6381,0.0272842,0.0480502,-0.998472,1
4918,0,0,0,0,1098,277,6293,272,6565,0.03202,0.0471523,-0.998374,1
4914,0,0,0,0,1057,311,6282,216,6498,0.000308436,0.0308866,-0.999523,1
4956,0,0,0,0,1052,263,6271,453,6724,0.0125559,0.0797445,-0.996736,1
4819,0,0,0,0,1033,295,6147,260,6407,0.00390227,0.0374891,-0.999289,1
4897,0,0,0,0,1073,288,6258,429,6687,0.0166876,0.0696089,-0.997435,1
4790,0,0,0,0,1077,299,6166,249,6415,0.00796804,0.0363876,-0.999306,1
5471,0,0,0,0,1060,278,6809,447,7256,0.0126024,0.0759934,-0.997029,1
5034,0,0,0,0,1059,266,6359,237,6596,0.00447937,0.0439922,-0.999022,1
4879,0,0,0,0,1136,273,6288,425,6713,0.00796423,0.0694805,-0.997552,1
4853,0,0,0,0,1042,300,6195,218,6413,0.00277919,0.0376272,-0.999288,1
5008,0,0,0,0,1071,265,6344,417,6761,0.0147616,0.0711433,-0.997357,1
4811,0,0,0,0,1048,257,6116,205,6321,0.0129955,0.0434336,-0.998972,1
5053,0,0,0,0,1099,261,6413,430,6843,0.0164516,0.0732026,-0.997181,1
4926,0,0,0,0,1088,256,6270,234,6504,-0.00361175,0.0229587,-0.99973,1
4990,0,0,0,0,1067,306,6363,422,6785,0.01206,0.0736493,-0.997211,1
5652,0,0,0,0,1065,292,7009,216,7225,0.00772648,0.0286733,-0.999559,1
4943,0,0,0,0,1004,276,6223,402,6625,0.0113254,0.0794177,-0.996777,1
5165,0,0,0,0,1014,275,6454,213,6667,0.00105933,0.0322558,-0.999479,2
4923,0,0,0,0,1009,272,6204,428,6632,0.0173121,0.0587506,-0.998123,2
4851,0,0,0,0,1003,269,6123,196,6319,0.0249084,0.0603169,-0.997869,2
4935,0,0,0,0,1026,269,6230,206,6436,0.0168764,0.0462662,-0.998787,2
4963,0,0,0,0,1023,277,6263,411,6674,0.012122,0.0793109,-0.996776,2
4863,0,0,0,0,1016,259,6138,219,6357,0.0217375,0.0556591,-0.998213,2
4894,0,0,0,0,1014,271,6179,204,6383,0.0289193,0.0562321,-0.997999,2
4928,0,0,0,0,1026,273,6227,215,6442,0.0276855,0.055501,-0.998075,2
4846,0,0,0,0,1147,272,6265,205,6470,0.0143181,0.0386334,-0.999151,2
5000,0,0,0,0,1052,273,6325,468,6793,0.0153254,0.0727071,-0.997236,2
5111,0,0,0,0,1071,271,6453,238,6691,0.024501,0.0471656,-0.998587,2
5025,0,0,0,0,1083,327,6435,206,6641,0.0243419,0.0450223,-0.998689,2
3324,0,0,0,0,721,194,4239,133,4372,-0.0117145,0.0108386,-0.999873,2
5058,0,0,0,0,1058,285,6401,253,6654,0.0533012,0.0209517,-0.998359,2
4975,0,0,0,0,1010,260,6245,194,6439,0.00165883,0.0165029,-0.999862,2
5252,0,0,0,0,1015,270,6537,413,6950,0.0120942,0.0750546,-0.997106,2
4900,0,0,0,0,1009,257,6166,200,6366,0.00537815,0.0427299,-0.999072,2
4956,0,0,0,0,1005,268,6229,428,6657,0.0147332,0.0782324,-0.996826,2
4865,0,0,0,0,1026,272,6163,224,6387,0.0247772,0.0588048,-0.997962,2
4905,0,0,0,0,1020,273,6198,217,6415,-0.000456284,0.0243483,-0.999703,2
5494,0,0,0,0,1051,351,6896,402,7298,0.0125604,0.0684822,-0.997573,2
5186,0,0,0,0,1122,266,6574,205,6779,0.0037462,0.03199,-0.999481,2
5090,0,0,0,0,1039,274,6403,416,6819,0.0163808,0.067939,-0.997555,2
5096,0,0,0,0,1011,273,6380,206,6586,-0.00142936,0.0248216,-0.999691,2
4972,0,0,0,0,1007,273,6252,417,6669,0.0114518,0.0712951,-0.997389,2
4911,0,0,0,0,1012,269,6192,218,6410,0.0210118,0.0449819,-0.998767,2
4908,0,0,0,0,1024,270,6202,192,6394,0.02483,0.0413397,-0.998837,2
5604,0,0,0,0,1187,270,7061,198,7259,0.030881,0.0481613,-0.998362,2
4936,0,0,0,0,1030,299,6265,217,6482,0.0278616,0.0454538,-0.998578,2
5540,0,0,0,0,1044,275,6859,215,7074,-0.0134996,0.00608288,-0.99989,2
5017,0,0,0,0,1035,258,6310,189,6499,-0.0866891,0.00559521,-0.99622,2
4941,0,0,0,0,1017,257,6215,228,6443,-0.0130057,0.00538782,-0.999901,2
5545,0,0,0,0,1194,307,7046,210,7256,-0.119865,0.00780725,-0.992759,2
5558,0,0,0,0,1215,310,7083,292,7375,-0.0209752,0.011333,-0.999716,2
4913,0,0,0,0,1010,256,6179,174,6353,-0.0991047,0.00576004,-0.99506,2
4835,0,0,0,0,1008,296,6139,234,6373,-0.0163595,0.00194705,-0.999864,2
4943,0,0,0,0,835,187,5965,123,6088,-0.104539,0.00889382,-0.994481,2
4982,0,0,0,0,1028,262,6272,240,6512,-0.016329,0.0107497,-0.999809,2
5442,0,0,0,0,1057,314,6813,187,7000,-0.284924,-0.0136912,-0.958452,2
5158,0,0,0,0,1041,289,6488,248,6736,0.0136204,0.0119563,-0.999836,2
5146,0,0,0,0,1023,325,6494,513,7007,0.0132965,0.0604167,-0.998085,2
5126,0,0,0,0,1012,258,6396,189,6585,-0.00207106,0.0134626,-0.999907,2
4906,0,0,0,0,1030,260,6196,402,6598,0.0132118,0.0674331,-0.997636,2
5646,0,0,0,0,1185,302,7133,280,7413,0.00843778,0.0263171,-0.999618,2
4921,0,0,0,0,1028,343,6292,426,6718,0.0116101,0.0680734,-0.997613,2
5329,0,0,0,0,1020,294,6643,205,6848,0.0226721,0.0388536,-0.998988,2
5010,0,0,0,0,1042,275,6327,183,6510,0.0097575,0.0231876,-0.999684,2
5605,0,0,0,0,1173,306,7084,528,7612,0.0172243,0.0574053,-0.998202,2
5145,0,0,0,0,1136,301,6582,235,6817,0.024535,0.0409749,-0.998859,2
4975,0,0,0,0,1118,295,6388,229,6617,0.0277805,0.0382666,-0.998881,2
4899,0,0,0,0,1079,262,6240,204,6444,0.00310265,0.0139243,-0.999898,2
4907,0,0,0,0,1069,265,6241,477,6718,0.0171223,0.0605059,-0.998021,2
5579,0,0,0,0,1236,297,7112,292,7404,0.0237752,0.0434117,-0.998774,2
5513,0,0,0,0,1386,312,7211,227,7438,0.0014677,0.0118894,-0.999928,2
5393,0,0,0,0,1187,275,6855,420,7275,0.0114137,0.0698551,-0.997492,2
4972,0,0,0,0,1025,262,6259,222,6481,0.0203087,0.0326637,-0.99926,2
5003,0,0,0,0,1022,264,6289,452,6741,0.00853975,0.072124,-0.997359,2
5071,0,0,0,0,1135,299,6505,243,6748,0.00340816,0.0207251,-0.999779,2
5645,0,0,0,0,1152,357,7154,552,7706,0.0102729,0.0696925,-0.997516,2
5508,0,0,0,0,1129,301,6938,256,7194,0.0022845,0.0218444,-0.999759,2
4942,0,0,0,0,1101,264,6307,454,6761,0.0156025,0.0510511,-0.998574,2
5183,0,0,0,0,1099,295,6577,246,6823,0.024028,0.0363293,-0.999051,2
4968,0,0,0,0,1550,411,6929,246,7175,0.0385485,0.0286611,-0.998846,2
4929,0,0,0,0,1020,259,6208,235,6443,0.0119531,0.00982523,-0.99988,2
5023,0,0,0,0,1019,264,6306,416,6722,0.0155884,0.0580613,-0.998191,2
5056,0,0,0,0,1050,302,6408,245,6653,0.0230611,0.0365606,-0.999065,2
4940,0,0,0,0,1095,313,6348,184,6532,0.0284252,0.0144237,-0.999492,2
4968,0,0,0,0,1069,264,6301,460,6761,0.0211671,0.0564888,-0.998179,2
4988,0,0,0,0,1025,269,6282,241,6523,0.00355294,0.0174739,-0.999841,2
5004,0,0,0,0,1070,262,6336,504,6840,0.0173135,0.0542418,-0.998378,2
5088,0,0,0,0,1066,309,6463,230,6693,0.00519625,0.019165,-0.999803,2
5052,0,0,0,0,1109,303,6464,448,6912,0.00834893,0.0724046,-0.99734,2
4937,0,0,0,0,1126,260,6323,218,6541,-0.00109693,0.0153158,-0.999882,2
5077,0,0,0,0,1064,263,6404,459,6863,0.0113817,0.0605739,-0.998099,2
5028,0,0,0,0,1060,260,6348,193,6541,0.00409291,0.0259174,-0.999656,2
5554,0,0,0,0,1055,268,6877,425,7302,0.0136923,0.0664084,-0.997699,2
5222,0,0,0,0,1091,263,6576,211,6787,0.0186177,0.0459591,-0.99877,2
4997,0,0,0,0,1023,258,6278,193,6471,-0.0173603,-0.000342951,-0.999849,2
4985,0,0,0,0,1072,329,6386,228,6614,-0.136355,-0.00417216,-0.990651,2
5301,0,0,0,0,1106,273,6680,279,6959,-0.0341216,-0.00766826,-0.999388,2
5280,0,0,0,0,1087,302,6669,199,6868,-0.00287018,0.0070084,-0.999971,2
4997,0,0,0,0,1129,297,6423,460,6883,0.015587,0.0633486,-0.99787,2
4944,0,0,0,0,1073,259,6276,280,6556,0.0202045,0.0365646,-0.999127,2
5136,0,0,0,0,1083,284,6503,237,6740,0.0234601,0.028481,-0.999319,2
5022,0,0,0,0,1150,317,6489,215,6704,0.0213943,0.0138743,-0.999675,2
5132,0,0,0,0,1070,292,6494,210,6704,0.000476088,-0.00668659,-0.999978,2
5099,0,0,0,0,1041,299,6439,463,6902,0.018506,0.0529167,-0.998427,2
5074,0,0,0,0,1074,299,6447,245,6692,-0.00650199,0.00698772,-0.999954,2
5021,0,0,0,0,1065,276,6362,439,6801,0.0181553,0.0544752,-0.99835,2
5777,0,0,0,0,1081,292,7150,220,7370,0.02426,0.0411949,-0.998857,2
5065,0,0,0,0,1030,301,6396,236,6632,-0.00921318,0.00315333,-0.999953,2
5106,0,0,0,0,1042,260,6408,222,6630,0.0210317,-0.047227,-0.998663,2
5472,0,0,0,0,1069,266,6807,426,7233,0.0137434,0.0555168,-0.998363,2
5708,0,0,0,0,1254,307,7269,223,7492,0.00452916,0.0186787,-0.999815,2
5026,0,0,0,0,1077,300,6403,478,6881,0.0138122,0.0564737,-0.998309,2
5281,0,0,0,0,1071,306,6658,249,6907,-0.00500719,0.00711688,-0.999962,2
5090,0,0,0,0,1040,275,6405,417,6822,0.0107674,0.0491592,-0.998733,2
5083,0,0,0,0,1073,301,6457,233,6690,0.0198152,0.0387769,-0.999051,2
5738,0,0,0,0,1036,277,7051,207,7258,0.0264486,0.0456153,-0.998609,2
5072,0,0,0,0,1040,277,6389,210,6599,0.0257568,0.0337416,-0.999099,2
5409,0,0,0,0,1036,328,6773,221,6994,-0.00975798,-0.00504255,-0.99994,2
5083,0,0,0,0,1032,275,6390,-1000,-1000,-1,-1,-1,2
5256,0,0,0,0,1058,296,6610,474,7084,0.0141493,0.0670242,-0.997651,2
5043,0,0,0,0,1078,275,6396,275,6671,-0.00394242,0.00746869,-0.999964,2
5015,0,0,0,0,1103,298,6416,446,6862,0.0151356,0.0582234,-0.998189,2
5114,0,0,0,0,1159,314,6587,205,6792,0.000884263,0.0189247,-0.999821,2
5150,0,0,0,0,1042,306,6498,443,6941,0.0160989,0.0471248,-0.998759,2
5424,0,0,0,0,1028,298,6750,249,6999,-0.0107287,0.00160621,-0.999941,2
5282,0,0,0,0,1099,262,6643,207,6850,-0.169598,0.129666,-0.976946,2
5225,0,0,0,0,1092,266,6583,272,6855,-0.0385792,0.017878,-0.999096,2
5135,0,0,0,0,1078,261,6474,202,6676,-0.0231844,0.0440219,-0.998761,2
5083,0,0,0,0,1155,306,6544,240,6784,-0.0110192,0.0314623,-0.999444,2
5484,0,0,0,0,1111,298,6893,187,7080,-0.104029,0.178028,-0.978511,2
5067,0,0,0,0,1151,312,6530,328,6858,-0.0217698,0.0377268,-0.999051,2
5534,0,0,0,0,1082,264,6880,194,7074,0.00386483,0.00203462,-0.99999,2
5101,0,0,0,0,1095,266,6462,453,6915,0.0178474,0.0465245,-0.998758,2
3589,0,0,0,0,782,215,4586,159,4745,-0.00674072,0.000567414,-0.999977,2
3471,0,0,0,0,755,204,4430,137,4567,-0.0110662,-0.017067,-0.999793,2
5212,0,0,0,0,1119,300,6631,214,6845,-0.249835,0.259888,-0.93276,2
5040,0,0,0,0,1093,298,6431,259,6690,0.0168572,0.00117279,-0.999857,2
5003,0,0,0,0,1060,285,6348,468,6816,0.0131394,0.057156,-0.998279,2
5023,0,0,0,0,1033,286,6342,228,6570,-0.00848512,0.00641162,-0.999943,2
5608,0,0,0,0,1131,268,7007,487,7494,0.0119708,0.0534575,-0.998498,2
5072,0,0,0,0,1110,286,6468,240,6708,-0.016629,-0.00710195,-0.999837,2
5188,0,0,0,0,1080,329,6597,191,6788,-0.31466,0.387235,-0.866624,2
5032,0,0,0,0,1086,280,6398,253,6651,0.041685,0.00565627,-0.999115,2
5058,0,0,0,0,1095,269,6422,248,6670,-0.00472649,-0.0110459,-0.999928,2
5292,0,0,0,0,1032,277,6601,453,7054,0.0140156,0.0533975,-0.998475,2
5155,0,0,0,0,1123,312,6590,213,6803,-0.00997362,0.00524258,-0.999937,2
5055,0,0,0,0,1158,266,6479,462,6941,0.0141653,0.0485955,-0.998718,2
5074,0,0,0,0,1029,283,6386,237,6623,-0.0169455,-0.00582124,-0.999839,2
4996,0,0,0,0,1046,274,6316,191,6507,-0.175934,0.120628,-0.976983,2
5883,0,0,0,0,1163,332,7378,306,7684,-0.0413659,0.0195696,-0.998952,2
5123,0,0,0,0,1088,324,6535,195,6730,-0.0250565,0.0428587,-0.998767,2
5077,0,0,0,0,1108,263,6448,208,6656,-0.0121423,0.0267734,-0.999568,2
5060,0,0,0,0,1020,279,6359,432,6791,0.0154988,0.0477956,-0.998737,2
4840,0,0,0,0,1034,276,6150,215,6365,-0.00969399,0.00455012,-0.999943,2
5493,0,0,0,0,1190,269,6952,438,7390,0.0125053,0.0499543,-0.998673,2
5011,0,0,0,0,1130,276,6417,223,6640,-0.0128764,-0.000452497,-0.999917,2
5148,0,0,0,0,1028,260,6436,226,6662,-0.0670636,-0.00105098,-0.997748,2
5060,0,0,0,0,1165,263,6488,247,6735,-0.0174659,0.00312419,-0.999843,2
5506,0,0,0,0,1153,258,6917,214,7131,0.0120863,0.0167842,-0.999786,2
5109,0,0,0,0,1114,269,6492,443,6935,0.00961382,0.0584793,-0.998242,2
5185,0,0,0,0,1226,296,6707,223,6930,0.0184906,0.0390948,-0.999064,2
5021,0,0,0,0,1106,292,6419,222,6641,-0.0023091,0.00549026,-0.999982,2
5159,0,0,0,0,1026,296,6481,486,6967,0.00770082,0.0628135,-0.997996,2
5203,0,0,0,0,1130,292,6625,240,6865,-0.00442097,0.00898312,-0.99995,2
5137,0,0,0,0,1104,324,6565,431,6996,0.0139005,0.0505804,-0.998623,2
5038,0,0,0,0,1090,299,6427,267,6694,-0.0102343,-0.00437289,-0.999938,2
5000,0,0,0,0,1025,258,6283,188,6471,-0.37097,0.324754,-0.870009,2
5027,0,0,0,0,1035,329,6391,302,6693,0.0446116,-0.0158244,-0.998879,2
5135,0,0,0,0,1023,261,6419,185,6604,-0.0226996,-0.00254551,-0.999739,2
5169,0,0,0,0,1042,264,6475,217,6692,0.0364986,0.0198952,-0.999136,2
5142,0,0,0,0,1042,262,6446,198,6644,-0.0123406,-0.0141287,-0.999824,2
5137,0,0,0,0,1037,261,6435,183,6618,-0.370939,0.374321,-0.849876,2
5039,0,0,0,0,1022,262,6323,248,6571,0.0225084,0.00566311,-0.999731,2
5138,0,0,0,0,1035,264,6437,182,6619,-0.135644,0.000626207,-0.990757,2
5140,0,0,0,0,1036,322,6498,309,6807,-0.0403665,-0.00507684,-0.999172,2
5062,0,0,0,0,1086,262,6410,232,6642,-0.0065123,0.0321348,-0.999462,2
5054,0,0,0,0,1036,265,6355,184,6539,-0.00291373,0.0154514,-0.999876,2
5089,0,0,0,0,1077,266,6432,457,6889,0.00870549,0.0593198,-0.998201,2
5077,0,0,0,0,1072,277,6426,230,6656,0.0172513,0.0247963,-0.999544,2
5176,0,0,0,0,1029,286,6491,238,6729,-0.00348995,-0.0018766,-0.999992,2
5119,0,0,0,0,1291,284,6694,413,7107,0.0132127,0.0535574,-0.998477,2
5165,0,0,0,0,1029,283,6477,224,6701,-0.0138812,-0.00883157,-0.999865,2
5208,0,0,0,0,926,248,6382,172,6554,-0.115585,0.248826,-0.961627,2
5122,0,0,0,0,1020,276,6418,320,6738,-0.000880225,0.00813445,-0.999967,2
5195,0,0,0,0,1070,267,6532,414,6946,0.0117898,0.0566718,-0.998323,2
5037,0,0,0,0,1054,261,6352,209,6561,0.0152957,0.023584,-0.999605,2
5073,0,0,0,0,1028,295,6396,186,6582,-0.00773922,-0.00851294,-0.999934,2
5123,0,0,0,0,1028,276,6427,191,6618,-0.283731,0.307747,-0.908179,2
5157,0,0,0,0,1043,263,6463,308,6771,0.0327718,-0.00803261,-0.999431,2
5026,0,0,0,0,1046,277,6349,212,6561,0.0338515,-0.0278492,-0.999039,2
5057,0,0,0,0,1030,279,6366,418,6784,0.01125,0.0591972,-0.998183,2
5156,0,0,0,0,1082,275,6513,314,6827,-0.00595847,0.00276034,-0.999978,2
5794,0,0,0,0,1023,267,7084,415,7499,0.0153751,0.0418677,-0.999005,2
5368,0,0,0,0,1051,297,6716,243,6959,-0.0165333,-0.0144105,-0.999759,2
5183,0,0,0,0,1100,328,6611,441,7052,0.0103305,0.0536593,-0.998506,2
5070,0,0,0,0,1061,302,6433,246,6679,-0.0154704,-0.012688,-0.9998,2
5039,0,0,0,0,1064,290,6393,215,6608,-0.166347,0.158256,-0.973285,2
5063,0,0,0,0,1105,273,6441,306,6747,-0.00809175,0.000880548,-0.999967,2
5057,0,0,0,0,1170,287,6514,471,6985,0.0107613,0.0473462,-0.998821,2
5017,0,0,0,0,1148,280,6445,230,6675,0.0195054,0.0319503,-0.999299,2
5169,0,0,0,0,1075,290,6534,222,6756,-0.00386845,0.00132961,-0.999992,2
5210,0,0,0,0,1068,278,6556,430,6986,0.00853508,0.0567618,-0.998351,2
5023,0,0,0,0,1180,333,6536,263,6799,-0.00883459,-0.00451108,-0.999951,2
5006,0,0,0,0,1109,290,6405,455,6860,0.0133982,0.0469779,-0.998806,2
4961,0,0,0,0,1065,331,6357,231,6588,-0.0123698,-0.00533893,-0.999909,2
5136,0,0,0,0,1026,280,6442,418,6860,0.00763831,0.0630465,-0.997981,2
5044,0,0,0,0,1133,308,6485,229,6714,-0.00971222,0.00496616,-0.999941,2
5078,0,0,0,0,1057,279,6414,427,6841,0.0117018,0.0510847,-0.998626,2
5026,0,0,0,0,1103,289,6418,212,6630,-0.00205368,0.00775859,-0.999968,2
5047,0,0,0,0,1146,299,6492,471,6963,0.0201617,0.0461772,-0.99873,2
5102,0,0,0,0,1102,318,6522,255,6777,-0.00653508,-0.000302098,-0.999979,2
5088,0,0,0,0,1119,294,6501,506,7007,0.0185789,0.0340783,-0.999246,2
5085,0,0,0,0,1105,331,6521,245,6766,-0.00210129,-0.0238653,-0.999713,2
5096,0,0,0,0,1082,289,6467,416,6883,0.0196834,0.0454823,-0.998771,2
5117,0,0,0,0,1047,297,6461,213,6674,-0.0143795,-0.0112082,-0.999834,2
5261,0,0,0,0,1062,297,6620,431,7051,0.00381229,0.0344561,-0.999399,2
5224,0,0,0,0,1119,293,6636,212,6848,0.0165311,0.0508365,-0.99857,2
6116,0,0,0,0,1047,322,7485,225,7710,-0.019466,0.0319346,-0.9993,2
5093,0,0,0,0,1074,281,6448,196,6644,-0.199602,0.0626299,-0.977874,2
5184,0,0,0,0,1234,310,6728,251,6979,0.0194633,0.0395281,-0.999029,2
5372,0,0,0,0,1072,272,6716,215,6931,0.00276753,0.0643521,-0.997923,2
5313,0,0,0,0,1098,270,6681,206,6887,-0.00965959,0.125682,-0.992024,2
5392,0,0,0,0,967,248,6607,241,6848,-0.0162233,0.105961,-0.994238,2
5222,0,0,0,0,892,229,6343,263,6606,-0.0169578,0.159978,-0.986975,2
4912,0,0,0,0,937,215,6064,299,6363,-0.0158413,0.116918,-0.993015,2
5010,0,0,0,0,731,189,5930,296,6226,-0.012944,0.129315,-0.991519,2
4952,0,0,0,0,744,177,5873,297,6170,-0.00851724,0.234414,-0.972099,2
4997,0,0,0,0,692,169,5858,307,6165,-0.00891925,0.238896,-0.971004,2
4672,0,0,0,0,449,149,5270,244,5514,0.00082359,0.15395,-0.988078,2
3264,0,0,0,0,411,102,3777,237,4014,0.0105503,0.100213,-0.99491,2
4728,0,0,0,0,554,136,5418,368,5786,0.00722641,0.101958,-0.994762,2
4983,0,0,0,0,491,123,5597,376,5973,0.0178,0.104127,-0.994405,2
4900,0,0,0,0,447,135,5482,392,5874,0.0286033,0.091916,-0.995356,2
4897,0,0,0,0,400,102,5399,385,5784,0.0317319,0.122593,-0.99195,2
4796,0,0,0,0,330,91,5217,481,5698,0.0347798,0.113333,-0.992948,2
4822,0,0,0,0,329,114,5265,413,5678,0.0325691,0.12474,-0.991655,2
4591,0,0,0,0,286,101,4978,414,5392,0.0322479,0.117458,-0.992554,2
4919,0,0,0,0,229,69,5217,452,5669,0.0266946,0.156107,-0.987379,2
4316,0,0,0,0,251,63,4630,411,5041,0.0249273,0.116125,-0.992922,2
4392,0,0,0,0,206,57,4655,417,5072,0.0116332,0.0733062,-0.997242,2
4195,0,0,0,0,155,51,4401,473,4874,-0.00462704,0.0703586,-0.997511,2
4081,0,0,0,0,150,49,4280,384,4664,-0.0173198,0.0735875,-0.997138,2
4208,0,0,0,0,181,65,4454,371,4825,-0.0314929,0.081346,-0.996188,2
4085,0,0,0,0,212,55,4352,436,4788,-0.0422642,0.0959446,-0.994489,2
4190,0,0,0,0,262,92,4544,424,4968,-0.0315965,0.0998821,-0.994497,2
4093,0,0,0,0,272,68,4433,466,4899,-0.0165193,0.0688177,-0.997492,2
5189,0,0,0,0,285,90,5564,438,6002,-0.00207344,0.0427914,-0.999082,2
4288,0,0,0,0,331,99,4718,420,5138,0.00947249,0.0258177,-0.999622,2
4344,0,0,0,0,392,103,4839,475,5314,0.021107,0.0181508,-0.999612,2
4353,0,0,0,0,456,148,4957,446,5403,0.0363432,0.0200456,-0.999138,2
4770,0,0,0,0,541,171,5482,474,5956,0.0483621,0.019419,-0.998641,2
4851,0,0,0,0,722,202,5775,411,6186,0.0912192,-0.0101822,-0.995779,2
5394,0,0,0,0,1033,277,6704,458,7162,0.0995256,-0.00601389,-0.995017,2
5361,0,0,0,0,1217,291,6869,354,7223,0.110157,0.019104,-0.993731,2
5941,0,0,0,0,1423,368,7732,329,8061,0.121775,0.0512746,-0.991232,2
6230,0,0,0,0,1534,470,8234,543,8777,0.0972222,0.168774,-0.980848,2
6209,0,0,0,0,1503,406,8118,697,8815,0.0784464,0.232093,-0.969525,2
6463,0,0,0,0,1572,359,8394,600,8994,0.0696463,0.319639,-0.944976,2
6310,0,0,0,0,1477,367,8154,564,8718,0.0740274,0.37453,-0.924255,2
5701,0,0,0,0,1200,304,7205,525,7730,0.0762303,0.416279,-0.906036,2
6053,0,0,0,0,1075,284,7412,458,7870,0.0747331,0.456847,-0.886401,2
5705,0,0,0,0,1056,289,7050,486,7536,0.0720384,0.512888,-0.855428,2
5615,0,0,0,0,992,272,6879,474,7353,0.0549736,0.570375,-0.819543,2
5667,0,0,0,0,984,256,6907,446,7353,0.0505176,0.639513,-0.767119,2
5518,0,0,0,0,944,251,6713,-1000,-1000,-1,-1,-1,2
5283,0,0,0,0,916,290,6489,441,6930,-0.0364304,0.0967002,-0.994647,2
5178,0,0,0,0,867,196,6241,475,6716,-0.0625772,0.160025,-0.985127,2
4830,0,0,0,0,730,172,5732,495,6227,-0.0444521,0.156428,-0.986688,2
4715,0,0,0,0,554,161,5430,418,5848,-0.0435597,0.178001,-0.983066,2
5231,0,0,0,0,775,207,6213,498,6711,-0.0403452,0.209678,-0.976938,2
4099,0,0,0,0,480,131,4710,405,5115,-0.0575389,0.286488,-0.956355,2
4807,0,0,0,0,488,158,5453,375,5828,-0.061179,0.243737,-0.96791,2
3880,0,0,0,0,353,96,4329,272,4601,-0.0546297,0.166192,-0.984579,2
2730,0,0,0,0,314,100,3144,275,3419,-0.0596676,0.178387,-0.98215,2
3927,0,0,0,0,448,135,4510,396,4906,-0.06086,0.163034,-0.984742,2
4025,0,0,0,0,459,137,4621,343,4964,-0.069614,0.19831,-0.977664,2
3937,0,0,0,0,444,135,4516,342,4858,-0.0651401,0.230458,-0.9709,2
4178,0,0,0,0,462,139,4779,355,5134,-0.0404814,0.223186,-0.973935,2
3966,0,0,0,0,523,149,4638,341,4979,-0.0372524,0.21904,-0.975004,2
4095,0,0,0,0,577,169,4841,338,5179,-0.0136654,0.237043,-0.971403,2
4365,0,0,0,0,727,218,5310,377,5687,-0.00562609,0.2679,-0.96343,2
4618,0,0,0,0,974,256,5848,362,6210,0.0097865,0.275589,-0.961226,2
4911,0,0,0,0,1108,283,6302,327,6629,0.00653571,0.258907,-0.96588,2
4688,0,0,0,0,1041,298,6027,322,6349,-0.00896403,0.242689,-0.970063,2
5469,0,0,0,0,1274,325,7068,371,7439,-0.0211475,0.234621,-0.971857,2
5481,0,0,0,0,1271,383,7135,323,7458,-0.0331685,0.268177,-0.962798,2
5464,0,0,0,0,1078,288,6830,272,7102,-0.0470356,0.274366,-0.960474,2
5220,0,0,0,0,912,250,6382,278,6660,-0.0402642,0.204852,-0.977964,2
4879,0,0,0,0,842,230,5951,267,6218,-0.0250078,0.160816,-0.986667,2
4799,0,0,0,0,721,197,5717,298,6015,-0.0249396,0.154365,-0.987699,2
4633,0,0,0,0,603,164,5400,283,5683,-0.0329113,0.175927,-0.983853,2
4570,0,0,0,0,451,138,5159,288,5447,-0.0128939,0.156911,-0.987528,2
4937,0,0,0,0,381,119,5437,273,5710,-0.00442113,0.125373,-0.9921,2
4715,0,0,0,0,379,113,5207,263,5470,0.0011491,0.121621,-0.992576,2
4717,0,0,0,0,376,105,5198,239,5437,-0.013216,0.119672,-0.992726,2
4744,0,0,0,0,519,143,5406,314,5720,-0.0333841,0.15009,-0.988108,2
4820,0,0,0,0,439,138,5397,301,5698,-0.0615142,0.178863,-0.981949,2
4775,0,0,0,0,486,118,5379,381,5760,-0.0643904,0.187096,-0.980229,2
4547,0,0,0,0,419,122,5088,445,5533,-0.0422122,0.14893,-0.987946,2
4572,0,0,0,0,471,117,5160,442,5602,-0.0358588,0.179417,-0.983119,2
4539,0,0,0,0,392,119,5050,403,5453,-0.0279461,0.157352,-0.987147,2
4718,0,0,0,0,371,108,5197,409,5606,-0.0289235,0.163197,-0.986169,2
4565,0,0,0,0,324,104,4993,421,5414,-0.00561786,0.146393,-0.989211,2
4447,0,0,0,0,345,100,4892,396,5288,0.00766496,0.132302,-0.99118,2
4495,0,0,0,0,305,109,4909,480,5389,-0.00189485,0.135084,-0.990832,2
4545,0,0,0,0,326,82,4953,417,5370,-0.0225633,0.12564,-0.991819,2
4443,0,0,0,0,314,79,4836,444,5280,-0.0113652,0.0712204,-0.997396,2
4497,0,0,0,0,257,94,4848,435,5283,-0.0100948,0.0337283,-0.99938,2
4359,0,0,0,0,289,81,4729,480,5209,-0.0209426,0.0465474,-0.998697,2
4311,0,0,0,0,318,85,4714,457,5171,-0.0232603,0.0633214,-0.997722,2
4341,0,0,0,0,314,104,4759,456,5215,-0.0212596,0.068801,-0.997404,2
4415,0,0,0,0,415,100,4930,404,5334,-0.00802224,0.112101,-0.993664,2
4629,0,0,0,0,490,120,5239,395,5634,0.0140858,0.120618,-0.992599,2
4744,0,0,0,0,558,151,5453,343,5796,0.0683596,0.103767,-0.99225,2
4917,0,0,0,0,609,191,5717,379,6096,0.106696,0.0737314,-0.991554,2
5044,0,0,0,0,672,183,5899,544,6443,0.129299,0.0704823,-0.989097,2
4999,0,0,0,0,836,234,6069,563,6632,0.144063,0.110018,-0.983434,2
4438,0,0,0,0,632,167,5237,384,5621,0.14598,0.0621053,-0.987336,2
2732,0,0,0,0,570,153,3455,314,3769,0.138196,0.0283688,-0.989999,2
5404,0,0,0,0,1131,291,6826,583,7409,0.123771,0.0238518,-0.992024,2
5739,0,0,0,0,1387,330,7456,626,8082,0.115496,0.0305858,-0.992837,2
5371,0,0,0,0,1213,310,6894,462,7356,0.106323,0.0383737,-0.993591,2
5830,0,0,0,0,1627,390,7847,520,8367,0.103226,0.0410753,-0.99381,2
5859,0,0,0,0,1593,401,7853,458,8311,0.101759,0.0426231,-0.993896,2
6176,0,0,0,0,1588,408,8172,322,8494,0.0997745,0.0376653,-0.994297,2
5005,0,0,0,0,1219,341,6565,264,6829,0.116467,0.0614901,-0.991289,2
6372,0,0,0,0,1783,444,8599,430,9029,0.129203,0.110863,-0.985401,2
6462,0,0,0,0,1947,490,8899,589,9488,0.0774934,0.184144,-0.97984,2
6375,0,0,0,0,1893,468,8736,718,9454,0.0505333,0.162662,-0.985387,2
6402,0,0,0,0,1571,413,8386,646,9032,0.0303054,0.142567,-0.989321,2
4088,0,0,0,0,1121,294,5503,486,5989,0.0206341,0.12247,-0.992258,2
5998,0,0,0,0,1682,397,8077,655,8732,0.0134352,0.11035,-0.993802,2
5772,0,0,0,0,1600,410,7782,685,8467,0.00902122,0.130672,-0.991385,2
5901,0,0,0,0,1542,405,7848,677,8525,0.00668697,0.151845,-0.988382,2
5899,0,0,0,0,1569,401,7869,690,8559,-0.00206976,0.159222,-0.987241,2
5753,0,0,0,0,1471,361,7585,781,8366,-0.00555639,0.159999,-0.987101,2
6426,0,0,0,0,1618,410,8454,832,9286,-0.0101482,0.155894,-0.987722,2
6508,0,0,0,0,1522,390,8420,877,9297,-0.0103084,0.144762,-0.989413,2
4333,0,0,0,0,1015,257,5605,617,6222,-0.00837555,0.118216,-0.992953,2
6693,0,0,0,0,1410,341,8444,866,9310,-0.00768548,0.103012,-0.99465,2
5607,0,0,0,0,1294,326,7227,708,7935,-0.00828277,0.0910009,-0.995816,2
6275,0,0,0,0,1432,391,8098,862,8960,-0.00721985,0.0845816,-0.99639,2
6142,0,0,0,0,1405,339,7886,792,8678,-0.0117155,0.0795772,-0.99676,2
6122,0,0,0,0,1402,372,7896,671,8567,-0.0154173,0.0769097,-0.996919,2
3231,0,0,0,0,598,159,3988,326,4314,-0.0196269,0.0755641,-0.996948,2
2461,0,0,0,0,565,151,3177,311,3488,-0.0191752,0.075932,-0.996929,2
5654,0,0,0,0,1265,344,7263,693,7956,-0.019607,0.0755195,-0.996951,2
6070,0,0,0,0,1397,340,7807,803,8610,-0.0196082,0.0753601,-0.996964,2
6004,0,0,0,0,1011,252,7267,555,7822,-0.019817,0.0728783,-0.997144,2
3194,0,0,0,0,732,201,4127,418,4545,-0.0195641,0.0717389,-0.997232,2
5985,0,0,0,0,1390,352,7727,764,8491,-0.022203,0.0706807,-0.997252,2
6425,0,0,0,0,1388,437,8250,741,8991,-0.0211056,0.0686074,-0.99742,2
4154,0,0,0,0,1035,237,5426,540,5966,-0.0226584,0.068646,-0.997384,2
4289,0,0,0,0,974,257,5520,518,6038,-0.0257957,0.0689365,-0.997288,2
6201,0,0,0,0,1416,463,8080,989,9069,-0.0277029,0.0708027,-0.997106,2
4186,0,0,0,0,1053,261,5500,549,6049,-0.0292517,0.0710719,-0.997042,2
6097,0,0,0,0,1520,410,8027,815,8842,-0.030499,0.0702529,-0.997063,2
6229,0,0,0,0,1501,422,8152,793,8945,-0.0299528,0.0704984,-0.997062,2
6025,0,0,0,0,1079,250,7354,572,7926,-0.0278451,0.0719256,-0.997021,2
3143,0,0,0,0,755,199,4097,413,4510,-0.0279551,0.071113,-0.997076,2
2113,0,0,0,0,501,123,2737,300,3037,-0.0271216,0.0699866,-0.997179,2
5973,0,0,0,0,1447,342,7762,763,8525,-0.0253756,0.0696299,-0.99725,2
6148,0,0,0,0,1404,344,7896,751,8647,-0.0251984,0.0717197,-0.997106,2
6094,0,0,0,0,1392,343,7829,788,8617,-0.0268441,0.0742348,-0.996879,2
6021,0,0,0,0,1469,391,7881,841,8722,-0.0290697,0.074692,-0.996783,2
6240,0,0,0,0,1412,417,8069,812,8881,-0.027641,0.0711357,-0.997084,2
6110,0,0,0,0,1460,382,7952,774,8726,-0.0289131,0.0706008,-0.997085,2
6463,0,0,0,0,1414,378,8255,815,9070,-0.0299127,0.0689225,-0.997173,2
6161,0,0,0,0,1512,378,8051,811,8862,-0.0304815,0.0674843,-0.997255,2
7210,0,0,0,0,1433,412,9055,818,9873,-0.0289012,0.065961,-0.997404,2
6075,0,0,0,0,1465,379,7919,782,8701,-0.0283497,0.0689818,-0.997215,2
6191,0,0,0,0,1466,354,8011,819,8830,-0.0298612,0.0689017,-0.997177,2
6055,0,0,0,0,1502,393,7950,817,8767,-0.0287548,0.0700458,-0.997129,2
6311,0,0,0,0,1502,443,8256,863,9119,-0.0296198,0.0680285,-0.997244,2
5284,0,0,0,0,990,269,6543,563,7106,-0.0302622,0.0686487,-0.997182,2
3266,0,0,0,0,757,215,4238,401,4639,-0.0286032,0.0673148,-0.997322,2
4559,0,0,0,0,1109,298,5966,598,6564,-0.0300218,0.0672081,-0.997287,2
6095,0,0,0,0,1516,388,7999,785,8784,-0.031463,0.0678698,-0.997198,2
6273,0,0,0,0,1541,401,8215,766,8981,-0.0310593,0.0693583,-0.997108,2
5999,0,0,0,0,1485,396,7880,810,8690,-0.0322756,0.0706543,-0.996979,2
6311,0,0,0,0,1595,392,8298,796,9094,-0.0339255,0.0697913,-0.996985,2
6261,0,0,0,0,1587,376,8224,875,9099,-0.0306595,0.0687612,-0.997162,2
6450,0,0,0,0,1475,356,8281,756,9037,-0.0269105,0.0700463,-0.997181,2
6209,0,0,0,0,1451,375,8035,767,8802,-0.0281859,0.0708071,-0.997092,2
5847,0,0,0,0,993,254,7094,529,7623,-0.0288819,0.0698449,-0.99714,2
3207,0,0,0,0,777,196,4180,435,4615,-0.0286646,0.068752,-0.997222,2
5146,0,0,0,0,1185,332,6663,632,7295,-0.0273447,0.0686838,-0.997264,2
