Downsample[ns],BuildFilTree[ns],SearchFil[ns],DeleteFil[ns],BuildTreeSub[ns],SearchSub[ns],DeleteSub[ns],PreProcTotal[ns],Plane[ns],Total[ns],nx,ny,nz,planeCount
2642,0,0,0,0,430,109,3181,233,3414,-0.00518438,0.0217288,-0.99975,0
2593,0,0,0,0,437,112,3142,257,3399,-0.00518787,0.02133,-0.999759,0
2610,0,0,0,0,446,104,3160,244,3404,-0.00555445,0.0212868,-0.999758,0
2528,0,0,0,0,429,102,3059,247,3306,-0.00394412,0.0219798,-0.999751,0
2560,0,0,0,0,426,116,3102,251,3353,-0.0055917,0.0211996,-0.99976,0
2682,0,0,0,0,437,107,3226,237,3463,-0.00501646,0.0223381,-0.999738,0
2559,0,0,0,0,433,106,3098,249,3347,-0.00517065,0.0212857,-0.99976,0
2805,0,0,0,0,438,108,3351,273,3624,-0.00438284,0.0216323,-0.999756,0
3840,0,0,0,0,695,153,4688,296,4984,-0.00516281,0.0216936,-0.999751,0
2669,0,0,0,0,481,114,3264,238,3502,-0.00545518,0.0212282,-0.99976,0
2557,0,0,0,0,428,103,3088,256,3344,-0.00455985,0.0218686,-0.999751,0
2664,0,0,0,0,492,107,3263,246,3509,-0.00523441,0.0211928,-0.999762,0
2610,0,0,0,0,429,106,3145,242,3387,-0.00549886,0.0209737,-0.999765,0
2670,0,0,0,0,495,111,3276,246,3522,-0.00535925,0.0213774,-0.999757,0
2636,0,0,0,0,444,110,3190,238,3428,-0.00381011,0.0218416,-0.999754,0
2636,0,0,0,0,467,105,3208,256,3464,-0.00589524,0.020809,-0.999766,0
2574,0,0,0,0,435,109,3118,241,3359,-0.00498647,0.0214473,-0.999758,0
2516,0,0,0,0,423,109,3048,246,3294,-0.00510466,0.0208914,-0.999769,0
2699,0,0,0,0,462,109,3270,240,3510,-0.00559023,0.0211105,-0.999762,0
2588,0,0,0,0,427,108,3123,245,3368,-0.0045533,0.0213064,-0.999763,0
2523,0,0,0,0,432,107,3062,245,3307,-0.00554604,0.0208547,-0.999767,0
2596,0,0,0,0,484,103,3183,255,3438,-0.00451905,0.0214161,-0.99976,0
2748,0,0,0,0,434,107,3289,245,3534,-0.00526245,0.0219797,-0.999745,0
2630,0,0,0,0,437,116,3183,242,3425,-0.00523672,0.0213642,-0.999758,0
2650,0,0,0,0,427,102,3179,248,3427,-0.0060851,0.0209821,-0.999761,0
2573,0,0,0,0,468,116,3157,247,3404,-0.00555658,0.0216881,-0.999749,0
2639,0,0,0,0,451,105,3195,238,3433,-0.00452233,0.0216456,-0.999756,0
2544,0,0,0,0,426,107,3077,241,3318,-0.00533513,0.021015,-0.999765,0
2548,0,0,0,0,527,132,3207,244,3451,-0.00483725,0.0209405,-0.999769,0
2654,0,0,0,0,471,138,3263,249,3512,-0.00530985,0.020707,-0.999771,0
2687,0,0,0,0,444,104,3235,252,3487,-0.00476649,0.0209328,-0.99977,0
2747,0,0,0,0,451,117,3315,250,3565,-0.00518008,0.020272,-0.999781,0
2761,0,0,0,0,461,119,3341,259,3600,-0.00562041,0.0204353,-0.999775,0
2595,0,0,0,0,476,109,3180,242,3422,-0.00645577,0.0200035,-0.999779,0
2627,0,0,0,0,423,103,3153,244,3397,-0.00528328,0.0208639,-0.999768,0
2576,0,0,0,0,429,104,3109,241,3350,-0.00535793,0.0207387,-0.999771,0
2631,0,0,0,0,434,123,3188,248,3436,-0.00360751,0.0212416,-0.999768,0
2575,0,0,0,0,438,104,3117,240,3357,-0.00570823,0.0207024,-0.999769,0
2785,0,0,0,0,438,108,3331,234,3565,-0.00501564,0.0204523,-0.999778,0
2609,0,0,0,0,424,102,3135,256,3391,-0.00466134,0.0211609,-0.999765,0
2651,0,0,0,0,487,112,3250,248,3498,-0.00463325,0.0209945,-0.999769,0
2765,0,0,0,0,541,115,3421,255,3676,-0.00542521,0.0210309,-0.999764,0
2727,0,0,0,0,435,109,3271,264,3535,-0.00619399,0.0204446,-0.999772,0
2820,0,0,0,0,430,104,3354,261,3615,-0.00490929,0.0208084,-0.999771,0
2792,0,0,0,0,427,102,3321,249,3570,-0.00554584,0.0209199,-0.999766,0
2550,0,0,0,0,443,111,3104,248,3352,-0.0053791,0.0205796,-0.999774,0
2726,0,0,0,0,478,104,3308,251,3559,-0.00630108,0.0201852,-0.999776,0
3671,0,0,0,0,680,147,4498,284,4782,-0.00492529,0.0208639,-0.99977,0
2785,0,0,0,0,442,108,3335,265,3600,-0.00474337,0.0212533,-0.999763,0
2839,0,0,0,0,440,107,3386,251,3637,-0.0050366,0.0207378,-0.999772,0
2591,0,0,0,0,497,104,3192,253,3445,-0.0058104,0.0206859,-0.999769,0
2789,0,0,0,0,435,107,3331,246,3577,-0.00516117,0.020936,-0.999768,0
2544,0,0,0,0,434,116,3094,250,3344,-0.00546815,0.0204529,-0.999776,0
2660,0,0,0,0,424,103,3187,239,3426,-0.00543136,0.0209257,-0.999766,0
2863,0,0,0,0,506,105,3474,244,3718,-0.00455644,0.0215916,-0.999757,0
2639,0,0,0,0,455,108,3202,262,3464,-0.00504703,0.0206478,-0.999774,0
2637,0,0,0,0,428,103,3168,240,3408,-0.00564931,0.0208386,-0.999767,0
2662,0,0,0,0,541,122,3325,253,3578,-0.00545301,0.0209388,-0.999766,0
2713,0,0,0,0,424,106,3243,242,3485,-0.00592159,0.0204587,-0.999773,0
2561,0,0,0,0,435,114,3110,254,3364,-0.00579726,0.0209254,-0.999764,0
2608,0,0,0,0,478,103,3189,247,3436,-0.00538169,0.0208944,-0.999767,0
3677,0,0,0,0,691,151,4519,302,4821,-0.00541641,0.0201499,-0.999782,0
2621,0,0,0,0,512,105,3238,240,3478,-0.00613945,0.0204707,-0.999772,0
2618,0,0,0,0,424,106,3148,241,3389,-0.00535023,0.0209853,-0.999765,0
2627,0,0,0,0,423,106,3156,242,3398,-0.00560581,0.0206514,-0.999771,0
2583,0,0,0,0,509,111,3203,272,3475,-0.0064212,0.0203395,-0.999772,0
2611,0,0,0,0,439,107,3157,248,3405,-0.00482698,0.0209369,-0.999769,0
2558,0,0,0,0,458,121,3137,237,3374,-0.00563823,0.0208669,-0.999766,0
2744,0,0,0,0,507,117,3368,241,3609,-0.0050946,0.0208739,-0.999769,0
2631,0,0,0,0,504,120,3255,240,3495,-0.00501587,0.0207431,-0.999772,0
2666,0,0,0,0,433,106,3205,260,3465,-0.00600281,0.0205623,-0.99977,0
2721,0,0,0,0,426,104,3251,247,3498,-0.0049257,0.0210653,-0.999766,0
2655,0,0,0,0,449,127,3231,253,3484,-0.00524808,0.0208204,-0.999769,0
2667,0,0,0,0,437,107,3211,241,3452,-0.00628271,0.0203361,-0.999773,0
2731,0,0,0,0,422,105,3258,274,3532,-0.00415237,0.0211454,-0.999768,0
2591,0,0,0,0,443,106,3140,259,3399,-0.00507484,0.0205382,-0.999776,0
2577,0,0,0,0,438,108,3123,272,3395,-0.0056263,0.0201782,-0.999781,0
2762,0,0,0,0,490,128,3380,258,3638,-0.004537,0.0209152,-0.999771,0
2871,0,0,0,0,436,121,3428,237,3665,-0.00514072,0.0204763,-0.999777,0
2616,0,0,0,0,433,103,3152,244,3396,-0.00536067,0.0206664,-0.999772,0
2607,0,0,0,0,447,104,3158,237,3395,-0.00492951,0.0203819,-0.99978,0
2595,0,0,0,0,465,115,3175,247,3422,-0.00496936,0.0208766,-0.99977,0
2616,0,0,0,0,482,106,3204,242,3446,-0.00565347,0.0205253,-0.999773,0
2670,0,0,0,0,447,103,3220,257,3477,-0.00517629,0.0203052,-0.99978,0
2648,0,0,0,0,429,109,3186,231,3417,-0.00498298,0.0203629,-0.99978,0
2602,0,0,0,0,430,105,3137,249,3386,-0.00596612,0.020478,-0.999772,0
2686,0,0,0,0,423,107,3216,231,3447,-0.00523005,0.0203569,-0.999779,0
2709,0,0,0,0,423,106,3238,275,3513,-0.00557802,0.0207426,-0.999769,0
2677,0,0,0,0,493,108,3278,240,3518,-0.00446154,0.0206332,-0.999777,0
3707,0,0,0,0,501,124,4332,290,4622,-0.00544276,0.0209031,-0.999767,0
2660,0,0,0,0,484,130,3274,237,3511,-0.00520372,0.0207282,-0.999772,0
2697,0,0,0,0,492,106,3295,237,3532,-0.00516652,0.020247,-0.999782,0
2543,0,0,0,0,524,110,3177,239,3416,-0.00513262,0.0207173,-0.999772,0
2776,0,0,0,0,456,115,3347,239,3586,-0.0054463,0.0205373,-0.999774,0
2775,0,0,0,0,503,103,3381,257,3638,-0.00460184,0.0206371,-0.999776,0
2749,0,0,0,0,657,125,3531,264,3795,-0.00426458,0.0205167,-0.99978,0
2573,0,0,0,0,499,115,3187,257,3444,-0.00538546,0.0206136,-0.999773,0
3747,0,0,0,0,741,165,4653,297,4950,-0.00536517,0.0201494,-0.999783,0
2792,0,0,0,0,437,108,3337,229,3566,-0.00446842,0.0205646,-0.999779,0
2563,0,0,0,0,428,107,3098,231,3329,-0.00506079,0.020695,-0.999773,0
2679,0,0,0,0,431,107,3217,272,3489,-0.00441545,0.0206239,-0.999778,0
2600,0,0,0,0,434,109,3143,241,3384,-0.0056012,0.0197326,-0.99979,0
2664,0,0,0,0,441,103,3208,256,3464,-0.00380207,0.0208584,-0.999775,0
2700,0,0,0,0,444,114,3258,265,3523,-0.0044661,0.0201135,-0.999788,0
2623,0,0,0,0,464,109,3196,251,3447,-0.00460522,0.0204944,-0.999779,0
2764,0,0,0,0,424,104,3292,238,3530,-0.00440532,0.0209642,-0.999771,0
2554,0,0,0,0,515,115,3184,260,3444,-0.00509915,0.0201044,-0.999785,0
2752,0,0,0,0,424,118,3294,282,3576,-0.00526955,0.020359,-0.999779,0
2539,0,0,0,0,430,106,3075,247,3322,-0.00659346,0.0193009,-0.999792,0
2553,0,0,0,0,489,113,3155,239,3394,-0.00568768,0.0194571,-0.999794,0
2538,0,0,0,0,454,108,3100,248,3348,-0.00452341,0.0206661,-0.999776,0
2631,0,0,0,0,443,120,3194,255,3449,-0.00476323,0.0201735,-0.999785,0
2810,0,0,0,0,507,109,3426,249,3675,-0.00536712,0.0198257,-0.999789,0
2621,0,0,0,0,438,104,3163,298,3461,-0.00651312,0.0196866,-0.999785,0
2561,0,0,0,0,435,103,3099,246,3345,-0.00531228,0.0203795,-0.999778,0
2565,0,0,0,0,431,109,3105,236,3341,-0.00603312,0.019595,-0.99979,0
2985,0,0,0,0,516,112,3613,239,3852,-0.00650071,0.0201135,-0.999777,0
2779,0,0,0,0,486,111,3376,256,3632,-0.00620659,0.0197989,-0.999785,0
2646,0,0,0,0,431,107,3184,238,3422,-0.00449315,0.0203883,-0.999782,0
2573,0,0,0,0,448,107,3128,261,3389,-0.00519679,0.0191958,-0.999802,0
2561,0,0,0,0,427,104,3092,237,3329,-0.00373878,0.0206034,-0.999781,0
2600,0,0,0,0,441,109,3150,233,3383,-0.00586537,0.0192161,-0.999798,0
2636,0,0,0,0,453,119,3208,271,3479,-0.00559048,0.0194351,-0.999796,0
2542,0,0,0,0,430,107,3079,240,3319,-0.00482946,0.0198089,-0.999792,0
2643,0,0,0,0,435,102,3180,239,3419,-0.00481439,0.0202671,-0.999783,0
2618,0,0,0,0,421,104,3143,238,3381,-0.00465092,0.0201156,-0.999787,0
2660,0,0,0,0,430,104,3194,260,3454,-0.00573411,0.0191098,-0.999801,0
2498,0,0,0,0,425,107,3030,247,3277,-0.00560024,0.0200226,-0.999784,0
2565,0,0,0,0,440,103,3108,250,3358,-0.00460042,0.020414,-0.999781,0
3988,0,0,0,0,449,105,4542,236,4778,-0.00429503,0.0199264,-0.999792,0
2678,0,0,0,0,460,109,3247,240,3487,-0.00506554,0.020473,-0.999778,0
2800,0,0,0,0,440,107,3347,252,3599,-0.00470305,0.0198766,-0.999791,0
2662,0,0,0,0,439,120,3221,236,3457,-0.00534217,0.019837,-0.999789,0
2583,0,0,0,0,458,113,3154,258,3412,-0.00516625,0.0192933,-0.9998,0
2639,0,0,0,0,443,103,3185,253,3438,-0.00556675,0.0195763,-0.999793,0
2619,0,0,0,0,431,106,3156,248,3404,-0.00407527,0.0201832,-0.999788,0
2593,0,0,0,0,436,104,3133,242,3375,-0.00544964,0.0197485,-0.99979,0
2540,0,0,0,0,462,135,3137,243,3380,-0.00422819,0.0205956,-0.999779,0
2675,0,0,0,0,448,109,3232,239,3471,-0.00491049,0.0202341,-0.999783,0
2592,0,0,0,0,428,108,3128,249,3377,-0.00407967,0.0198093,-0.999795,0
2551,0,0,0,0,451,108,3110,239,3349,-0.00545413,0.0194938,-0.999795,0
2568,0,0,0,0,423,102,3093,251,3344,-0.00393468,0.020633,-0.999779,0
2657,0,0,0,0,423,107,3187,238,3425,-0.00507081,0.0198077,-0.999791,0
2689,0,0,0,0,481,103,3273,243,3516,-0.00448999,0.0202631,-0.999785,0
2582,0,0,0,0,431,104,3117,232,3349,-0.00396407,0.0201886,-0.999788,0
2618,0,0,0,0,424,113,3155,244,3399,-0.00473546,0.0198571,-0.999792,0
2722,0,0,0,0,425,113,3260,273,3533,-0.00476193,0.0203581,-0.999781,0
2681,0,0,0,0,464,104,3249,328,3577,-0.00443727,0.0197316,-0.999795,0
2697,0,0,0,0,453,105,3255,234,3489,-0.00514942,0.0196783,-0.999793,0
3666,0,0,0,0,735,152,4553,284,4837,-0.00413437,0.0201633,-0.999788,0
2541,0,0,0,0,433,122,3096,241,3337,-0.00472739,0.0195102,-0.999798,0
2559,0,0,0,0,452,110,3121,238,3359,-0.00507357,0.019748,-0.999792,0
2561,0,0,0,0,545,109,3215,240,3455,-0.00483616,0.0198031,-0.999792,0
2555,0,0,0,0,499,106,3160,242,3402,-0.00478579,0.020468,-0.999779,0
2569,0,0,0,0,455,111,3135,248,3383,-0.00391099,0.0203966,-0.999784,0
2554,0,0,0,0,456,105,3115,263,3378,-0.00459427,0.019077,-0.999808,0
2550,0,0,0,0,438,109,3097,254,3351,-0.00478988,0.0195492,-0.999797,0
2502,0,0,0,0,429,103,3034,258,3292,-0.00472955,0.0202457,-0.999784,0
3022,0,0,0,0,664,111,3797,259,4056,-0.0039592,0.020054,-0.999791,0
2575,0,0,0,0,469,104,3148,241,3389,-0.00513098,0.0195401,-0.999796,0
2538,0,0,0,0,427,120,3085,250,3335,-0.00392083,0.0196435,-0.999799,0
2558,0,0,0,0,469,124,3151,261,3412,-0.00551736,0.018878,-0.999807,0
2728,0,0,0,0,432,106,3266,241,3507,-0.00446094,0.0195254,-0.999799,0
2700,0,0,0,0,442,106,3248,260,3508,-0.00523796,0.0195994,-0.999794,0
2606,0,0,0,0,429,106,3141,313,3454,-0.00518332,0.0192028,-0.999802,0
2768,0,0,0,0,464,108,3340,245,3585,-0.004338,0.0194589,-0.999801,0
2604,0,0,0,0,501,109,3214,263,3477,-0.00421786,0.0202331,-0.999786,0
2672,0,0,0,0,504,112,3288,265,3553,-0.00573958,0.0191905,-0.999799,0
2587,0,0,0,0,432,103,3122,274,3396,-0.00466963,0.0197047,-0.999795,0
2596,0,0,0,0,465,109,3170,280,3450,-0.00549681,0.0188927,-0.999806,0
2600,0,0,0,0,431,103,3134,237,3371,-0.00508231,0.0193037,-0.999801,0
2591,0,0,0,0,438,106,3135,254,3389,-0.00460608,0.019511,-0.999799,0
2562,0,0,0,0,471,133,3166,242,3408,-0.00351685,0.0199074,-0.999796,0
2568,0,0,0,0,441,102,3111,246,3357,-0.0050929,0.0193468,-0.9998,0
2589,0,0,0,0,426,107,3122,241,3363,-0.0053652,0.0194246,-0.999797,0
2555,0,0,0,0,449,104,3108,244,3352,-0.00470005,0.0193417,-0.999802,0
3035,0,0,0,0,450,122,3607,264,3871,-0.00507651,0.0190989,-0.999805,0
2634,0,0,0,0,422,106,3162,251,3413,-0.00614522,0.0183054,-0.999814,0
2869,0,0,0,0,423,115,3407,263,3670,-0.00502897,0.0189596,-0.999808,0
2663,0,0,0,0,516,122,3301,235,3536,-0.00603152,0.0188616,-0.999804,0
2599,0,0,0,0,480,159,3238,236,3474,-0.00493467,0.0193242,-0.999801,0
2594,0,0,0,0,505,105,3204,260,3464,-0.00527333,0.0193572,-0.999799,0
2620,0,0,0,0,473,113,3206,248,3454,-0.00546944,0.0189563,-0.999805,0
2615,0,0,0,0,436,103,3154,259,3413,-0.00428508,0.0192922,-0.999805,0
2652,0,0,0,0,464,103,3219,235,3454,-0.00574149,0.0184358,-0.999814,0
2802,0,0,0,0,452,114,3368,270,3638,-0.00532869,0.018851,-0.999808,0
2591,0,0,0,0,446,104,3141,247,3388,-0.00555961,0.0189284,-0.999805,0
2633,0,0,0,0,444,110,3187,238,3425,-0.00460103,0.0189327,-0.99981,0
2736,0,0,0,0,484,107,3327,252,3579,-0.00387898,0.019196,-0.999808,0
2637,0,0,0,0,444,104,3185,284,3469,-0.00523322,0.0190403,-0.999805,0
2584,0,0,0,0,428,102,3114,250,3364,-0.00481776,0.0191461,-0.999805,0
2594,0,0,0,0,449,105,3148,245,3393,-0.00466495,0.0192656,-0.999804,0
2605,0,0,0,0,437,104,3146,266,3412,-0.00570062,0.0184541,-0.999813,0
2598,0,0,0,0,475,113,3186,239,3425,-0.00535396,0.0189129,-0.999807,0
2546,0,0,0,0,445,107,3098,252,3350,-0.00464341,0.019601,-0.999797,0
2573,0,0,0,0,449,113,3135,257,3392,-0.00479112,0.0190949,-0.999806,0
2591,0,0,0,0,433,106,3130,251,3381,-0.00538075,0.0187873,-0.999809,0
2600,0,0,0,0,432,108,3140,255,3395,-0.0041826,0.0189165,-0.999812,0
2524,0,0,0,0,480,116,3120,237,3357,-0.00412318,0.0191983,-0.999807,0
2583,0,0,0,0,442,103,3128,248,3376,-0.00435416,0.0190174,-0.99981,0
2577,0,0,0,0,432,103,3112,246,3358,-0.0051418,0.0183059,-0.999819,0
2556,0,0,0,0,422,115,3093,235,3328,-0.00406222,0.0191062,-0.999809,0
2698,0,0,0,0,435,114,3247,243,3490,-0.00469612,0.0191188,-0.999806,0
2697,0,0,0,0,444,103,3244,236,3480,-0.00395506,0.0185915,-0.999819,0
2669,0,0,0,0,451,134,3254,275,3529,-0.00519093,0.0178081,-0.999828,0
2527,0,0,0,0,426,102,3055,235,3290,-0.00520283,0.0182627,-0.99982,0
2678,0,0,0,0,433,114,3225,251,3476,-0.00475428,0.0185384,-0.999817,0
2715,0,0,0,0,429,108,3252,247,3499,-0.00447985,0.018216,-0.999824,0
2666,0,0,0,0,430,115,3211,234,3445,-0.00556849,0.0178533,-0.999825,0
2580,0,0,0,0,442,103,3125,253,3378,-0.00457994,0.0187269,-0.999814,0
2578,0,0,0,0,478,106,3162,247,3409,-0.00370986,0.0187622,-0.999817,0
2641,0,0,0,0,422,111,3174,240,3414,-0.00551159,0.0172875,-0.999835,0
2571,0,0,0,0,499,123,3193,244,3437,-0.00548323,0.0183359,-0.999817,0
3006,0,0,0,0,471,109,3586,260,3846,-0.00461409,0.0179544,-0.999828,0
2600,0,0,0,0,432,107,3139,254,3393,-0.00518194,0.0180293,-0.999824,0
2640,0,0,0,0,446,116,3202,248,3450,-0.00463303,0.0179745,-0.999828,0
2576,0,0,0,0,474,105,3155,244,3399,-0.00585703,0.0176361,-0.999827,0
2661,0,0,0,0,525,109,3295,237,3532,-0.00471892,0.018662,-0.999815,0
2683,0,0,0,0,460,109,3252,275,3527,-0.00536535,0.017506,-0.999832,0
2571,0,0,0,0,429,106,3106,245,3351,-0.00525971,0.0185426,-0.999814,0
2625,0,0,0,0,473,105,3203,250,3453,-0.00542026,0.0182284,-0.999819,0
2574,0,0,0,0,423,113,3110,243,3353,-0.00497212,0.017989,-0.999826,0
2612,0,0,0,0,435,104,3151,228,3379,-0.00518107,0.0180401,-0.999824,0
2622,0,0,0,0,427,107,3156,265,3421,-0.00583688,0.0177501,-0.999825,0
2637,0,0,0,0,475,130,3242,252,3494,-0.00650395,0.0174388,-0.999827,0
2636,0,0,0,0,424,106,3166,248,3414,-0.00510362,0.0179149,-0.999826,0
2665,0,0,0,0,429,108,3202,257,3459,-0.00454633,0.0184008,-0.99982,0
2663,0,0,0,0,436,109,3208,237,3445,-0.00536129,0.0178743,-0.999826,0
2630,0,0,0,0,427,104,3161,256,3417,-0.00526325,0.018256,-0.99982,0
2515,0,0,0,0,507,112,3134,271,3405,-0.00685656,0.0175331,-0.999823,0
2552,0,0,0,0,464,112,3128,241,3369,-0.00462872,0.0182758,-0.999822,0
2787,0,0,0,0,608,125,3520,240,3760,-0.00628519,0.0173179,-0.99983,0
2637,0,0,0,0,436,114,3187,253,3440,-0.00464331,0.0179818,-0.999828,0
2597,0,0,0,0,456,115,3168,248,3416,-0.00541204,0.0180031,-0.999823,0
2634,0,0,0,0,434,107,3175,260,3435,-0.00634709,0.0170514,-0.999835,0
2614,0,0,0,0,432,107,3153,261,3414,-0.00622519,0.017348,-0.99983,0
2630,0,0,0,0,428,111,3169,254,3423,-0.00562338,0.0181053,-0.99982,0
2658,0,0,0,0,458,107,3223,239,3462,-0.00514623,0.0179118,-0.999826,0
2765,0,0,0,0,428,109,3302,250,3552,-0.00338556,0.0183965,-0.999825,0
2907,0,0,0,0,500,113,3520,243,3763,-0.00423641,0.0183188,-0.999823,0
2720,0,0,0,0,458,108,3286,236,3522,-0.00408535,0.0185006,-0.99982,0
2725,0,0,0,0,427,104,3256,280,3536,-0.00642433,0.0171563,-0.999832,0
2565,0,0,0,0,467,109,3141,259,3400,-0.00526054,0.017339,-0.999836,0
2733,0,0,0,0,517,110,3360,235,3595,-0.00570104,0.017283,-0.999834,0
2714,0,0,0,0,536,127,3377,262,3639,-0.00523999,0.0177579,-0.999829,0
2632,0,0,0,0,427,106,3165,248,3413,-0.00552616,0.0178202,-0.999826,0
2596,0,0,0,0,433,104,3133,264,3397,-0.00393722,0.018725,-0.999817,0
2729,0,0,0,0,433,108,3270,245,3515,-0.00409549,0.0184814,-0.999821,0
2745,0,0,0,0,424,106,3275,235,3510,-0.00487019,0.0171811,-0.99984,0
2660,0,0,0,0,484,104,3248,245,3493,-0.005257,0.0177548,-0.999829,0
2624,0,0,0,0,450,109,3183,247,3430,-0.00528477,0.0176303,-0.999831,0
3542,0,0,0,0,488,114,4144,255,4399,-0.00547949,0.0175092,-0.999832,0
2762,0,0,0,0,505,117,3384,243,3627,-0.00478769,0.0177203,-0.999831,0
2680,0,0,0,0,439,109,3228,247,3475,-0.00419546,0.0182974,-0.999824,0
2770,0,0,0,0,441,116,3327,242,3569,-0.00438228,0.0181316,-0.999826,0
2555,0,0,0,0,522,107,3184,241,3425,-0.00463329,0.0176904,-0.999833,0
2842,0,0,0,0,462,105,3409,255,3664,-0.0054747,0.0175011,-0.999832,0
2602,0,0,0,0,475,121,3198,241,3439,-0.00394373,0.0177122,-0.999835,0
2660,0,0,0,0,452,133,3245,351,3596,-0.00499718,0.0176153,-0.999832,0
2747,0,0,0,0,448,112,3307,242,3549,-0.00450574,0.0177429,-0.999832,0
2534,0,0,0,0,433,108,3075,239,3314,-0.00409672,0.0177885,-0.999833,0
2614,0,0,0,0,467,148,3229,244,3473,-0.00565876,0.0174487,-0.999832,0
2576,0,0,0,0,448,105,3129,238,3367,-0.00491929,0.0181441,-0.999823,0
2585,0,0,0,0,482,156,3223,239,3462,-0.00470184,0.0177877,-0.999831,0
2526,0,0,0,0,443,109,3078,239,3317,-0.00435141,0.0178603,-0.999831,0
2544,0,0,0,0,455,104,3103,261,3364,-0.00475959,0.0182265,-0.999823,0
3010,0,0,0,0,488,104,3602,247,3849,-0.00561152,0.0173572,-0.999834,0
2684,0,0,0,0,478,129,3291,239,3530,-0.00616939,0.0171263,-0.999834,0
2628,0,0,0,0,490,118,3236,247,3483,-0.00534454,0.0174649,-0.999833,0
2616,0,0,0,0,496,107,3219,247,3466,-0.00563536,0.0175179,-0.999831,0
3136,0,0,0,0,434,116,3686,245,3931,-0.0053052,0.0173573,-0.999835,0
2554,0,0,0,0,492,108,3154,253,3407,-0.00537009,0.017801,-0.999827,0
2548,0,0,0,0,430,110,3088,250,3338,-0.00526843,0.0175056,-0.999833,0
2772,0,0,0,0,435,111,3318,246,3564,-0.00536307,0.0172548,-0.999837,0
2692,0,0,0,0,448,107,3247,249,3496,-0.00510793,0.0176351,-0.999831,0
2546,0,0,0,0,456,108,3110,247,3357,-0.0048091,0.0178621,-0.999829,0
2831,0,0,0,0,463,111,3405,282,3687,-0.00542803,0.0171056,-0.999839,0
2645,0,0,0,0,524,110,3279,298,3577,-0.00580946,0.0173374,-0.999833,0
2898,0,0,0,0,438,114,3450,242,3692,-0.00564025,0.01651,-0.999848,0
2773,0,0,0,0,434,106,3313,250,3563,-0.00524542,0.0174347,-0.999834,0
2853,0,0,0,0,496,112,3461,257,3718,-0.00589925,0.016533,-0.999846,0
2681,0,0,0,0,415,116,3212,250,3462,-0.0058876,0.0168919,-0.99984,0
2699,0,0,0,0,422,106,3227,263,3490,-0.00570336,0.0172562,-0.999835,0
2697,0,0,0,0,434,106,3237,243,3480,-0.00620286,0.0168815,-0.999838,0
2556,0,0,0,0,420,109,3085,248,3333,-0.00548002,0.017445,-0.999833,0
2616,0,0,0,0,477,108,3201,244,3445,-0.0043079,0.0173702,-0.99984,0
2665,0,0,0,0,488,104,3257,245,3502,-0.00558552,0.0170754,-0.999839,0
2847,0,0,0,0,433,105,3385,226,3611,-0.0051577,0.0177349,-0.999829,0
2532,0,0,0,0,414,104,3050,241,3291,-0.00532459,0.0167663,-0.999845,0
2694,0,0,0,0,450,111,3255,235,3490,-0.00517087,0.0169204,-0.999843,0
2611,0,0,0,0,432,102,3145,242,3387,-0.00506672,0.0175393,-0.999833,0
2601,0,0,0,0,425,104,3130,246,3376,-0.00524927,0.0168521,-0.999844,0
2615,0,0,0,0,413,105,3133,223,3356,-0.00404835,0.0173546,-0.999841,0
2531,0,0,0,0,407,118,3056,237,3293,-0.00567435,0.0168961,-0.999841,0
2655,0,0,0,0,451,105,3211,224,3435,-0.00507373,0.0176187,-0.999832,0
2629,0,0,0,0,409,101,3139,216,3355,-0.00490038,0.017689,-0.999832,0
2811,0,0,0,0,397,99,3307,258,3565,-0.00523595,0.0171459,-0.999839,0
2611,0,0,0,0,393,95,3099,278,3377,-0.00475645,0.0171997,-0.999841,0
2624,0,0,0,0,400,93,3117,275,3392,-0.00421915,0.0178253,-0.999832,0
2669,0,0,0,0,377,96,3142,236,3378,-0.00431868,0.0171309,-0.999844,0
2570,0,0,0,0,372,651,3593,247,3840,-0.00640481,0.0159713,-0.999852,0
2600,0,0,0,0,416,92,3108,255,3363,-0.00511987,0.016691,-0.999848,0
2585,0,0,0,0,400,110,3095,257,3352,-0.00509461,0.0175605,-0.999833,0
2548,0,0,0,0,382,92,3022,248,3270,-0.00569343,0.0168809,-0.999841,0
2671,0,0,0,0,442,100,3213,232,3445,-0.00418463,0.0172584,-0.999842,0
2582,0,0,0,0,388,94,3064,229,3293,-0.00517605,0.0174857,-0.999834,0
2899,0,0,0,0,409,106,3414,208,3622,-0.00657635,0.0182069,-0.999813,0
2642,0,0,0,0,380,92,3114,195,3309,-0.00476255,0.0186665,-0.999814,0
2731,0,0,0,0,376,116,3223,209,3432,-0.00493822,0.0186003,-0.999815,0
2532,0,0,0,0,409,92,3033,227,3260,-0.00636457,0.016189,-0.999849,0
2898,0,0,0,0,396,118,3412,232,3644,-0.00527501,0.0171211,-0.999839,0
2732,0,0,0,0,419,94,3245,234,3479,-0.00434163,0.0172595,-0.999842,0
2672,0,0,0,0,385,101,3158,230,3388,-0.00427776,0.0174082,-0.999839,0
2746,0,0,0,0,389,96,3231,242,3473,-0.00438264,0.0175086,-0.999837,0
2596,0,0,0,0,410,95,3101,253,3354,-0.00536422,0.0168974,-0.999843,0
2710,0,0,0,0,390,91,3191,237,3428,-0.00524463,0.0173796,-0.999835,0
2476,0,0,0,0,416,104,2996,255,3251,-0.00769943,0.0170797,-0.999824,0
2631,0,0,0,0,371,95,3097,235,3332,-0.00567471,0.0178272,-0.999825,0
2484,0,0,0,0,385,90,2959,239,3198,-0.0055705,0.0178397,-0.999825,0
2586,0,0,0,0,399,94,3079,236,3315,-0.00592267,0.0177323,-0.999825,0
2560,0,0,0,0,372,89,3021,242,3263,-0.00684049,0.0174727,-0.999824,0
2669,0,0,0,0,383,92,3144,247,3391,-0.0063184,0.0173976,-0.999829,0
2590,0,0,0,0,449,93,3132,235,3367,-0.0058687,0.0194674,-0.999793,0
2614,0,0,0,0,379,93,3086,236,3322,-0.0066723,0.0193704,-0.99979,0
2513,0,0,0,0,375,91,2979,237,3216,-0.00789825,0.0192711,-0.999783,0
2711,0,0,0,0,509,94,3314,220,3534,-0.00928628,0.0181528,-0.999792,0
2611,0,0,0,0,437,99,3147,225,3372,-0.0122931,0.0138514,-0.999828,0
2802,0,0,0,0,485,109,3396,399,3795,-0.015919,-6.11148e-05,-0.999873,0
2587,0,0,0,0,536,135,3258,419,3677,-0.00985416,0.0205788,-0.99974,0
2677,0,0,0,0,400,102,3179,441,3620,-0.00766252,0.0144908,-0.999866,0
2977,0,0,0,0,431,105,3513,462,3975,-0.0116526,0.027216,-0.999562,0
2830,0,0,0,0,434,105,3369,525,3894,-0.0138208,0.0342256,-0.999319,0
2887,0,0,0,0,440,103,3430,605,4035,-0.0147821,0.0330491,-0.999344,0
2786,0,0,0,0,481,109,3376,688,4064,-0.0129962,0.0336883,-0.999348,0
2789,0,0,0,0,534,115,3438,648,4086,-0.0106143,0.0368938,-0.999263,0
2940,0,0,0,0,487,125,3552,673,4225,-0.0139127,0.0455094,-0.998867,0
2981,0,0,0,0,482,113,3576,690,4266,-0.02148,0.0615629,-0.997872,0
3885,0,0,0,0,481,115,4481,723,5204,0.0210088,0.0221677,-0.999533,0
2795,0,0,0,0,467,115,3377,600,3977,0.0137161,0.0265162,-0.999554,0
2918,0,0,0,0,500,114,3532,651,4183,0.00899357,0.0295325,-0.999523,0
2716,0,0,0,0,459,110,3285,637,3922,0.00200983,0.0311986,-0.999511,0
2697,0,0,0,0,502,110,3309,612,3921,-0.00749504,0.0330461,-0.999426,0
2722,0,0,0,0,488,112,3322,571,3893,0.00393365,0.0225221,-0.999739,0
2853,0,0,0,0,553,131,3537,557,4094,0.00383037,0.0304414,-0.999529,0
2812,0,0,0,0,442,107,3361,562,3923,0.00956666,0.0291652,-0.999529,0
2761,0,0,0,0,469,110,3340,447,3787,0.012714,0.0245205,-0.999619,0
3083,0,0,0,0,466,105,3654,413,4067,-0.00629218,0.0164214,-0.999845,0
2575,0,0,0,0,420,106,3101,411,3512,-0.0139282,0.0206513,-0.99969,0
2544,0,0,0,0,446,99,3089,317,3406,-0.00966876,0.0184698,-0.999783,0
2657,0,0,0,0,387,94,3138,287,3425,-0.00986767,0.0152093,-0.999836,0
2496,0,0,0,0,377,109,2982,244,3226,-0.0136425,0.00977772,-0.999859,0
2624,0,0,0,0,410,89,3123,179,3302,-0.0210506,0.00987854,-0.99973,0
2491,0,0,0,0,395,87,2973,161,3134,-0.0250386,0.00888733,-0.999647,0
2622,0,0,0,0,455,86,3163,155,3318,-0.0326588,0.011999,-0.999395,0
2453,0,0,0,0,333,93,2879,146,3025,-0.0339247,0.00752856,-0.999396,0
2537,0,0,0,0,405,88,3030,125,3155,-0.0364615,0.00408734,-0.999327,0
2734,0,0,0,0,393,190,3317,157,3474,-0.0405146,-0.00323864,-0.999174,0
2594,0,0,0,0,391,95,3080,147,3227,-0.0296809,0.0374117,-0.998859,0
2413,0,0,0,0,334,93,2840,140,2980,-0.0276816,0.028971,-0.999197,0
2606,0,0,0,0,393,83,3082,133,3215,-0.0281965,0.0256593,-0.999273,0
2460,0,0,0,0,331,140,2931,151,3082,-0.0236763,0.0187006,-0.999545,0
2388,0,0,0,0,338,83,2809,115,2924,-0.0198622,0.00438654,-0.999793,0
2375,0,0,0,0,332,88,2795,124,2919,-0.0154387,-0.0135503,-0.999789,0
2406,0,0,0,0,329,79,2814,122,2936,-0.0123223,-0.0343645,-0.999333,0
2443,0,0,0,0,329,80,2852,140,2992,-0.0187521,0.0386648,-0.999076,0
2444,0,0,0,0,331,79,2854,136,2990,-0.021584,0.0599425,-0.997968,0
2581,0,0,0,0,342,86,3009,162,3171,-0.00809359,0.0204589,-0.999758,0
2636,0,0,0,0,359,87,3082,163,3245,0.00128239,-0.00945628,-0.999955,0
2646,0,0,0,0,417,92,3155,179,3334,0.00930294,-0.0431022,-0.999027,0
2715,0,0,0,0,383,87,3185,216,3401,0.0151224,-0.0778367,-0.996851,0
2891,0,0,0,0,424,87,3402,204,3606,0.0225275,-0.120488,-0.992459,0
2735,0,0,0,0,431,153,3319,203,3522,0.0226648,-0.147207,-0.988846,0
3119,0,0,0,0,377,80,3576,210,3786,0.0216227,-0.165675,-0.985943,0
2732,0,0,0,0,378,75,3185,184,3369,0.0230663,-0.179458,-0.983495,0
2689,0,0,0,0,309,73,3071,188,3259,-0.0198663,0.0913718,-0.995619,0
2631,0,0,0,0,326,71,3028,190,3218,-0.0148546,0.0521815,-0.998527,0
2594,0,0,0,0,300,72,2966,195,3161,-0.0253443,0.14169,-0.989587,0
2654,0,0,0,0,292,69,3015,189,3204,-0.0216351,0.103706,-0.994373,0
2537,0,0,0,0,311,68,2916,179,3095,-0.00807165,0.0315784,-0.999469,0
2561,0,0,0,0,286,75,2922,207,3129,-0.00263845,-0.012324,-0.999921,0
2453,0,0,0,0,265,76,2794,187,2981,0.000972643,-0.0412233,-0.99915,0
3044,0,0,0,0,348,64,3456,307,3763,-0.00130715,0.0286486,-0.999589,0
2490,0,0,0,0,254,59,2803,183,2986,-0.014008,0.0492268,-0.998689,0
2629,0,0,0,0,378,86,3093,247,3340,0.00303575,-0.00387723,-0.999988,0
2365,0,0,0,0,223,56,2644,232,2876,-0.000409595,0.0335996,-0.999435,0
2410,0,0,0,0,223,55,2688,237,2925,0.0114814,-0.012191,-0.99986,0
2492,0,0,0,0,241,61,2794,240,3034,0.0173739,-0.0493772,-0.998629,0
2447,0,0,0,0,337,60,2844,235,3079,0.0250996,-0.0912316,-0.995513,0
2472,0,0,0,0,275,59,2806,253,3059,0.032671,-0.134908,-0.990319,0
2590,0,0,0,0,256,62,2908,238,3146,0.0376505,-0.178694,-0.983184,0
2441,0,0,0,0,255,60,2756,253,3009,0.0415251,-0.233921,-0.971368,0
2518,0,0,0,0,237,62,2817,228,3045,-0.00356497,0.0671022,-0.99774,0
2368,0,0,0,0,267,72,2707,223,2930,0.000447886,0.00912447,-0.999958,0
2547,0,0,0,0,272,66,2885,233,3118,0.00572548,-0.0549032,-0.998475,0
2386,0,0,0,0,236,59,2681,212,2893,0.0150215,-0.129053,-0.991524,0
2397,0,0,0,0,257,68,2722,179,2901,0.0275187,-0.202359,-0.978925,0
2357,0,0,0,0,212,66,2635,146,2781,0.0219134,-0.236261,-0.971443,0
2439,0,0,0,0,210,66,2715,180,2895,0.0336571,-0.312548,-0.949305,0
2425,0,0,0,0,240,54,2719,232,2951,0.0380272,-0.377696,-0.925148,0
2471,0,0,0,0,211,53,2735,225,2960,0.0499329,-0.445477,-0.8939,0
2498,0,0,0,0,229,55,2782,240,3022,0.0606254,-0.506347,-0.860196,0
2545,0,0,0,0,275,61,2881,263,3144,0.038135,0.040742,-0.998442,0
2700,0,0,0,0,293,66,3059,230,3289,0.0542513,-0.0207181,-0.998312,0
2700,0,0,0,0,257,66,3023,282,3305,0.0685682,-0.0691884,-0.995244,0
2597,0,0,0,0,324,69,2990,232,3222,0.0268916,0.0600434,-0.997833,0
2539,0,0,0,0,295,73,2907,215,3122,0.0421892,0.00404832,-0.999101,0
2743,0,0,0,0,291,76,3110,195,3305,0.0555094,-0.0194529,-0.998269,0
2645,0,0,0,0,326,78,3049,180,3229,0.0773981,-0.0347194,-0.996396,0
2529,0,0,0,0,341,83,2953,129,3082,0.10348,-0.0549996,-0.99311,0
3867,0,0,0,0,567,129,4563,164,4727,0.0373015,0.203304,-0.978405,0
2721,0,0,0,0,363,92,3176,110,3286,0.0468297,0.300674,-0.952577,0
2710,0,0,0,0,376,93,3179,86,3265,0.0584627,0.315185,-0.947228,0
3758,0,0,0,0,477,111,4346,109,4455,0.0692554,0.446334,-0.892182,0
2668,0,0,0,0,431,113,3212,65,3277,0.1117,0.390711,-0.913711,0
2705,0,0,0,0,441,107,3253,86,3339,0.129207,0.320896,-0.93826,0
2666,0,0,0,0,411,106,3183,92,3275,0.127886,0.422329,-0.897376,0
2633,0,0,0,0,454,112,3199,81,3280,0.151097,0.366772,-0.917959,0
2829,0,0,0,0,451,99,3379,81,3460,0.110381,0.504953,-0.85606,0
2819,0,0,0,0,390,93,3302,91,3393,0.113322,0.478012,-0.871012,0
2819,0,0,0,0,371,87,3277,118,3395,0.0953851,0.632129,-0.76897,0
2638,0,0,0,0,360,82,3080,117,3197,0.0971673,0.688531,-0.718668,0
2711,0,0,0,0,329,87,3127,126,3253,0.0979542,0.665329,-0.740096,0
2617,0,0,0,0,331,74,3022,-1000,-1000,-1,-1,-1,0
2634,0,0,0,0,286,69,2989,504,3493,0.020134,-0.0540686,-0.998334,0
2644,0,0,0,0,265,63,2972,494,3466,-0.0335545,0.123375,-0.991793,0
2701,0,0,0,0,256,62,3019,419,3438,-0.0221698,0.076627,-0.996813,0
2504,0,0,0,0,252,60,2816,361,3177,-0.0391514,0.0927084,-0.994923,0
2635,0,0,0,0,267,60,2962,328,3290,-0.0128197,0.0191644,-0.999734,0
2461,0,0,0,0,260,64,2785,290,3075,0.0154655,-0.0701396,-0.997417,0
2619,0,0,0,0,277,80,2976,309,3285,-0.0587453,0.0942092,-0.993818,0
2761,0,0,0,0,352,79,3192,260,3452,-0.0712806,0.155251,-0.9853,0
2694,0,0,0,0,367,84,3145,235,3380,-0.0435224,0.0492535,-0.997838,0
2640,0,0,0,0,333,98,3071,221,3292,-0.0190841,-0.0526102,-0.998433,0
2625,0,0,0,0,398,96,3119,214,3333,0.00562612,-0.144407,-0.989502,0
2772,0,0,0,0,371,95,3238,199,3437,0.0384253,-0.2568,-0.9657,0
2726,0,0,0,0,446,109,3281,208,3489,0.068367,-0.362498,-0.929473,0
2687,0,0,0,0,420,100,3207,195,3402,0.0933379,-0.447054,-0.889624,0
2723,0,0,0,0,411,107,3241,203,3444,0.114083,-0.524965,-0.843443,0
3336,0,0,0,0,422,108,3866,209,4075,-0.0593113,0.139218,-0.988484,0
2625,0,0,0,0,447,108,3180,200,3380,-0.0463754,0.0431257,-0.997993,0
2634,0,0,0,0,455,135,3224,212,3436,-0.0324677,-0.0658312,-0.997302,0
2763,0,0,0,0,515,116,3394,229,3623,-0.0212764,-0.165021,-0.986061,0
3091,0,0,0,0,474,116,3681,220,3901,-0.0319943,-0.00439204,-0.999478,0
2825,0,0,0,0,466,136,3427,223,3650,-0.041876,0.0428046,-0.998205,0
2721,0,0,0,0,463,119,3303,233,3536,-0.0305638,-0.0624396,-0.997581,0
2924,0,0,0,0,490,116,3530,255,3785,-0.0163543,-0.167997,-0.985652,0
2767,0,0,0,0,458,117,3342,315,3657,-0.0031053,-0.259281,-0.965797,0
2844,0,0,0,0,496,175,3515,363,3878,-0.0122695,0.108768,-0.993991,0
3076,0,0,0,0,464,150,3690,361,4051,-0.0167924,0.148367,-0.98879,0
2642,0,0,0,0,433,107,3182,310,3492,-0.00243839,0.0512926,-0.998681,0
2747,0,0,0,0,400,96,3243,240,3483,-0.020185,0.172619,-0.984782,0
2688,0,0,0,0,372,93,3153,195,3348,0.00186359,0.057325,-0.998354,0
2743,0,0,0,0,393,90,3226,246,3472,-0.0137552,0.175572,-0.98437,0
2573,0,0,0,0,430,95,3098,243,3341,0.00604773,0.0675669,-0.997696,0
2668,0,0,0,0,375,90,3133,190,3323,0.0241143,-0.0189444,-0.99953,0
2629,0,0,0,0,340,92,3061,166,3227,0.0432238,-0.112046,-0.992762,0
2532,0,0,0,0,346,79,2957,151,3108,0.0561724,-0.201783,-0.977818,0
2628,0,0,0,0,316,79,3023,153,3176,0.0772011,-0.301595,-0.950305,0
2633,0,0,0,0,449,91,3173,156,3329,-0.0164146,0.123432,-0.992217,0
2547,0,0,0,0,318,81,2946,172,3118,0.0206594,-0.0108763,-0.999727,0
2560,0,0,0,0,273,77,2910,217,3127,0.0428014,-0.0996081,-0.994106,0
2535,0,0,0,0,271,83,2889,214,3103,0.0553915,-0.163338,-0.985014,0
3750,0,0,0,0,412,89,4251,281,4532,-0.0120165,0.0500723,-0.998673,0
2487,0,0,0,0,216,59,2762,207,2969,-0.0101853,0.0329118,-0.999406,0
2509,0,0,0,0,212,52,2773,197,2970,-0.00415931,0.107126,-0.994237,0
2471,0,0,0,0,194,55,2720,191,2911,-0.00168984,0.0870955,-0.996199,0
2417,0,0,0,0,210,48,2675,180,2855,0.00372167,0.0313559,-0.999501,0
2559,0,0,0,0,169,44,2772,181,2953,0.00420298,0.125506,-0.992084,0
2760,0,0,0,0,171,48,2979,167,3146,0.0217708,0.051848,-0.998418,0
2450,0,0,0,0,188,47,2685,165,2850,0.0334784,0.0104323,-0.999385,0
2431,0,0,0,0,184,49,2664,161,2825,0.0451239,-0.0148533,-0.998871,0
2486,0,0,0,0,259,55,2800,153,2953,0.0589166,-0.0340857,-0.997681,0
2718,0,0,0,0,210,55,2983,145,3128,0.0649619,-0.0484032,-0.996713,0
2547,0,0,0,0,238,61,2846,150,2996,0.0883939,-0.125717,-0.98812,0
2570,0,0,0,0,285,74,2929,159,3088,0.0185738,0.0844281,-0.996256,0
2723,0,0,0,0,245,63,3031,133,3164,0.0234954,0.0380872,-0.998998,0
2573,0,0,0,0,263,76,2912,188,3100,0.0282027,0.00787804,-0.999571,0
2608,0,0,0,0,273,71,2952,144,3096,0.0309653,-0.000873165,-0.99952,0
2634,0,0,0,0,291,72,2997,137,3134,0.0237382,0.175139,-0.984258,0
2556,0,0,0,0,363,78,2997,119,3116,0.0377793,0.168852,-0.984917,0
2691,0,0,0,0,328,82,3101,144,3245,0.0216981,0.325638,-0.945246,0
2461,0,0,0,0,317,80,2858,99,2957,0.0304179,0.359016,-0.932836,0
2438,0,0,0,0,362,92,2892,86,2978,0.0439792,0.370687,-0.927716,0
2500,0,0,0,0,341,87,2928,91,3019,0.0316041,0.502492,-0.864004,0
2601,0,0,0,0,348,92,3041,65,3106,0.0707397,0.403103,-0.912416,0
2588,0,0,0,0,453,94,3135,65,3200,0.0643339,-0.159328,-0.985127,0
2724,0,0,0,0,371,98,3193,282,3475,0.0238186,-0.0734107,-0.997017,0
2678,0,0,0,0,393,102,3173,228,3401,0.00865685,0.00202011,-0.999961,0
2663,0,0,0,0,376,101,3140,153,3293,0.0251939,-0.0290487,-0.99926,0
2687,0,0,0,0,394,100,3181,97,3278,0.0142305,0.0534247,-0.998471,0
2722,0,0,0,0,405,99,3226,103,3329,0.0142253,0.00621482,-0.999879,0
2691,0,0,0,0,428,105,3224,124,3348,0.023774,-0.0559794,-0.998149,0
2783,0,0,0,0,413,102,3298,147,3445,0.0330197,-0.127862,-0.991242,0
2787,0,0,0,0,408,108,3303,184,3487,0.0444846,-0.210508,-0.97658,0
2732,0,0,0,0,399,95,3226,308,3534,0.00468943,0.0852296,-0.99635,0
2731,0,0,0,0,368,103,3202,364,3566,0.0160187,-0.00245779,-0.999869,0
2745,0,0,0,0,354,84,3183,457,3640,0.0266404,-0.0858258,-0.995954,0
2654,0,0,0,0,336,87,3077,490,3567,0.0376072,-0.165618,-0.985473,0
3717,0,0,0,0,529,116,4362,615,4977,0.00782259,-0.0882171,-0.996071,0
2517,0,0,0,0,315,86,2918,502,3420,-0.00021335,0.0339037,-0.999425,0
2668,0,0,0,0,289,89,3046,500,3546,0.0065991,-0.0418469,-0.999102,0
2750,0,0,0,0,276,70,3096,503,3599,0.0160826,-0.116305,-0.993083,0
2619,0,0,0,0,309,73,3001,436,3437,0.026073,-0.183708,-0.982635,0
2683,0,0,0,0,310,74,3067,396,3463,0.00196703,0.0598356,-0.998206,0
2653,0,0,0,0,302,74,3029,359,3388,-0.0146264,0.0733794,-0.997197,0
2684,0,0,0,0,316,94,3094,326,3420,-0.00138626,-0.0162485,-0.999867,0
2711,0,0,0,0,326,81,3118,310,3428,-0.0240183,0.0217272,-0.999475,0
2731,0,0,0,0,388,85,3204,299,3503,-0.0112808,-0.068377,-0.997596,0
2784,0,0,0,0,436,92,3312,282,3594,4.81021e-05,-0.147984,-0.98899,0
2749,0,0,0,0,390,100,3239,293,3532,0.0111235,-0.237179,-0.971402,0
2647,0,0,0,0,408,110,3165,251,3416,0.0207693,-0.323435,-0.946022,0
2723,0,0,0,0,418,107,3248,229,3477,-0.0296222,0.0818407,-0.996205,0
2713,0,0,0,0,498,110,3321,228,3549,-0.0419096,0.0948603,-0.994608,0
2914,0,0,0,0,494,116,3524,249,3773,-0.0413445,0.0957211,-0.994549,0
2682,0,0,0,0,481,111,3274,222,3496,-0.0409339,0.0486923,-0.997975,0
2714,0,0,0,0,427,108,3249,219,3468,-0.0386885,-0.0502172,-0.997989,0
2702,0,0,0,0,452,113,3267,222,3489,-0.0353922,-0.174796,-0.983968,0
2643,0,0,0,0,457,111,3211,225,3436,-0.0318313,-0.283534,-0.958434,0
2767,0,0,0,0,517,143,3427,256,3683,-0.0302217,-0.385722,-0.92212,0
2745,0,0,0,0,474,134,3353,257,3610,-0.0287806,-0.487754,-0.872507,0
2749,0,0,0,0,489,114,3352,245,3597,-0.0280531,-0.580294,-0.813924,0
2829,0,0,0,0,496,128,3453,272,3725,-0.022446,0.158724,-0.987068,0
2745,0,0,0,0,503,120,3368,252,3620,-0.0198873,0.192541,-0.981087,0
2794,0,0,0,0,499,126,3419,275,3694,-0.021326,0.0776496,-0.996753,0
2892,0,0,0,0,481,117,3490,314,3804,-0.0279369,-0.0275008,-0.999231,0
2786,0,0,0,0,460,120,3366,332,3698,-0.00386633,0.116545,-0.993178,0
2789,0,0,0,0,497,130,3416,312,3728,-0.00882366,0.012343,-0.999885,0
2775,0,0,0,0,483,105,3363,228,3591,-0.0166361,-0.0879945,-0.995982,0
2787,0,0,0,0,363,90,3240,164,3404,-0.0188681,-0.190619,-0.981483,0
2684,0,0,0,0,421,89,3194,185,3379,-0.0249229,-0.28418,-0.958447,0
3771,0,0,0,0,619,131,4521,280,4801,-0.0251865,-0.0704339,-0.997198,0
2647,0,0,0,0,381,101,3129,235,3364,-0.00368322,0.0274689,-0.999616,0
2655,0,0,0,0,365,90,3110,203,3313,-0.00899165,-0.0471766,-0.998846,0
2554,0,0,0,0,368,89,3011,190,3201,-0.0127721,-0.120198,-0.992668,0
3021,0,0,0,0,456,88,3565,218,3783,-0.0128842,0.0881068,-0.996028,0
2593,0,0,0,0,337,90,3020,179,3199,-0.0111466,0.0931566,-0.995589,0
2772,0,0,0,0,346,109,3227,192,3419,-0.00673755,0.139934,-0.990138,0
2707,0,0,0,0,368,92,3167,199,3366,-0.00895015,0.0907944,-0.995829,0
2767,0,0,0,0,332,88,3187,181,3368,-0.00597635,0.232075,-0.97268,0
2617,0,0,0,0,382,91,3090,260,3350,-0.00537271,0.220776,-0.97531,0
2558,0,0,0,0,312,90,2960,177,3137,-0.00138629,0.183429,-0.983032,0
2559,0,0,0,0,309,74,2942,196,3138,0.00191856,0.0941179,-0.995559,0
2568,0,0,0,0,277,70,2915,211,3126,-0.00487378,0.115046,-0.993348,0
2469,0,0,0,0,273,69,2811,241,3052,-0.0047971,0.0318189,-0.999482,0
2479,0,0,0,0,252,65,2796,241,3037,-0.00616652,-0.0290111,-0.99956,0
2624,0,0,0,0,267,63,2954,243,3197,-0.00915429,-0.0821295,-0.99658,0
2479,0,0,0,0,225,57,2761,233,2994,-0.0139141,-0.12215,-0.992414,0
2491,0,0,0,0,210,55,2756,213,2969,0.0148302,0.0696863,-0.997459,0
2492,0,0,0,0,200,56,2748,214,2962,0.0175715,0.0819723,-0.99648,0
2535,0,0,0,0,224,58,2817,191,3008,0.0219562,0.097867,-0.994957,0
2640,0,0,0,0,229,65,2934,199,3133,0.0224702,0.0823523,-0.99635,0
2584,0,0,0,0,257,60,2901,186,3087,0.0262969,0.0990271,-0.994737,0
2485,0,0,0,0,254,65,2804,204,3008,0.028583,0.0573099,-0.997947,0
2464,0,0,0,0,270,69,2803,176,2979,0.029924,-0.00366683,-0.999545,0
2700,0,0,0,0,256,71,3027,159,3186,0.0304379,-0.0769248,-0.996572,0
2589,0,0,0,0,308,81,2978,144,3122,0.0318762,-0.141419,-0.989436,0
2906,0,0,0,0,297,80,3283,147,3430,0.0259167,-0.0659399,-0.997487,0
2634,0,0,0,0,310,79,3023,132,3155,0.0276922,0.0837707,-0.9961,0
2688,0,0,0,0,337,94,3119,151,3270,0.0270108,0.0242878,-0.99934,0
2566,0,0,0,0,325,82,2973,137,3110,0.044684,0.0900907,-0.994931,0
2537,0,0,0,0,338,85,2960,136,3096,0.0363583,0.0359588,-0.998692,0
2654,0,0,0,0,346,113,3113,125,3238,0.0309387,-0.0125046,-0.999443,0
2801,0,0,0,0,427,95,3323,118,3441,0.0305181,-0.07186,-0.996948,0
2572,0,0,0,0,384,99,3055,107,3162,0.0250318,-0.147971,-0.988675,0
2594,0,0,0,0,397,99,3090,100,3190,0.0203646,-0.227975,-0.973454,0
2704,0,0,0,0,399,99,3202,103,3305,0.0217448,-0.32828,-0.94433,0
2572,0,0,0,0,403,102,3077,135,3212,0.0375162,0.058446,-0.997585,0
2636,0,0,0,0,401,113,3150,132,3282,0.0505657,0.0557926,-0.997161,0
2566,0,0,0,0,442,101,3109,147,3256,0.0503177,0.00655418,-0.998712,0
2637,0,0,0,0,406,110,3153,144,3297,0.0699961,0.0221101,-0.997302,0
2632,0,0,0,0,441,99,3172,163,3335,0.0773255,-0.033932,-0.996428,0
2668,0,0,0,0,415,98,3181,167,3348,0.08419,-0.082979,-0.992989,0
2586,0,0,0,0,381,98,3065,158,3223,0.0971161,-0.1284,-0.986956,0
2570,0,0,0,0,391,109,3070,156,3226,0.118863,-0.167998,-0.978595,0
2707,0,0,0,0,398,98,3203,196,3399,0.131374,-0.199459,-0.97106,0
2718,0,0,0,0,406,103,3227,140,3367,0.148735,-0.223381,-0.963317,0
3050,0,0,0,0,537,104,3691,157,3848,0.100367,-0.0443837,-0.99396,0
2775,0,0,0,0,413,129,3317,176,3493,0.0426611,0.0319545,-0.998579,0
2886,0,0,0,0,464,117,3467,246,3713,0.0235915,0.0153993,-0.999603,0
2750,0,0,0,0,402,114,3266,323,3589,0.0182273,0.0722177,-0.997222,0
2888,0,0,0,0,438,97,3423,377,3800,0.00706787,0.0227374,-0.999716,0
2760,0,0,0,0,445,93,3298,393,3691,0.00200959,-0.037059,-0.999311,0
2799,0,0,0,0,371,103,3273,435,3708,0.00498917,-0.103362,-0.994631,0
2695,0,0,0,0,378,89,3162,442,3604,0.00367698,-0.185076,-0.982717,0
2693,0,0,0,0,341,84,3118,466,3584,-0.00351549,-0.257336,-0.966316,0
2547,0,0,0,0,323,77,2947,456,3403,-0.0162946,-0.320895,-0.946975,0
2740,0,0,0,0,292,70,3102,468,3570,0.0110314,0.00609726,-0.999921,0
3740,0,0,0,0,610,102,4452,575,5027,0.0186571,0.0469391,-0.998723,0
2628,0,0,0,0,283,70,2981,464,3445,0.0216075,0.0349038,-0.999157,0
2487,0,0,0,0,281,71,2839,408,3247,0.016295,-0.0374194,-0.999167,0
2574,0,0,0,0,275,72,2921,379,3300,0.00939822,-0.111189,-0.993755,0
2613,0,0,0,0,296,78,2987,350,3337,0.00257588,-0.176311,-0.984331,0
2664,0,0,0,0,293,82,3039,308,3347,-0.00795511,-0.247871,-0.96876,0
2495,0,0,0,0,296,74,2865,320,3185,-0.0169671,-0.317151,-0.948223,0
2929,0,0,0,0,391,78,3398,315,3713,-0.0271698,-0.349837,-0.936416,0
2562,0,0,0,0,313,79,2954,295,3249,-0.00633078,0.0693417,-0.997573,0
2736,0,0,0,0,344,86,3166,276,3442,-0.0189979,-0.00860111,-0.999783,0
2695,0,0,0,0,351,88,3134,243,3377,-0.00505002,0.0499128,-0.998741,0
3193,0,0,0,0,443,100,3736,265,4001,0.00595526,0.113221,-0.993552,0
2651,0,0,0,0,397,102,3150,233,3383,-0.0170705,0.00298671,-0.99985,0
2625,0,0,0,0,413,107,3145,217,3362,-0.0351489,-0.1026,-0.994102,0
2771,0,0,0,0,456,122,3349,237,3586,-0.0558243,-0.218928,-0.974143,0
2849,0,0,0,0,466,117,3432,262,3694,-0.0289513,0.0269455,-0.999218,0
2857,0,0,0,0,495,121,3473,252,3725,-0.0510872,-0.0913191,-0.99451,0
2966,0,0,0,0,499,126,3591,246,3837,-0.00899298,0.122166,-0.992469,0
2981,0,0,0,0,526,134,3641,265,3906,-0.0203459,0.0751702,-0.996963,0
2799,0,0,0,0,510,137,3446,267,3713,-0.0296513,0.0868885,-0.995777,0
2853,0,0,0,0,566,144,3563,257,3820,-0.0154393,0.115172,-0.993226,0
2706,0,0,0,0,540,132,3378,263,3641,-0.0148877,0.0957226,-0.995297,0
2738,0,0,0,0,528,136,3402,265,3667,-0.0501118,-0.00724476,-0.998717,0
2843,0,0,0,0,625,134,3602,276,3878,-0.080964,-0.102559,-0.991427,0
2873,0,0,0,0,530,131,3534,300,3834,0.0339344,0.128745,-0.991097,0
2847,0,0,0,0,603,144,3594,341,3935,-0.00815326,0.0478762,-0.99882,0
2917,0,0,0,0,563,139,3619,309,3928,-0.0501262,-0.0252675,-0.998423,0
2797,0,0,0,0,518,123,3438,267,3705,-0.0978922,-0.101369,-0.990021,0
2973,0,0,0,0,633,127,3733,230,3963,0.0793265,0.0996376,-0.991857,0
2658,0,0,0,0,465,119,3242,208,3450,0.0206248,0.0370648,-0.9991,0
2730,0,0,0,0,453,111,3294,213,3507,-0.0301189,-0.025751,-0.999215,0
2613,0,0,0,0,451,112,3176,224,3400,0.0279852,0.0540906,-0.998144,0
2747,0,0,0,0,434,105,3286,242,3528,-0.0256499,0.00731841,-0.999644,0
2628,0,0,0,0,428,114,3170,201,3371,-0.0736215,-0.0288352,-0.996869,0
2684,0,0,0,0,380,105,3169,180,3349,-0.13255,-0.0769455,-0.988185,0
2583,0,0,0,0,370,100,3053,175,3228,-0.212236,-0.149288,-0.965748,0
2642,0,0,0,0,665,93,3400,179,3579,0.02551,0.0377123,-0.998963,0
2538,0,0,0,0,360,100,2998,189,3187,0.0423939,0.0357136,-0.998462,0
2547,0,0,0,0,334,85,2966,212,3178,-0.0178421,0.0271342,-0.999472,0
2684,0,0,0,0,340,83,3107,211,3318,-0.0793808,0.012873,-0.996761,0
2623,0,0,0,0,347,110,3080,255,3335,-0.138532,-0.00770082,-0.990328,0
2624,0,0,0,0,333,91,3048,233,3281,-0.197793,-0.0353692,-0.979606,0
2563,0,0,0,0,350,89,3002,231,3233,0.0405173,0.0240114,-0.99889,0
2715,0,0,0,0,346,92,3153,224,3377,-0.025181,0.0164663,-0.999547,0
2845,0,0,0,0,424,89,3358,239,3597,-0.088608,0.0103713,-0.996013,0
2806,0,0,0,0,336,91,3233,232,3465,-0.146342,0.00604502,-0.989216,0
2680,0,0,0,0,416,89,3185,214,3399,-0.199573,0.00398562,-0.979875,0
2636,0,0,0,0,317,79,3032,273,3305,0.0206413,0.0256945,-0.999457,0
2591,0,0,0,0,273,71,2935,216,3151,-0.0331457,0.0515362,-0.998121,0
2424,0,0,0,0,250,62,2736,178,2914,-0.0882772,0.0838138,-0.992564,0
2448,0,0,0,0,209,56,2713,204,2917,-0.142735,0.117233,-0.982794,0
2614,0,0,0,0,215,69,2898,180,3078,-0.0134416,0.0690238,-0.997524,0
2386,0,0,0,0,199,48,2633,171,2804,0.0228842,0.0344668,-0.999144,0
2243,0,0,0,0,171,49,2463,182,2645,0.0654046,-0.0394276,-0.99708,0
2283,0,0,0,0,150,42,2475,175,2650,0.0401825,0.00403701,-0.999184,0
2280,0,0,0,0,155,48,2483,171,2654,0.00795054,0.0430557,-0.999041,0
2404,0,0,0,0,167,64,2635,165,2800,-0.027069,0.0874829,-0.995798,0
2703,0,0,0,0,213,54,2970,181,3151,-0.0668862,0.12148,-0.990338,0
2354,0,0,0,0,206,56,2616,165,2781,-0.00564624,0.0262275,-0.99964,0
2759,0,0,0,0,253,63,3075,160,3235,0.00237642,0.0238898,-0.999712,0
2499,0,0,0,0,294,69,2862,202,3064,0.013277,0.00598342,-0.999894,0
2640,0,0,0,0,301,134,3075,216,3291,0.00318732,0.0207068,-0.999781,0
2478,0,0,0,0,312,81,2871,210,3081,-0.0253924,0.0896601,-0.995649,0
2464,0,0,0,0,345,87,2896,197,3093,-0.0627863,0.164881,-0.984313,0
2428,0,0,0,0,348,91,2867,210,3077,-0.0860498,0.222545,-0.971118,0
2509,0,0,0,0,379,95,2983,219,3202,-0.115408,0.286085,-0.951229,0
2682,0,0,0,0,414,101,3197,251,3448,-0.133541,0.330181,-0.934423,0
2838,0,0,0,0,411,107,3356,192,3548,-0.0072651,-0.00607384,-0.999955,0
2567,0,0,0,0,441,116,3124,189,3313,-0.0407328,0.0578786,-0.997492,0
2612,0,0,0,0,443,113,3168,207,3375,-0.0668255,0.120472,-0.990465,0
2615,0,0,0,0,474,115,3204,202,3406,-0.0517146,0.0023658,-0.998659,0
2819,0,0,0,0,516,135,3470,248,3718,-0.0582639,-0.0446057,-0.997304,0
2806,0,0,0,0,519,123,3448,230,3678,-0.0644647,0.0268499,-0.997559,0
2988,0,0,0,0,520,139,3647,255,3902,-0.0456943,-0.000269708,-0.998955,0
2842,0,0,0,0,545,133,3520,295,3815,-0.0317405,0.0726687,-0.996851,0
2863,0,0,0,0,572,130,3565,292,3857,-0.0189534,0.139815,-0.989996,0
2928,0,0,0,0,517,130,3575,288,3863,-0.0124473,0.214034,-0.976747,0
2834,0,0,0,0,494,125,3453,327,3780,-0.00480522,-0.127233,-0.991861,0
2767,0,0,0,0,474,118,3359,300,3659,0.0103735,-0.041036,-0.999104,0
2751,0,0,0,0,443,107,3301,331,3632,0.0204234,0.102998,-0.994472,0
2761,0,0,0,0,420,109,3290,401,3691,0.0463274,-0.131435,-0.990242,0
2690,0,0,0,0,412,130,3232,378,3610,0.065233,-0.0229172,-0.997607,0
2653,0,0,0,0,381,100,3134,336,3470,0.0879067,0.0814003,-0.992797,0
2783,0,0,0,0,391,111,3285,293,3578,0.00554945,-0.0663187,-0.997783,0
2620,0,0,0,0,372,94,3086,263,3349,0.0340413,0.026633,-0.999066,0
2665,0,0,0,0,357,92,3114,295,3409,0.0641546,0.12546,-0.990022,0
2669,0,0,0,0,368,101,3138,229,3367,0.0940526,0.230991,-0.9684,0
2560,0,0,0,0,352,88,3000,256,3256,0.121642,0.330781,-0.935835,0
2679,0,0,0,0,391,93,3163,219,3382,0.15289,0.43708,-0.886333,0
2624,0,0,0,0,358,97,3079,233,3312,-0.0168175,-0.12997,-0.991375,0
2749,0,0,0,0,399,130,3278,212,3490,-0.0267689,-0.163211,-0.986228,0
2783,0,0,0,0,468,127,3378,219,3597,0.0121498,-0.0423335,-0.99903,0
2782,0,0,0,0,452,111,3345,232,3577,0.0468293,0.0621668,-0.996967,0
2809,0,0,0,0,448,125,3382,214,3596,0.0861297,0.168834,-0.981874,0
2918,0,0,0,0,465,117,3500,235,3735,0.12948,0.27831,-0.951724,0
2810,0,0,0,0,483,125,3418,228,3646,0.17024,0.382258,-0.908239,0
2771,0,0,0,0,517,126,3414,229,3643,0.211456,0.483897,-0.849194,0
2853,0,0,0,0,521,124,3498,248,3746,0.252618,0.579413,-0.774897,0
2830,0,0,0,0,541,147,3518,-1000,-1000,-1,-1,-1,0
2862,0,0,0,0,550,121,3533,107,3640,0.00443445,-0.0692821,-0.997587,0
2862,0,0,0,0,507,122,3491,322,3813,0.0292065,0.0423119,-0.998677,0
2830,0,0,0,0,469,115,3414,239,3653,-0.0145348,-0.098774,-0.995004,0
2644,0,0,0,0,451,118,3213,180,3393,0.0125388,0.0335524,-0.999358,0
2741,0,0,0,0,515,113,3369,193,3562,-0.0183696,-0.0747985,-0.997029,0
2754,0,0,0,0,533,125,3412,178,3590,-0.0412705,-0.168109,-0.984904,0
2593,0,0,0,0,430,109,3132,145,3277,-0.0163238,-0.0531629,-0.998452,0
2725,0,0,0,0,409,121,3255,145,3400,-0.00125783,0.0792739,-0.996852,0
2667,0,0,0,0,397,105,3169,151,3320,-0.0254479,-0.0817321,-0.996329,0
2756,0,0,0,0,405,96,3257,158,3415,-0.0230403,-0.139766,-0.989917,0
2701,0,0,0,0,371,92,3164,185,3349,-0.0213857,-0.0276037,-0.99939,0
2746,0,0,0,0,346,91,3183,209,3392,-0.0207248,-0.0871427,-0.99598,0
2611,0,0,0,0,319,84,3014,228,3242,-0.0214108,0.00656503,-0.999749,0
2620,0,0,0,0,290,75,2985,213,3198,-0.0188828,0.0960456,-0.995198,0
2571,0,0,0,0,259,65,2895,256,3151,-0.0207226,-0.0174165,-0.999634,0
3620,0,0,0,0,398,105,4123,254,4377,-0.0196664,0.00461386,-0.999796,0
2391,0,0,0,0,252,61,2704,204,2908,-0.0252559,-0.0600608,-0.997875,0
2502,0,0,0,0,208,69,2779,170,2949,-0.0163397,0.0157249,-0.999743,0
2470,0,0,0,0,209,65,2744,154,2898,-0.0265713,-0.0267367,-0.999289,0
2351,0,0,0,0,224,61,2636,155,2791,-0.0248567,0.0533604,-0.998266,0
2617,0,0,0,0,255,74,2946,164,3110,-0.021608,-0.0567825,-0.998153,0
2534,0,0,0,0,302,75,2911,176,3087,-0.0128123,0.0373087,-0.999222,0
2655,0,0,0,0,287,76,3018,169,3187,-0.00572369,0.119802,-0.992781,0
2718,0,0,0,0,301,80,3099,175,3274,-0.00102251,0.198986,-0.980002,0
2583,0,0,0,0,318,81,2982,171,3153,0.0026163,0.277391,-0.960754,0
2590,0,0,0,0,339,95,3024,194,3218,-0.0234341,-0.0142289,-0.999624,0
2635,0,0,0,0,354,94,3083,191,3274,-0.0150234,0.0454647,-0.998853,0
2567,0,0,0,0,415,94,3076,178,3254,-0.00875578,0.121152,-0.992595,0
2687,0,0,0,0,395,120,3202,179,3381,-0.00512511,0.208521,-0.978005,0
2642,0,0,0,0,404,99,3145,202,3347,0.00249078,0.274871,-0.961478,0
2760,0,0,0,0,482,104,3346,155,3501,0.00717717,0.285862,-0.958244,0
2554,0,0,0,0,439,114,3107,86,3193,0.00582735,0.299658,-0.954029,0
2606,0,0,0,0,429,110,3145,119,3264,-0.0730194,0.474652,-0.87714,0
3597,0,0,0,0,513,143,4253,177,4430,-0.0407954,0.301217,-0.952683,0
2761,0,0,0,0,487,117,3365,213,3578,-0.0927795,0.0107861,-0.995628,0
2740,0,0,0,0,511,121,3372,262,3634,-0.0688778,0.0749789,-0.994804,0
2900,0,0,0,0,628,147,3675,328,4003,-0.0440679,-0.0721174,-0.996422,0
2761,0,0,0,0,502,124,3387,371,3758,-0.0265291,-0.0182137,-0.999482,0
2799,0,0,0,0,441,108,3348,387,3735,-0.0182557,0.0944614,-0.995361,0
2722,0,0,0,0,432,103,3257,466,3723,-0.00215822,-0.0436588,-0.999044,0
2789,0,0,0,0,395,97,3281,489,3770,0.000499373,0.0596815,-0.998217,0
2661,0,0,0,0,412,96,3169,497,3666,0.00794916,-0.035538,-0.999337,0
2527,0,0,0,0,431,98,3056,429,3485,0.0105959,0.0621613,-0.99801,0
2623,0,0,0,0,335,86,3044,349,3393,0.0324266,-0.0670894,-0.99722,0
2520,0,0,0,0,358,89,2967,330,3297,0.0407584,-0.0385684,-0.998424,0
2631,0,0,0,0,335,85,3051,348,3399,0.0471341,0.0703339,-0.996409,0
2555,0,0,0,0,332,86,2973,265,3238,0.0514314,0.176457,-0.982964,0
2580,0,0,0,0,370,90,3040,269,3309,0.0581643,0.270367,-0.960999,0
2658,0,0,0,0,371,102,3131,256,3387,0.0657158,0.375849,-0.924348,0
2860,0,0,0,0,395,105,3360,226,3586,0.0757546,0.458025,-0.885706,0
2693,0,0,0,0,487,116,3296,216,3512,0.0248505,-0.0208222,-0.999474,0
2668,0,0,0,0,431,112,3211,204,3415,0.0423638,0.0843098,-0.995539,0
2802,0,0,0,0,451,112,3365,204,3569,0.0602897,0.191142,-0.979709,0
2842,0,0,0,0,509,121,3472,186,3658,0.0752956,0.301938,-0.950349,0
2709,0,0,0,0,446,113,3268,195,3463,-0.000843467,-0.06985,-0.997557,0
2912,0,0,0,0,452,111,3475,221,3696,-0.00448848,-0.107496,-0.994195,0
2730,0,0,0,0,460,113,3303,205,3508,0.00560289,-0.00173156,-0.999983,0
2768,0,0,0,0,434,113,3315,202,3517,0.0161063,0.112938,-0.993471,0
2768,0,0,0,0,432,113,3313,224,3537,0.0124193,-0.0862364,-0.996197,0
2632,0,0,0,0,431,114,3177,206,3383,0.0252969,0.0308221,-0.999205,0
2663,0,0,0,0,407,102,3172,228,3400,0.0404813,0.147032,-0.988303,0
2776,0,0,0,0,418,113,3307,230,3537,-0.00931715,-0.143138,-0.989659,0
2731,0,0,0,0,419,103,3253,297,3550,0.00365832,-0.0230344,-0.999728,0
2762,0,0,0,0,488,110,3360,300,3660,0.0184114,0.094895,-0.995317,0
2625,0,0,0,0,408,100,3133,229,3362,-0.0070432,-0.0760183,-0.997082,0
2673,0,0,0,0,391,101,3165,170,3335,0.00410047,0.0443597,-0.999007,0
2944,0,0,0,0,456,101,3501,189,3690,0.00283254,-0.0590279,-0.998252,0
2647,0,0,0,0,434,108,3189,226,3415,-0.00333842,-0.0123392,-0.999918,0
2903,0,0,0,0,498,118,3519,187,3706,-0.0246449,-0.103496,-0.994325,0
2741,0,0,0,0,413,98,3252,169,3421,-0.0224222,0.0129697,-0.999664,0
2957,0,0,0,0,416,106,3479,195,3674,-0.0130262,-0.0758893,-0.997031,0
2733,0,0,0,0,380,94,3207,157,3364,-0.00878619,-0.0892536,-0.99597,0
2660,0,0,0,0,386,96,3142,169,3311,-0.0117515,0.0192083,-0.999746,0
2569,0,0,0,0,352,90,3011,214,3225,-0.017036,-0.089995,-0.995796,0
2592,0,0,0,0,349,88,3029,198,3227,-0.0218979,0.00315019,-0.999755,0
2820,0,0,0,0,371,101,3292,209,3501,-0.0232495,0.0808817,-0.996452,0
2585,0,0,0,0,306,79,2970,208,3178,-0.0300818,-0.0132478,-0.99946,0
2832,0,0,0,0,338,77,3247,199,3446,-0.0337936,0.0693247,-0.997022,0
2629,0,0,0,0,256,69,2954,200,3154,-0.0186754,-0.0743432,-0.997058,0
2450,0,0,0,0,244,64,2758,213,2971,-0.0235986,0.00550679,-0.999706,0
2482,0,0,0,0,230,60,2772,191,2963,-0.0224678,-0.0421592,-0.998858,0
2379,0,0,0,0,218,57,2654,195,2849,-0.0187882,-0.0352922,-0.9992,0
2457,0,0,0,0,238,58,2753,181,2934,-0.0207704,0.0381745,-0.999055,0
2369,0,0,0,0,233,72,2674,158,2832,-0.0162163,-0.0358539,-0.999225,0
2501,0,0,0,0,263,66,2830,164,2994,-0.0252832,0.0705032,-0.997191,0
2659,0,0,0,0,331,71,3061,167,3228,-0.0170242,0.130475,-0.991305,0
2478,0,0,0,0,278,72,2828,187,3015,-0.0143486,0.206988,-0.978238,0
2683,0,0,0,0,292,79,3054,175,3229,-0.0138302,0.295921,-0.955112,0
2643,0,0,0,0,301,83,3027,168,3195,-0.0130732,0.378819,-0.925378,0
2579,0,0,0,0,314,92,2985,176,3161,-0.0148371,0.478261,-0.878092,0
2657,0,0,0,0,338,92,3087,211,3298,-0.0291548,0.0536708,-0.998133,0
2696,0,0,0,0,351,95,3142,149,3291,-0.0179319,0.0131248,-0.999753,0
2514,0,0,0,0,426,104,3044,186,3230,-0.0192714,0.0993726,-0.994864,0
2600,0,0,0,0,391,97,3088,183,3271,-0.0186359,0.170987,-0.985097,0
2664,0,0,0,0,426,106,3196,104,3300,-0.00738761,0.176374,-0.984296,0
2598,0,0,0,0,477,109,3184,89,3273,-0.0704784,0.271033,-0.959987,0
2667,0,0,0,0,463,124,3254,102,3356,-0.097794,0.370439,-0.923694,0
2777,0,0,0,0,469,120,3366,123,3489,-0.112605,0.472391,-0.874166,0
2608,0,0,0,0,488,110,3206,181,3387,-0.0532576,-0.0846029,-0.99499,0
2651,0,0,0,0,468,104,3223,288,3511,-0.0401719,0.00977388,-0.999145,0
3041,0,0,0,0,438,97,3576,346,3922,0.0134755,-0.132661,-0.99107,0
2769,0,0,0,0,389,101,3259,382,3641,0.00630166,-0.00571594,-0.999964,0
2603,0,0,0,0,363,86,3052,472,3524,-4.03156e-05,0.113994,-0.993481,0
2563,0,0,0,0,382,86,3031,488,3519,-0.00691161,0.217677,-0.975996,0
2629,0,0,0,0,412,100,3141,527,3668,-0.0156684,0.312062,-0.949933,0
2526,0,0,0,0,349,83,2958,443,3401,-0.0251173,0.397643,-0.917196,0
2491,0,0,0,0,354,89,2934,384,3318,-0.0311524,0.488132,-0.872213,0
2519,0,0,0,0,338,78,2935,335,3270,-0.0332813,0.583311,-0.811567,0
2624,0,0,0,0,432,86,3142,286,3428,0.030997,-0.0642861,-0.99745,0
2567,0,0,0,0,350,85,3002,263,3265,0.0409296,0.0571434,-0.997527,0
2564,0,0,0,0,343,87,2994,249,3243,0.0377175,-0.0372283,-0.998595,0
2622,0,0,0,0,366,97,3085,245,3330,0.0492406,0.0708297,-0.996272,0
2668,0,0,0,0,371,98,3137,234,3371,0.0168885,-0.0466375,-0.998769,0
2725,0,0,0,0,382,97,3204,244,3448,0.0322193,0.062062,-0.997552,0
2716,0,0,0,0,402,99,3217,213,3430,0.0441964,0.156497,-0.986689,0
2669,0,0,0,0,446,98,3213,208,3421,0.0559101,0.256184,-0.96501,0
2747,0,0,0,0,368,94,3209,202,3411,0.0711141,0.367026,-0.927488,0
2654,0,0,0,0,379,102,3135,213,3348,-0.0193003,-0.126321,-0.991802,0
2656,0,0,0,0,366,89,3111,211,3322,-0.0176545,-0.0251107,-0.999529,0
2694,0,0,0,0,383,97,3174,215,3389,-0.000507643,-0.149211,-0.988805,0
2757,0,0,0,0,370,91,3218,203,3421,-0.000430181,-0.201417,-0.979506,0
2648,0,0,0,0,413,95,3156,222,3378,0.00333943,-0.122316,-0.992486,0
2568,0,0,0,0,419,98,3085,217,3302,0.0093701,-0.00803163,-0.999924,0
2766,0,0,0,0,385,91,3242,221,3463,0.00319741,-0.141137,-0.989985,0
2712,0,0,0,0,388,93,3193,257,3450,0.00421109,-0.0872751,-0.996175,0
2825,0,0,0,0,410,100,3335,302,3637,0.00693709,0.0227127,-0.999718,0
2957,0,0,0,0,420,101,3478,298,3776,-0.0157747,-0.174029,-0.984614,0
2654,0,0,0,0,464,102,3220,246,3466,-0.0142811,-0.0755733,-0.997038,0
2593,0,0,0,0,382,94,3069,190,3259,-0.00723156,-0.13974,-0.990162,0
2694,0,0,0,0,370,87,3151,207,3358,-0.0118473,-0.0471243,-0.998819,0
2579,0,0,0,0,358,89,3026,220,3246,-0.0135668,0.0470189,-0.998802,0
2616,0,0,0,0,351,86,3053,216,3269,-0.0164297,0.127376,-0.991718,0
2630,0,0,0,0,425,84,3139,204,3343,-0.0154912,0.208147,-0.977975,0
2625,0,0,0,0,352,95,3072,188,3260,-0.0135637,0.266895,-0.96363,0
2857,0,0,0,0,373,106,3336,191,3527,-0.00876547,0.125167,-0.992097,0
2542,0,0,0,0,348,88,2978,176,3154,-0.0199019,-0.00555823,-0.999786,0
2490,0,0,0,0,404,88,2982,218,3200,-0.0327853,0.00609789,-0.999444,0
2491,0,0,0,0,385,85,2961,212,3173,-0.0311642,-0.0470394,-0.998407,0
2590,0,0,0,0,327,97,3014,230,3244,-0.046001,0.0163983,-0.998807,0
2504,0,0,0,0,317,90,2911,225,3136,-0.0635432,0.0850015,-0.994353,0
2999,0,0,0,0,330,94,3423,246,3669,-0.0820246,0.152679,-0.984866,0
2649,0,0,0,0,343,80,3072,242,3314,-0.097297,0.219238,-0.970808,0
2476,0,0,0,0,317,79,2872,239,3111,-0.114817,0.297144,-0.947904,0
2621,0,0,0,0,307,74,3002,247,3249,-0.121031,0.357684,-0.925966,0
2482,0,0,0,0,288,79,2849,239,3088,-0.124658,0.410177,-0.903446,0
2625,0,0,0,0,300,74,2999,260,3259,-0.126944,0.451867,-0.883007,0
3562,0,0,0,0,461,91,4114,296,4410,-0.0587976,0.239399,-0.969139,0
2460,0,0,0,0,282,72,2814,219,3033,-0.0364797,-0.0309112,-0.998856,0
2667,0,0,0,0,316,68,3051,198,3249,-0.0280176,-0.0216506,-0.999373,0
2444,0,0,0,0,302,71,2817,167,2984,-0.0244551,0.00360373,-0.999694,0
2397,0,0,0,0,250,76,2723,160,2883,-0.0224023,0.0308004,-0.999274,0
2380,0,0,0,0,271,63,2714,169,2883,-0.0257261,0.0486743,-0.998483,0
2455,0,0,0,0,275,65,2795,173,2968,-0.022024,0.0667228,-0.997528,0
2478,0,0,0,0,250,80,2808,215,3023,-0.0259325,0.0730229,-0.996993,0
2530,0,0,0,0,261,67,2858,183,3041,-0.0280445,0.0869635,-0.995817,0
2365,0,0,0,0,268,66,2699,191,2890,-0.0302817,0.106941,-0.993804,0
2476,0,0,0,0,261,78,2815,205,3020,-0.0320584,0.118213,-0.992471,0
2857,0,0,0,0,316,82,3255,225,3480,-0.018568,-0.00923131,-0.999785,0
2434,0,0,0,0,263,66,2763,197,2960,-0.0267947,-0.0342682,-0.999053,0
2444,0,0,0,0,273,66,2783,210,2993,-0.0221823,-0.0304823,-0.999289,0
3560,0,0,0,0,430,96,4086,248,4334,-0.0197236,-0.0367005,-0.999132,0
2451,0,0,0,0,286,73,2810,188,2998,-0.026421,-0.0286061,-0.999241,0
2400,0,0,0,0,289,69,2758,188,2946,-0.0175079,-0.0492897,-0.998631,0
2438,0,0,0,0,280,73,2791,180,2971,-0.0126977,-0.0583412,-0.998216,0
2568,0,0,0,0,325,87,2980,189,3169,-0.00267551,-0.0797785,-0.996809,0
2628,0,0,0,0,290,91,3009,194,3203,-0.0200327,-0.022309,-0.99955,0
2536,0,0,0,0,291,72,2899,175,3074,-0.0176602,-0.0405358,-0.999022,0
2544,0,0,0,0,323,73,2940,182,3122,-0.0125876,-0.0559255,-0.998356,0
