Downsample[ns],BuildFilTree[ns],SearchFil[ns],DeleteFil[ns],BuildTreeSub[ns],SearchSub[ns],DeleteSub[ns],PreProcTotal[ns],Plane[ns],Total[ns],nx,ny,nz,planeCount
6107,0,0,0,0,1203,309,7619,5237,12856,-0.00255127,0.168558,-0.985688,0
2606,0,0,0,0,469,118,3193,873,4066,0.00746974,0.0186414,-0.999798,0
6362,0,0,0,0,1098,303,7763,1893,9656,0.0167157,0.0435721,-0.99891,0
4454,0,0,0,0,856,199,5509,1481,6990,0.0289527,0.0348332,-0.998974,0
4845,0,0,0,0,759,194,5798,1494,7292,0.008084,0.0346815,-0.999366,0
4627,0,0,0,0,942,195,5764,2178,7942,0.0121305,0.0314366,-0.999432,0
4101,0,0,0,0,797,191,5089,1379,6468,0.0237843,0.0375297,-0.999012,0
6221,0,0,0,0,1137,296,7654,2029,9683,0.00402754,0.0430735,-0.999064,0
5696,0,0,0,0,808,287,6791,1208,7999,0.0150015,0.0377134,-0.999176,0
3318,0,0,0,0,596,155,4069,1045,5114,0.0139631,0.0360961,-0.999251,0
4111,0,0,0,0,891,226,5228,1779,7007,0.00834124,0.0365527,-0.999297,0
5352,0,0,0,0,970,229,6551,1577,8128,0.0037735,0.0464562,-0.998913,0
6202,0,0,0,0,1088,295,7585,2023,9608,0.00220765,0.0546982,-0.9985,0
6041,0,0,0,0,1087,316,7444,2056,9500,0.0230115,0.0525997,-0.998351,0
3108,0,0,0,0,539,135,3782,835,4617,0.0134079,0.0528302,-0.998513,0
1682,0,0,0,0,291,76,2049,542,2591,0.0220729,0.0555654,-0.998211,0
6861,0,0,0,0,1123,278,8262,2019,10281,0.00876995,0.0567943,-0.998347,0
6733,0,0,0,0,1552,287,8572,1413,9985,0.00345753,0.0695188,-0.997575,0
2579,0,0,0,0,484,121,3184,858,4042,0.00927673,0.0673809,-0.997684,0
3634,0,0,0,0,710,183,4527,1219,5746,0.00952085,0.0622043,-0.998018,0
6523,0,0,0,0,1310,293,8126,2013,10139,0.0347383,0.0770171,-0.996424,0
6192,0,0,0,0,1171,273,7636,1507,9143,0.0109049,0.0707771,-0.997433,0
3317,0,0,0,0,570,146,4033,1204,5237,0.0129293,0.0675422,-0.997633,0
4536,0,0,0,0,873,176,5585,1419,7004,0.00295782,0.0832135,-0.996527,0
5166,0,0,0,0,937,228,6331,1648,7979,0.0102252,0.0768167,-0.996993,0
5072,0,0,0,0,985,230,6287,1658,7945,0.00123635,0.0822407,-0.996612,0
6552,0,0,0,0,1149,281,7982,1409,9391,0.00907163,0.0715216,-0.997398,0
3664,0,0,0,0,631,148,4443,1076,5519,-0.000472001,0.0724843,-0.997369,0
4110,0,0,0,0,751,191,5052,1707,6759,0.0194714,0.0959906,-0.995192,0
4941,0,0,0,0,924,221,6086,1624,7710,0.032333,0.0832118,-0.996007,0
5023,0,0,0,0,858,212,6093,2002,8095,0.0330616,0.0819003,-0.996092,0
3467,0,0,0,0,612,151,4230,1218,5448,0.0130266,0.0990421,-0.994998,0
5797,0,0,0,0,1034,245,7076,2121,9197,0.021764,0.104146,-0.994324,0
6346,0,0,0,0,1151,264,7761,1483,9244,0.0180703,0.09634,-0.995184,0
3123,0,0,0,0,535,124,3782,1116,4898,0.0292221,0.0806894,-0.996311,0
3154,0,0,0,0,492,119,3765,1072,4837,0.0178096,0.0756965,-0.996972,0
2990,0,0,0,0,448,115,3553,1144,4697,0.012392,0.0740715,-0.997176,0
6302,0,0,0,0,889,216,7407,2315,9722,-6.44875e-06,0.107322,-0.994224,0
5907,0,0,0,0,924,227,7058,2245,9303,-0.00303538,0.0987446,-0.995108,0
4377,0,0,0,0,562,137,5076,1601,6677,-0.00952469,0.098208,-0.99512,0
4394,0,0,0,0,508,142,5044,1582,6626,0.00435678,0.0901564,-0.995918,0
4148,0,0,0,0,597,131,4876,1553,6429,0.0193572,0.0767547,-0.996862,0
3788,0,0,0,0,488,222,4498,1488,5986,0.0338884,0.0692891,-0.997021,0
3812,0,0,0,0,505,130,4447,2212,6659,0.0143465,0.100482,-0.994835,0
5332,0,0,0,0,715,179,6226,1953,8179,0.0173682,0.0861668,-0.996129,0
5354,0,0,0,0,678,195,6227,2156,8383,0.0205112,0.0868621,-0.996009,0
5125,0,0,0,0,721,172,6018,1795,7813,0.0157868,0.0759975,-0.996983,0
4710,0,0,0,0,637,161,5508,1926,7434,0.0223004,0.0454496,-0.998718,0
5301,0,0,0,0,884,204,6389,2085,8474,0.0366674,0.0725128,-0.996693,0
4898,0,0,0,0,652,153,5703,2068,7771,0.0133469,0.073837,-0.997181,0
5314,0,0,0,0,539,142,5995,2895,8890,0.00864746,0.0700449,-0.997506,0
4869,0,0,0,0,488,126,5483,2486,7969,0.0136329,0.087809,-0.996044,0
4761,0,0,0,0,457,120,5338,2131,7469,0.0140017,0.0744475,-0.997127,0
6105,0,0,0,0,468,123,6696,3114,9810,0.00458985,0.0790407,-0.996861,0
3357,0,0,0,0,292,76,3725,2199,5924,0.0251736,0.0629797,-0.997697,0
3429,0,0,0,0,304,75,3808,1668,5476,0.0184668,0.0842443,-0.996274,0
5337,0,0,0,0,485,131,5953,2604,8557,0.0280667,0.0796562,-0.996427,0
5466,0,0,0,0,498,137,6101,1749,7850,0.0220034,0.0964604,-0.995094,0
2848,0,0,0,0,298,78,3224,1283,4507,0.0157579,0.0876446,-0.996027,0
4555,0,0,0,0,522,138,5215,1759,6974,0.0252047,0.0816576,-0.996342,0
5575,0,0,0,0,599,155,6329,3419,9748,-0.0198331,0.0724602,-0.997174,0
3364,0,0,0,0,464,122,3950,4621,8571,-0.143797,0.398237,-0.905941,0
2658,0,0,0,0,412,111,3181,3016,6197,-0.0934965,0.406991,-0.908635,0
5387,0,0,0,0,790,199,6376,5019,11395,-0.0183224,0.0936135,-0.99544,0
5351,0,0,0,0,793,209,6353,4431,10784,-0.0055,-0.00981225,-0.999937,0
3022,0,0,0,0,449,117,3588,1495,5083,0.0434055,0.0414242,-0.998198,0
7299,0,0,0,0,975,246,8520,2231,10751,0.0172374,0.0563079,-0.998265,0
4132,0,0,0,0,638,163,4933,1689,6622,0.00862393,0.0485776,-0.998782,0
3128,0,0,0,0,500,127,3755,1305,5060,0.015739,0.0592856,-0.998117,0
3963,0,0,0,0,636,163,4762,1474,6236,0.0180983,0.0646564,-0.997743,0
6076,0,0,0,0,1055,323,7454,2268,9722,0.0338988,0.145438,-0.988786,0
3663,0,0,0,0,585,154,4402,1066,5468,0.0429229,0.134572,-0.989974,0
2179,0,0,0,0,410,90,2679,637,3316,0.0255722,0.0861941,-0.99595,0
3243,0,0,0,0,796,157,4196,1219,5415,0.0235639,0.102527,-0.994451,0
6950,0,0,0,0,1642,394,8986,2364,11350,0.0352261,0.140723,-0.989422,0
6400,0,0,0,0,1354,329,8083,2954,11037,0.00672508,0.211591,-0.977335,0
3541,0,0,0,0,644,162,4347,1075,5422,-0.0162073,0.142803,-0.989618,0
2185,0,0,0,0,442,104,2731,841,3572,0.025046,0.107169,-0.993925,0
6561,0,0,0,0,1180,294,8035,2091,10126,0.0140458,0.109458,-0.993892,0
6495,0,0,0,0,1251,306,8052,1539,9591,0.0146852,0.107702,-0.994075,0
3335,0,0,0,0,806,153,4294,1104,5398,-0.00210878,0.0868423,-0.99622,0
4214,0,0,0,0,752,215,5181,1478,6659,-0.0264909,0.0706005,-0.997153,0
6531,0,0,0,0,1726,371,8628,1834,10462,-0.00773036,0.12475,-0.992158,0
4410,0,0,0,0,905,264,5579,1510,7089,-0.0153538,0.099857,-0.994883,0
4375,0,0,0,0,1017,207,5599,1439,7038,-0.000298048,0.0852685,-0.996358,0
6680,0,0,0,0,1375,304,8359,2340,10699,0.0100391,0.0916804,-0.995738,0
4405,0,0,0,0,822,201,5428,1483,6911,0.0185355,0.0775724,-0.996814,0
5795,0,0,0,0,1057,277,7129,2023,9152,0.0195636,0.0999446,-0.994801,0
5764,0,0,0,0,1017,263,7044,2083,9127,0.0140584,0.0692242,-0.997502,0
5821,0,0,0,0,1028,270,7119,1907,9026,-0.00400991,0.0995046,-0.995029,0
4107,0,0,0,0,742,189,5038,1432,6470,0.00845138,0.103399,-0.994604,0
4221,0,0,0,0,748,178,5147,1300,6447,0.0123874,0.108997,-0.993965,0
4028,0,0,0,0,898,213,5139,1814,6953,-0.00989669,0.131615,-0.991251,0
4352,0,0,0,0,761,176,5289,1240,6529,-0.0138086,0.123609,-0.992235,0
4578,0,0,0,0,704,175,5457,1626,7083,-0.00920712,0.136116,-0.99065,0
3964,0,0,0,0,694,176,4834,1355,6189,-0.0133834,0.103022,-0.994589,0
6374,0,0,0,0,1117,274,7765,2082,9847,-0.0220815,0.123914,-0.992047,0
4152,0,0,0,0,741,188,5081,1426,6507,-0.0474473,0.134124,-0.989828,0
4156,0,0,0,0,790,191,5137,1445,6582,-0.0405169,0.142824,-0.988918,0
6934,0,0,0,0,1169,287,8390,1821,10211,-0.0248395,0.169043,-0.985296,0
4200,0,0,0,0,812,204,5216,1558,6774,-0.0100372,0.151839,-0.988354,0
4577,0,0,0,0,857,217,5651,1515,7166,0.00856493,0.169753,-0.985449,0
4199,0,0,0,0,877,219,5295,1453,6748,0.0166988,0.176047,-0.98424,0
4141,0,0,0,0,884,221,5246,1448,6694,0.0269545,0.194238,-0.980584,0
5405,0,0,0,0,1157,289,6851,1887,8738,0.01746,0.181259,-0.98328,0
5955,0,0,0,0,1356,354,7665,2107,9772,0.0175899,0.250964,-0.967837,0
4138,0,0,0,0,1027,249,5414,1436,6850,0.00597935,0.229559,-0.973276,0
4365,0,0,0,0,948,225,5538,1342,6880,0.00778363,0.246601,-0.969086,0
6226,0,0,0,0,1391,334,7951,1949,9900,-0.0110683,0.278125,-0.960481,0
3690,0,0,0,0,887,189,4766,941,5707,-0.0167175,0.225642,-0.974067,0
4131,0,0,0,0,765,188,5084,1190,6274,-0.0176302,0.228239,-0.973446,0
6788,0,0,0,0,1344,307,8439,1610,10049,-0.0180364,0.257245,-0.966178,0
4660,0,0,0,0,824,296,5780,1525,7305,-0.0102705,0.243265,-0.969905,0
4744,0,0,0,0,829,248,5821,1397,7218,0.00474384,0.237632,-0.971344,0
4280,0,0,0,0,781,193,5254,1444,6698,-0.0139193,0.196272,-0.980451,0
4413,0,0,0,0,898,205,5516,2082,7598,0.00782087,0.186908,-0.982346,0
4113,0,0,0,0,876,211,5200,1296,6496,0.00719257,0.181875,-0.983295,0
5591,0,0,0,0,1248,288,7127,1679,8806,0.0040459,0.158423,-0.987363,0
5240,0,0,0,0,1332,290,6862,2152,9014,0.00400894,0.148949,-0.988837,0
5120,0,0,0,0,1145,277,6542,1295,7837,0.00711597,0.137676,-0.990452,0
3650,0,0,0,0,818,202,4670,1282,5952,0.00385389,0.117826,-0.993027,0
4688,0,0,0,0,1065,313,6066,1541,7607,0.0269585,0.0872514,-0.995821,0
4625,0,0,0,0,1063,248,5936,1621,7557,0.0252667,0.083307,-0.996204,0
4665,0,0,0,0,1056,249,5970,2050,8020,0.0117008,0.0628786,-0.997953,0
4167,0,0,0,0,925,227,5319,1636,6955,0.005705,0.0580641,-0.998297,0
4177,0,0,0,0,903,225,5305,1376,6681,0.00313807,0.0410185,-0.999153,0
5323,0,0,0,0,899,231,6453,1915,8368,0.00267031,0.0612382,-0.99812,0
4613,0,0,0,0,924,228,5765,1907,7672,0.00356819,0.0737628,-0.997269,0
7817,0,0,0,0,1341,329,9487,2232,11719,0.0129345,0.0978715,-0.995115,0
4238,0,0,0,0,894,221,5353,1376,6729,0.0205411,0.121549,-0.992373,0
4385,0,0,0,0,947,252,5584,1430,7014,0.00926791,0.155275,-0.987828,0
5965,0,0,0,0,1275,324,7564,2109,9673,0.0301632,0.155075,-0.987442,0
5946,0,0,0,0,1280,318,7544,1454,8998,0.0418465,0.177959,-0.983148,0
3046,0,0,0,0,636,159,3841,1095,4936,0.018129,0.166381,-0.985895,0
5913,0,0,0,0,1236,304,7453,2019,9472,0.0176197,0.159972,-0.986964,0
6313,0,0,0,0,1206,307,7826,2076,9902,-0.0156421,0.133022,-0.99099,0
5903,0,0,0,0,1196,295,7394,1961,9355,-0.00329771,0.126035,-0.99202,0
2480,0,0,0,0,506,131,3117,903,4020,0.00564384,0.116484,-0.993176,0
6154,0,0,0,0,1116,339,7609,2085,9694,-0.00517568,0.207258,-0.978273,0
4791,0,0,0,0,709,179,5679,1070,6749,0.00575134,0.156533,-0.987656,0
2594,0,0,0,0,423,103,3120,954,4074,0.00796728,0.135725,-0.990714,0
2752,0,0,0,0,392,99,3243,965,4208,0.0109052,0.108771,-0.994007,0
5945,0,0,0,0,776,192,6913,2167,9080,0.0112817,0.141133,-0.989926,0
6101,0,0,0,0,678,169,6948,1463,8411,0.00844491,0.14231,-0.989786,0
2353,0,0,0,0,264,65,2682,1421,4103,0.0254493,0.110047,-0.993601,0
5775,0,0,0,0,850,178,6803,2263,9066,0.00654806,0.127003,-0.991881,0
2292,0,0,0,0,228,59,2579,1415,3994,0.000219893,0.134204,-0.990954,0
3325,0,0,0,0,335,87,3747,2066,5813,0.00440577,0.128795,-0.991661,0
3295,0,0,0,0,381,95,3771,1921,5692,0.0119345,0.123589,-0.992262,0
5756,0,0,0,0,702,188,6646,2200,8846,0.0302656,0.141112,-0.989531,0
2348,0,0,0,0,317,80,2745,1399,4144,0.0159384,0.122088,-0.992391,0
5611,0,0,0,0,813,207,6631,3513,10144,0.00427208,0.15268,-0.988266,0
2233,0,0,0,0,289,66,2588,792,3380,0.0210748,0.110575,-0.993644,0
1622,0,0,0,0,241,62,1925,619,2544,0.0254537,0.0875831,-0.995832,0
6382,0,0,0,0,987,194,7563,1436,8999,0.0155275,0.113487,-0.993418,0
6621,0,0,0,0,1360,291,8272,2942,11214,0.0362158,0.0951271,-0.994806,0
4344,0,0,0,0,679,188,5211,3026,8237,0.0411142,0.10871,-0.993223,0
2507,0,0,0,0,431,114,3052,986,4038,0.0294899,0.103912,-0.994149,0
6491,0,0,0,0,1178,264,7933,2889,10822,0.0345297,0.140804,-0.989435,0
3233,0,0,0,0,474,109,3816,1057,4873,0.028683,0.101117,-0.994461,0
2510,0,0,0,0,463,105,3078,1317,4395,0.0248777,0.131065,-0.991062,0
6097,0,0,0,0,1089,282,7468,3609,11077,0.0248445,0.135908,-0.99041,0
4231,0,0,0,0,651,185,5067,2773,7840,0.0475771,0.142532,-0.988646,0
4139,0,0,0,0,673,163,4975,2246,7221,0.0752725,0.0747922,-0.994354,0
6375,0,0,0,0,1005,266,7646,2975,10621,0.0474819,0.092729,-0.994559,0
4511,0,0,0,0,679,166,5356,1694,7050,0.0336187,0.0926623,-0.99513,0
4804,0,0,0,0,678,164,5646,2777,8423,0.033785,0.083436,-0.99594,0
4065,0,0,0,0,651,167,4883,1662,6545,0.0324272,0.0815282,-0.996143,0
6478,0,0,0,0,1041,245,7764,2430,10194,0.0420156,0.0648711,-0.997009,0
4653,0,0,0,0,736,180,5569,2359,7928,-0.00132814,-0.0586035,-0.99828,0
4717,0,0,0,0,785,222,5724,1560,7284,0.0206331,0.0209492,-0.999568,0
6501,0,0,0,0,1303,289,8093,2365,10458,0.0446555,0.0665022,-0.996787,0
3156,0,0,0,0,533,130,3819,1224,5043,0.0574969,0.0954563,-0.993772,0
2247,0,0,0,0,433,105,2785,985,3770,0.0527709,-0.00104654,-0.998606,0
2974,0,0,0,0,649,138,3761,1300,5061,0.0533057,0.0357335,-0.997939,0
6484,0,0,0,0,1103,273,7860,3439,11299,0.00797512,0.0179033,-0.999808,0
4617,0,0,0,0,714,174,5505,1493,6998,-0.00769333,0.135191,-0.99079,0
8152,0,0,0,0,1238,242,9632,1759,11391,-0.0208029,0.122574,-0.992241,0
2098,0,0,0,0,288,73,2459,638,3097,-0.0606372,0.0662628,-0.995958,0
1812,0,0,0,0,287,72,2171,707,2878,-0.028465,0.0954748,-0.995025,0
2041,0,0,0,0,320,81,2442,692,3134,-0.03152,0.11268,-0.993131,0
4873,0,0,0,0,758,188,5819,1710,7529,-0.0506795,0.121596,-0.991285,0
4886,0,0,0,0,727,179,5792,1292,7084,-0.0258291,0.145765,-0.988982,0
2808,0,0,0,0,602,130,3540,1384,4924,-0.0240536,0.132418,-0.990902,0
6247,0,0,0,0,957,238,7442,3068,10510,-0.0185529,0.190382,-0.981535,0
4261,0,0,0,0,639,163,5063,1497,6560,-0.00493596,0.182669,-0.983162,0
4116,0,0,0,0,678,169,4963,1501,6464,-0.00236557,0.185949,-0.982556,0
4204,0,0,0,0,687,177,5068,1611,6679,0.00864687,0.213586,-0.976886,0
6051,0,0,0,0,1148,271,7470,3131,10601,0.0124379,0.235395,-0.97182,0
3165,0,0,0,0,601,152,3918,1660,5578,0.00540176,0.198048,-0.980178,0
2949,0,0,0,0,662,157,3768,1048,4816,0.00453719,0.23522,-0.971932,0
6345,0,0,0,0,1432,405,8182,2151,10333,-0.0063703,0.252319,-0.967623,0
6472,0,0,0,0,1227,315,8014,1367,9381,-0.00429588,0.211192,-0.977435,0
3047,0,0,0,0,639,162,3848,1104,4952,-0.00540206,0.196543,-0.98048,0
4894,0,0,0,0,1029,241,6164,1603,7767,-0.00479014,0.174262,-0.984688,0
4863,0,0,0,0,982,245,6090,1692,7782,-0.00535514,0.15798,-0.987428,0
5129,0,0,0,0,981,242,6352,1703,8055,-0.0117153,0.15057,-0.98853,0
4709,0,0,0,0,1347,285,6341,2461,8802,-0.00665725,0.143879,-0.989573,0
4895,0,0,0,0,999,237,6131,2517,8648,-0.0095029,0.139622,-0.990159,0
3750,0,0,0,0,771,175,4696,1790,6486,-0.00447848,0.133199,-0.991079,0
4776,0,0,0,0,1083,231,6090,1552,7642,0.00022744,0.140995,-0.99001,0
5847,0,0,0,0,1106,272,7225,2054,9279,-0.00544194,0.133433,-0.991043,0
6480,0,0,0,0,1086,298,7864,1416,9280,-0.00168953,0.132946,-0.991122,0
2959,0,0,0,0,577,138,3674,1065,4739,-0.00194101,0.122807,-0.992429,0
5893,0,0,0,0,1070,270,7233,2287,9520,-6.92686e-05,0.122071,-0.992521,0
6187,0,0,0,0,1137,272,7596,1372,8968,-0.00902912,0.0990962,-0.995037,0
3761,0,0,0,0,715,166,4642,1586,6228,-0.00893246,0.108567,-0.994049,0
4952,0,0,0,0,873,223,6048,1673,7721,-0.00198936,0.107064,-0.99425,0
5923,0,0,0,0,1044,278,7245,2088,9333,-0.00819236,0.100297,-0.994924,0
5978,0,0,0,0,1081,262,7321,2369,9690,-0.00226701,0.121301,-0.992613,0
4811,0,0,0,0,764,210,5785,1354,7139,-0.0113041,0.084923,-0.996323,0
3968,0,0,0,0,750,180,4898,1680,6578,-0.00584781,0.114244,-0.993436,0
6106,0,0,0,0,948,235,7289,1844,9133,-0.00998202,0.115728,-0.993231,0
3899,0,0,0,0,955,204,5058,1291,6349,-0.00339686,0.108441,-0.994097,0
3770,0,0,0,0,1004,186,4960,1287,6247,-0.0117764,0.111296,-0.993717,0
2264,0,0,0,0,375,94,2733,675,3408,-0.00688167,0.112971,-0.993574,0
1809,0,0,0,0,325,79,2213,626,2839,-0.00638722,0.0962009,-0.995341,0
2370,0,0,0,0,411,102,2883,890,3773,-0.00583269,0.120501,-0.992696,0
6245,0,0,0,0,1173,265,7683,2025,9708,-0.00632933,0.110978,-0.993803,0
7315,0,0,0,0,1044,286,8645,1375,10020,0.00391555,0.119736,-0.992798,0
3051,0,0,0,0,662,166,3879,1055,4934,-0.00400538,0.112896,-0.993599,0
5952,0,0,0,0,1050,258,7260,2018,9278,-0.00500284,0.113224,-0.993557,0
6634,0,0,0,0,1190,270,8094,2228,10322,-0.0109829,0.12765,-0.991758,0
3015,0,0,0,0,697,169,3881,1038,4919,-0.00813494,0.0993248,-0.995022,0
7120,0,0,0,0,1080,275,8475,2047,10522,-0.0222884,0.12681,-0.991677,0
5787,0,0,0,0,1055,254,7096,2032,9128,-0.0113589,0.116534,-0.993122,0
5985,0,0,0,0,1116,268,7369,3068,10437,-0.00513849,0.135775,-0.990726,0
3879,0,0,0,0,750,175,4804,1464,6268,-0.0131779,0.117216,-0.993019,0
5955,0,0,0,0,1146,257,7358,2042,9400,-0.0107634,0.107917,-0.994102,0
5900,0,0,0,0,1130,270,7300,2058,9358,-0.0230475,0.104496,-0.994258,0
6251,0,0,0,0,1043,281,7575,1434,9009,-0.0112934,0.107845,-0.994104,0
5861,0,0,0,0,1024,258,7143,1381,8524,-0.00386854,0.124381,-0.992227,0
3998,0,0,0,0,769,176,4943,1400,6343,-0.00820307,0.129773,-0.99151,0
5794,0,0,0,0,995,244,7033,2201,9234,-0.0124206,0.123119,-0.992314,0
6003,0,0,0,0,989,251,7243,2051,9294,-0.0106202,0.10573,-0.994338,0
5855,0,0,0,0,1037,268,7160,2839,9999,-0.0115875,0.122143,-0.992445,0
4237,0,0,0,0,882,198,5317,1440,6757,-0.00629535,0.133533,-0.991024,0
5849,0,0,0,0,1052,244,7145,2091,9236,-0.000302502,0.114242,-0.993453,0
6166,0,0,0,0,1104,255,7525,1949,9474,-0.0114712,0.112671,-0.993566,0
4756,0,0,0,0,678,170,5604,1362,6966,-0.00359504,0.125992,-0.992025,0
5227,0,0,0,0,891,218,6336,2690,9026,-0.00607043,0.112865,-0.993592,0
5680,0,0,0,0,975,238,6893,1377,8270,-0.0164162,0.106299,-0.994199,0
4129,0,0,0,0,680,181,4990,1361,6351,-0.0129274,0.100292,-0.994874,0
6488,0,0,0,0,1035,272,7795,1972,9767,-0.0050935,0.116021,-0.993234,0
4040,0,0,0,0,681,167,4888,1381,6269,-0.00908302,0.101652,-0.994779,0
5206,0,0,0,0,890,218,6314,1725,8039,-0.00777857,0.102841,-0.994667,0
5314,0,0,0,0,960,221,6495,1891,8386,-0.00835089,0.0867447,-0.996196,0
6093,0,0,0,0,1162,266,7521,1845,9366,-0.0247549,0.0818143,-0.99634,0
6460,0,0,0,0,1252,249,7961,1497,9458,-0.0290869,0.0787912,-0.996467,0
3041,0,0,0,0,776,158,3975,1276,5251,-0.0122552,0.101793,-0.99473,0
6025,0,0,0,0,1099,254,7378,2892,10270,-0.0138711,0.111121,-0.99371,0
6102,0,0,0,0,1070,254,7426,2113,9539,-0.0166727,0.10105,-0.994742,0
4056,0,0,0,0,795,174,5025,1658,6683,-0.00961226,0.117824,-0.992988,0
6281,0,0,0,0,1247,253,7781,2161,9942,-0.00799745,0.107616,-0.99416,0
4804,0,0,0,0,912,198,5914,1649,7563,-0.0172435,0.102692,-0.994564,0
4157,0,0,0,0,819,176,5152,1501,6653,-0.0104129,0.106273,-0.994282,0
6798,0,0,0,0,1012,284,8094,2176,10270,-0.00601339,0.117174,-0.993093,0
7042,0,0,0,0,1246,253,8541,1501,10042,-0.00541396,0.112793,-0.993604,0
3221,0,0,0,0,562,137,3920,1057,4977,-0.0209918,0.118921,-0.992682,0
6441,0,0,0,0,1238,280,7959,2306,10265,-0.0104905,0.129238,-0.991558,0
6311,0,0,0,0,1191,257,7759,1529,9288,-0.0129198,0.111798,-0.993647,0
2538,0,0,0,0,473,107,3118,980,4098,-0.00927577,0.116765,-0.993116,0
6475,0,0,0,0,1154,265,7894,2217,10111,-0.0123021,0.103472,-0.994556,0
6506,0,0,0,0,1134,254,7894,2025,9919,-0.0129992,0.102944,-0.994602,0
4397,0,0,0,0,795,176,5368,1573,6941,-0.0106969,0.111575,-0.993698,0
4174,0,0,0,0,817,177,5168,1477,6645,-0.0107292,0.114526,-0.993362,0
5533,0,0,0,0,1011,230,6774,1966,8740,-0.000900648,0.114931,-0.993373,0
5894,0,0,0,0,901,225,7020,2169,9189,-0.00121544,0.120147,-0.992755,0
5703,0,0,0,0,956,239,6898,1932,8830,-0.000712573,0.107007,-0.994258,0
5558,0,0,0,0,1031,224,6813,2007,8820,-0.0192432,0.124955,-0.991976,0
5986,0,0,0,0,920,345,7251,1286,8537,-0.0061613,0.0969123,-0.995274,0
3940,0,0,0,0,738,160,4838,1366,6204,-0.00770988,0.109725,-0.993932,0
4081,0,0,0,0,634,170,4885,1455,6340,-0.00947563,0.105465,-0.994378,1
4450,0,0,0,0,635,160,5245,1306,6551,-0.0060933,0.119381,-0.99283,1
6149,0,0,0,0,1186,246,7581,2297,9878,0.00714573,0.123059,-0.992374,1
5733,0,0,0,0,971,239,6943,2002,8945,-0.01689,0.127255,-0.991726,1
5843,0,0,0,0,1083,238,7164,1982,9146,-0.0169654,0.141961,-0.989727,1
5794,0,0,0,0,991,247,7032,2145,9177,-0.0159033,0.121889,-0.992416,1
4659,0,0,0,0,683,169,5511,1889,7400,-0.0145554,0.132982,-0.991012,1
6009,0,0,0,0,770,168,6947,1518,8465,-0.0101693,0.113595,-0.993475,1
2931,0,0,0,0,423,102,3456,858,4314,-0.00582539,0.0996309,-0.995007,1
5982,0,0,0,0,984,250,7216,2047,9263,-0.005726,0.0996258,-0.995009,1
7265,0,0,0,0,1030,253,8548,1620,10168,-0.0101715,0.112846,-0.99356,1
3055,0,0,0,0,516,124,3695,1116,4811,-0.0255842,0.119098,-0.992553,1
4891,0,0,0,0,795,192,5878,1715,7593,-0.0101756,0.131689,-0.991239,1
5801,0,0,0,0,933,231,6965,2173,9138,-0.00884788,0.11858,-0.992905,1
6289,0,0,0,0,932,233,7454,2692,10146,-0.00230012,0.129779,-0.99154,1
5825,0,0,0,0,925,228,6978,3051,10029,0.00167823,0.114075,-0.993471,1
3096,0,0,0,0,503,123,3722,1065,4787,-0.00675432,0.137592,-0.990466,1
4776,0,0,0,0,760,189,5725,1626,7351,-0.00212511,0.11921,-0.992867,1
5962,0,0,0,0,951,228,7141,2102,9243,-0.00754663,0.14064,-0.990032,1
6169,0,0,0,0,1279,285,7733,2066,9799,0.0171665,0.110897,-0.993684,1
6105,0,0,0,0,954,227,7286,2058,9344,0.0105129,0.0901853,-0.99587,1
3039,0,0,0,0,495,117,3651,1050,4701,0.00615554,0.123725,-0.992297,1
6068,0,0,0,0,919,234,7221,2980,10201,0.0015693,0.125771,-0.992058,1
4343,0,0,0,0,626,162,5131,1957,7088,-0.00530277,0.137181,-0.990532,1
5467,0,0,0,0,861,204,6532,2717,9249,0.0026685,0.129139,-0.991623,1
4704,0,0,0,0,753,182,5639,2367,8006,-0.00553381,0.108395,-0.994093,1
5041,0,0,0,0,766,193,6000,1594,7594,-0.00204803,0.115671,-0.993286,1
4671,0,0,0,0,726,183,5580,2448,8028,-0.00088041,0.127045,-0.991897,1
3695,0,0,0,0,754,158,4607,1759,6366,0.00122683,0.12722,-0.991874,1
3595,0,0,0,0,534,130,4259,1163,5422,-0.0035483,0.131845,-0.991264,1
5235,0,0,0,0,706,163,6104,2160,8264,0.000292912,0.152794,-0.988258,1
4593,0,0,0,0,653,159,5405,1597,7002,0.00605777,0.13784,-0.990436,1
4500,0,0,0,0,662,156,5318,1486,6804,0.00695811,0.138817,-0.990294,1
5773,0,0,0,0,844,200,6817,1989,8806,0.00211418,0.134393,-0.990926,1
4224,0,0,0,0,625,141,4990,1413,6403,0.00572152,0.105225,-0.994432,1
4376,0,0,0,0,587,139,5102,1489,6591,0.00754563,0.0886333,-0.996036,1
4784,0,0,0,0,609,143,5536,1431,6967,0.00599495,0.112043,-0.993685,1
6170,0,0,0,0,759,185,7114,2643,9757,0.00938515,0.142581,-0.989739,1
3886,0,0,0,0,544,133,4563,1913,6476,0.0104104,0.138576,-0.990297,1
5054,0,0,0,0,692,165,5911,2396,8307,4.42607e-05,0.134995,-0.990846,1
4960,0,0,0,0,670,159,5789,2442,8231,0.00108934,0.14999,-0.988687,1
3450,0,0,0,0,480,116,4046,1178,5224,0.00959914,0.151842,-0.988358,1
5875,0,0,0,0,804,190,6869,2100,8969,0.0288666,0.16943,-0.985119,1
5942,0,0,0,0,1216,254,7412,2150,9562,0.0213029,0.213431,-0.976726,1
3118,0,0,0,0,458,106,3682,868,4550,0.0173298,0.18395,-0.982783,1
2136,0,0,0,0,357,84,2577,744,3321,0.0130919,0.146251,-0.989161,1
5607,0,0,0,0,853,224,6684,1843,8527,-0.0190559,0.136597,-0.990443,1
5452,0,0,0,0,881,206,6539,1928,8467,-0.00321221,0.140028,-0.990142,1
3878,0,0,0,0,651,150,4679,1259,5938,0.00688516,0.145825,-0.989287,1
5016,0,0,0,0,861,202,6079,1669,7748,0.013125,0.102264,-0.994671,1
4917,0,0,0,0,871,208,5996,1757,7753,0.0163923,0.142711,-0.989629,1
5225,0,0,0,0,973,223,6421,1415,7836,0.0135233,0.120485,-0.992623,1
3634,0,0,0,0,703,179,4516,1222,5738,0.0263253,0.128757,-0.991327,1
6135,0,0,0,0,1170,285,7590,2267,9857,0.0243093,0.122173,-0.992211,1
6349,0,0,0,0,1147,317,7813,2305,10118,0.017176,0.136839,-0.990444,1
4389,0,0,0,0,765,181,5335,1430,6765,0.0184325,0.115796,-0.993102,1
4087,0,0,0,0,740,185,5012,1480,6492,0.00269682,0.095356,-0.99544,1
5822,0,0,0,0,1037,257,7116,2233,9349,0.00641837,0.12337,-0.99234,1
5719,0,0,0,0,1263,290,7272,1642,8914,0.000152251,0.116867,-0.993148,1
5758,0,0,0,0,1005,268,7031,1993,9024,-0.00647682,0.120811,-0.992654,1
4002,0,0,0,0,707,180,4889,1441,6330,0.00385326,0.119596,-0.992815,1
3937,0,0,0,0,721,181,4839,1725,6564,0.0101243,0.110691,-0.993803,1
5984,0,0,0,0,990,244,7218,2240,9458,0.0275538,0.132855,-0.990752,1
5977,0,0,0,0,1002,257,7236,1754,8990,0.0135091,0.0166916,-0.999769,1
3653,0,0,0,0,506,126,4285,1398,5683,0.0127228,0.0541668,-0.998451,1
5866,0,0,0,0,918,216,7000,2553,9553,0.012407,0.139623,-0.990127,1
5849,0,0,0,0,770,188,6807,1740,8547,0.0338486,0.168058,-0.985196,1
3008,0,0,0,0,372,77,3457,1289,4746,0.023887,0.133959,-0.990699,1
6511,0,0,0,0,699,134,7344,1765,9109,0.0395842,0.177549,-0.983315,1
5605,0,0,0,0,449,114,6168,2682,8850,0.0135988,0.190587,-0.981576,1
5970,0,0,0,0,500,134,6604,2038,8642,-0.00517648,0.183707,-0.982967,1
3091,0,0,0,0,313,82,3486,1727,5213,0.0402948,0.129084,-0.990815,1
4764,0,0,0,0,592,146,5502,2434,7936,0.0404084,0.140311,-0.989283,1
6004,0,0,0,0,796,200,7000,4794,11794,0.0353821,0.20944,-0.977181,1
6889,0,0,0,0,1001,219,8109,2355,10464,0.0538104,0.133524,-0.989584,1
3252,0,0,0,0,545,117,3914,1742,5656,0.0473822,0.0929664,-0.994541,1
3117,0,0,0,0,479,116,3712,1605,5317,0.037353,0.101453,-0.994139,1
5831,0,0,0,0,876,222,6929,3911,10840,0.0399706,0.19204,-0.980573,1
5840,0,0,0,0,875,215,6930,3227,10157,0.0472712,0.207633,-0.977064,1
3182,0,0,0,0,450,113,3745,2033,5778,0.0948538,0.141327,-0.985408,1
3099,0,0,0,0,430,107,3636,2507,6143,0.0674598,0.0621615,-0.995784,1
4777,0,0,0,0,639,156,5572,2658,8230,0.0398843,0.106728,-0.993488,1
4864,0,0,0,0,615,156,5635,5847,11482,0.0504207,0.0937122,-0.994322,1
3687,0,0,0,0,437,107,4231,3315,7546,0.0851163,0.106766,-0.990634,1
6405,0,0,0,0,735,193,7333,4140,11473,0.0987904,0.0618965,-0.993181,1
3245,0,0,0,0,401,91,3737,1840,5577,0.075238,0.0745198,-0.994377,1
5255,0,0,0,0,609,142,6006,2688,8694,0.0743794,0.116298,-0.990425,1
5472,0,0,0,0,657,157,6286,2295,8581,0.0587259,0.0714476,-0.995714,1
6718,0,0,0,0,784,138,7640,1934,9574,0.00359039,-0.00787139,-0.999963,1
2767,0,0,0,0,377,165,3309,983,4292,0.00560688,-0.0653643,-0.997846,1
7527,0,0,0,0,946,225,8698,2651,11349,0.00429425,0.0162479,-0.999859,1
4915,0,0,0,0,623,165,5703,1256,6959,-0.0223343,-0.0562842,-0.998165,1
3241,0,0,0,0,482,117,3840,1379,5219,-0.0134252,-0.0648683,-0.997804,1
5142,0,0,0,0,788,167,6097,2100,8197,-0.000533142,-0.0723885,-0.997376,1
4921,0,0,0,0,644,261,5826,1844,7670,-0.004377,-0.0588854,-0.998255,1
3497,0,0,0,0,494,115,4106,1752,5858,-0.0044341,-0.0534105,-0.998563,1
5713,0,0,0,0,1125,180,7018,3243,10261,-0.0112391,0.015164,-0.999822,1
4170,0,0,0,0,468,117,4755,2051,6806,0.0105415,-0.0769292,-0.996981,1
3107,0,0,0,0,364,91,3562,1430,4992,-0.0271454,-0.0562345,-0.998049,1
5735,0,0,0,0,757,232,6724,2616,9340,-0.00865981,0.0320496,-0.999449,1
6063,0,0,0,0,735,181,6979,2321,9300,-0.0230002,0.00919292,-0.999693,1
3240,0,0,0,0,365,95,3700,1511,5211,-0.00408632,0.0519581,-0.998641,1
5745,0,0,0,0,741,179,6665,2867,9532,-0.0296165,0.0709937,-0.997037,1
4753,0,0,0,0,514,136,5403,2102,7505,-0.0111322,0.105402,-0.994367,1
6543,0,0,0,0,881,383,7807,1813,9620,-0.0122095,0.0973286,-0.995177,1
3830,0,0,0,0,460,119,4409,1470,5879,-0.0173361,0.0676361,-0.997559,1
3562,0,0,0,0,485,124,4171,1226,5397,-0.0063389,0.074638,-0.997191,1
3853,0,0,0,0,688,155,4696,1521,6217,-0.0155737,0.0975394,-0.99511,1
3800,0,0,0,0,598,152,4550,2101,6651,-0.0255964,0.00673688,-0.99965,1
4031,0,0,0,0,581,147,4759,1606,6365,-0.0142825,0.0131335,-0.999812,1
5406,0,0,0,0,889,198,6493,1979,8472,-0.0127991,0.0314794,-0.999422,1
5209,0,0,0,0,881,192,6282,1390,7672,-0.0119432,0.0236886,-0.999648,1
3335,0,0,0,0,507,129,3971,1262,5233,-0.0108277,0.0231132,-0.999674,1
7035,0,0,0,0,805,203,8043,2145,10188,-0.0355279,0.10019,-0.994334,1
4158,0,0,0,0,630,135,4923,1959,6882,-0.0306263,0.0762533,-0.996618,1
4032,0,0,0,0,533,126,4691,1446,6137,-0.0447192,0.0546535,-0.997503,1
5778,0,0,0,0,833,185,6796,2595,9391,0.0166212,0.144815,-0.989319,1
6548,0,0,0,0,510,123,7181,1931,9112,-0.00324715,0.202173,-0.979344,1
2532,0,0,0,0,375,75,2982,1126,4108,-0.005281,0.0665938,-0.997766,1
5906,0,0,0,0,787,186,6879,3437,10316,-0.0216407,0.172595,-0.984755,1
4162,0,0,0,0,566,134,4862,2302,7164,-0.0388611,0.0381829,-0.998515,1
5974,0,0,0,0,915,225,7114,2850,9964,-0.0317721,0.158129,-0.986907,1
4095,0,0,0,0,602,142,4839,1763,6602,-0.0143893,0.0103044,-0.999843,1
3167,0,0,0,0,546,120,3833,1203,5036,-0.0071324,0.0175009,-0.999821,1
5877,0,0,0,0,931,224,7032,2693,9725,-0.0129693,0.0755991,-0.997054,1
6518,0,0,0,0,846,214,7578,3026,10604,0.0180737,0.204253,-0.978751,1
4333,0,0,0,0,642,150,5125,1720,6845,-0.0169692,0.142118,-0.989704,1
2007,0,0,0,0,304,75,2386,1339,3725,0.0211906,0.0279342,-0.999385,1
2925,0,0,0,0,352,86,3363,1348,4711,-0.000212912,0.0401693,-0.999193,1
5466,0,0,0,0,855,213,6534,4210,10744,-0.00411462,0.0310458,-0.999509,1
3780,0,0,0,0,593,147,4520,1877,6397,-0.00548115,0.0469968,-0.99888,1
5712,0,0,0,0,996,248,6956,3656,10612,-0.0314202,0.0643855,-0.99743,1
4146,0,0,0,0,516,132,4794,2974,7768,-0.0310866,0.0234556,-0.999241,1
6462,0,0,0,0,662,168,7292,3080,10372,-0.00393127,0.0433738,-0.999051,1
2940,0,0,0,0,309,81,3330,2847,6177,-0.0330964,0.0665936,-0.997231,1
3043,0,0,0,0,281,75,3399,1686,5085,-0.00507545,0.00818696,-0.999954,1
5561,0,0,0,0,547,130,6238,3463,9701,-0.0653869,0.0796736,-0.994674,1
3708,0,0,0,0,327,84,4119,2457,6576,-0.0844975,0.0879327,-0.992536,1
5529,0,0,0,0,554,140,6223,3445,9668,-0.0908455,0.0883979,-0.991934,1
3747,0,0,0,0,417,106,4270,2920,7190,-0.0739046,0.0776973,-0.994234,1
5294,0,0,0,0,649,160,6103,3255,9358,-0.0937191,0.11665,-0.988741,1
6004,0,0,0,0,786,195,6985,2150,9135,-0.0920007,0.0472458,-0.994637,1
3190,0,0,0,0,450,110,3750,1760,5510,-0.1084,0.0674581,-0.991816,1
4666,0,0,0,0,703,192,5561,3137,8698,-0.0736247,0.0555203,-0.995739,1
4720,0,0,0,0,706,178,5604,3421,9025,-0.0834312,0.0866411,-0.99274,1
4737,0,0,0,0,730,194,5661,2752,8413,-0.0360057,0.00380311,-0.999344,1
3485,0,0,0,0,487,120,4092,2719,6811,-0.0421111,0.0174972,-0.99896,1
3524,0,0,0,0,466,114,4104,3421,7525,-0.0497538,0.0597615,-0.996972,1
5807,0,0,0,0,769,185,6761,6667,13428,-0.0995435,0.177725,-0.979033,1
4373,0,0,0,0,632,122,5127,3736,8863,-0.12657,0.311996,-0.941615,1
4648,0,0,0,0,454,106,5208,5374,10582,-0.139926,0.404246,-0.903884,1
2937,0,0,0,0,355,79,3371,1743,5114,-0.163733,0.483274,-0.860022,1
5921,0,0,0,0,693,160,6774,5147,11921,-0.183651,0.536261,-0.82383,1
4046,0,0,0,0,511,114,4671,4862,9533,-0.150806,0.633516,-0.758891,1
5639,0,0,0,0,699,156,6494,10744,17238,0.0227487,0.0293618,-0.99931,1
3069,0,0,0,0,381,88,3538,1193,4731,0.0253938,-0.0348927,-0.999068,1
3336,0,0,0,0,358,90,3784,1117,4901,0.031723,-0.0501997,-0.998235,1
6497,0,0,0,0,916,175,7588,2493,10081,-0.0233956,0.0637857,-0.997689,1
4038,0,0,0,0,471,93,4602,1649,6251,-0.0187663,0.0339301,-0.999248,1
2187,0,0,0,0,281,55,2523,1029,3552,-0.00407292,-0.00963394,-0.999945,1
2654,0,0,0,0,256,77,2987,1408,4395,-0.0150482,-0.0177412,-0.999729,1
5582,0,0,0,0,516,129,6227,2994,9221,-0.0348035,-0.0409079,-0.998557,1
6159,0,0,0,0,449,120,6728,2494,9222,-0.0400717,-0.0362023,-0.998541,1
3177,0,0,0,0,305,60,3542,2013,5555,-0.0422703,-0.0164184,-0.998971,1
6378,0,0,0,0,583,118,7079,4148,11227,-0.047558,-0.0426032,-0.99796,1
3904,0,0,0,0,349,83,4336,4092,8428,-0.0454556,-0.077475,-0.995958,1
3829,0,0,0,0,372,95,4296,3804,8100,-0.0419121,-0.052796,-0.997725,1
5663,0,0,0,0,563,147,6373,3774,10147,-0.0661384,0.00426396,-0.997801,1
4177,0,0,0,0,482,113,4772,3111,7883,-0.00984318,0.0321649,-0.999434,1
4383,0,0,0,0,506,219,5108,3134,8242,-0.0454582,0.158147,-0.986369,1
3174,0,0,0,0,503,105,3782,2062,5844,-0.0364642,0.041454,-0.998475,1
4944,0,0,0,0,681,179,5804,2768,8572,-0.0173543,0.0640688,-0.997795,1
4446,0,0,0,0,733,189,5368,2288,7656,-0.00378011,0.0470263,-0.998886,1
4357,0,0,0,0,683,190,5230,1895,7125,-0.00553188,0.0930307,-0.995648,1
4945,0,0,0,0,815,176,5936,2164,8100,-0.00590831,0.106573,-0.994287,1
4349,0,0,0,0,676,164,5189,1886,7075,-0.0190642,0.0880246,-0.995936,1
4359,0,0,0,0,642,157,5158,1836,6994,-0.00820209,0.0786944,-0.996865,1
4450,0,0,0,0,595,147,5192,1782,6974,-0.0113831,0.0739392,-0.997198,1
4508,0,0,0,0,541,135,5184,1773,6957,-0.0162207,0.0892575,-0.995876,1
5254,0,0,0,0,529,134,5917,2028,7945,-0.0186714,0.0605072,-0.997993,1
4946,0,0,0,0,637,154,5737,1782,7519,-0.0372387,0.0496191,-0.998074,1
5221,0,0,0,0,485,120,5826,1967,7793,-0.0412235,0.047667,-0.998012,1
3481,0,0,0,0,367,92,3940,1205,5145,-0.0256274,0.0334427,-0.999112,1
4617,0,0,0,0,581,116,5314,1873,7187,-0.0402399,0.0712375,-0.996647,1
5086,0,0,0,0,473,121,5680,1742,7422,-0.03109,0.0472429,-0.998399,1
4700,0,0,0,0,565,117,5382,1839,7221,-0.0134769,0.0193044,-0.999723,1
5777,0,0,0,0,463,103,6343,1630,7973,-0.0353305,0.0326622,-0.998842,1
2339,0,0,0,0,254,62,2655,947,3602,-0.022998,0.0328517,-0.999196,1
6510,0,0,0,0,564,144,7218,2511,9729,-0.00447741,0.0576066,-0.998329,1
3650,0,0,0,0,426,97,4173,1691,5864,0.00796603,-0.0416116,-0.999102,1
3879,0,0,0,0,499,108,4486,1569,6055,0.0095125,-0.0120638,-0.999882,1
4164,0,0,0,0,464,111,4739,1628,6367,0.0115784,0.0213695,-0.999705,1
5511,0,0,0,0,696,175,6382,2369,8751,0.025451,0.0847107,-0.99608,1
5115,0,0,0,0,832,195,6142,2786,8928,0.0132761,0.0408171,-0.999078,1
5290,0,0,0,0,780,194,6264,1704,7968,0.00942572,0.0334436,-0.999396,1
3165,0,0,0,0,400,103,3668,1239,4907,0.0152078,-0.0124843,-0.999806,1
5559,0,0,0,0,706,184,6449,4182,10631,-0.0396153,-0.0193518,-0.999028,1
5329,0,0,0,0,669,173,6171,2636,8807,-0.0459659,-0.00448962,-0.998933,1
2734,0,0,0,0,284,79,3097,2008,5105,-0.0692112,0.00497692,-0.99759,1
5236,0,0,0,0,406,104,5746,3384,9130,-0.0323962,0.00853239,-0.999439,1
4620,0,0,0,0,339,92,5051,3652,8703,-0.0461335,-0.00308263,-0.998931,1
2536,0,0,0,0,180,47,2763,2600,5363,-0.054505,0.145148,-0.987908,1
5194,0,0,0,0,509,115,5818,4592,10410,-0.0653943,0.289585,-0.954916,1
3634,0,0,0,0,248,67,3949,4621,8570,-0.0376476,0.0674457,-0.997012,1
2780,0,0,0,0,193,52,3025,2807,5832,-0.0247382,0.198198,-0.97985,1
5498,0,0,0,0,420,108,6026,4642,10668,0.00338754,0.00572485,-0.999978,1
3746,0,0,0,0,308,82,4136,2364,6500,-0.0023758,-0.00142094,-0.999996,1
3745,0,0,0,0,352,91,4188,2303,6491,-0.0506274,0.00621891,-0.998698,1
5523,0,0,0,0,571,150,6244,2990,9234,0.00920712,0.0188362,-0.99978,1
6425,0,0,0,0,723,170,7318,2630,9948,0.00476668,0.010757,-0.999931,1
5641,0,0,0,0,465,120,6226,1876,8102,0.0430563,0.025353,-0.998751,1
2841,0,0,0,0,362,92,3295,1575,4870,0.00174025,0.0181061,-0.999835,1
5908,0,0,0,0,775,200,6883,3595,10478,0.000403119,0.0445726,-0.999006,1
4086,0,0,0,0,559,156,4801,2423,7224,-0.00221495,0.0163748,-0.999863,1
3792,0,0,0,0,552,147,4491,2817,7308,0.0123393,-0.0101402,-0.999872,1
5928,0,0,0,0,837,212,6977,5632,12609,-0.0128355,-0.00253282,-0.999914,1
3942,0,0,0,0,612,146,4700,3540,8240,-0.0444165,-0.0215102,-0.998781,1
3692,0,0,0,0,521,128,4341,2414,6755,-0.0135043,-0.0369875,-0.999224,1
6041,0,0,0,0,982,208,7231,6744,13975,-0.0261134,-0.0514445,-0.998334,1
2993,0,0,0,0,406,100,3499,1499,4998,-0.0100097,-0.0937665,-0.995544,1
5962,0,0,0,0,756,208,6926,3830,10756,0.000988094,-0.0688002,-0.99763,1
5445,0,0,0,0,555,128,6128,2509,8637,0.00850293,-0.056341,-0.998375,1
6196,0,0,0,0,737,199,7132,3613,10745,-0.0202781,-0.000322669,-0.999794,1
3089,0,0,0,0,396,92,3577,3427,7004,-0.0426554,0.0982962,-0.994243,1
2142,0,0,0,0,253,61,2456,2470,4926,-0.147423,0.146683,-0.978136,1
1871,0,0,0,0,218,52,2141,1991,4132,-0.0811417,0.0379551,-0.99598,1
3057,0,0,0,0,375,88,3520,2775,6295,-0.101208,0.0404529,-0.994043,1
6333,0,0,0,0,873,175,7381,4012,11393,-0.0646192,-0.0174114,-0.997758,1
3447,0,0,0,0,366,88,3901,3129,7030,-0.0880874,0.00186045,-0.996111,1
5419,0,0,0,0,711,140,6270,4891,11161,-0.118155,0.0681964,-0.990651,1
3725,0,0,0,0,426,198,4349,3365,7714,-0.110718,0.0800322,-0.990624,1
3778,0,0,0,0,527,101,4406,4523,8929,-0.0644132,0.0961708,-0.993278,1
4809,0,0,0,0,534,131,5474,3757,9231,-0.0522683,0.121374,-0.99123,1
4823,0,0,0,0,584,124,5531,3450,8981,-0.0350742,0.156867,-0.986997,1
2682,0,0,0,0,380,74,3136,2038,5174,-0.00735145,0.12825,-0.991715,1
5178,0,0,0,0,704,137,6019,3684,9703,0.0145364,0.177008,-0.984102,1
5615,0,0,0,0,604,152,6371,3768,10139,0.00848143,0.142211,-0.9898,1
4734,0,0,0,0,570,136,5440,5063,10503,0.0449562,0.0639923,-0.996937,1
2894,0,0,0,0,478,94,3466,1963,5429,0.0696521,0.0146067,-0.997464,1
5885,0,0,0,0,691,164,6740,3708,10448,-0.00231462,-0.096042,-0.995375,1
3252,0,0,0,0,370,87,3709,1694,5403,-0.00102076,-0.0947916,-0.995497,1
4664,0,0,0,0,572,133,5369,2688,8057,-0.00565377,-0.106804,-0.994264,1
4293,0,0,0,0,549,121,4963,1784,6747,-0.00623046,-0.0922511,-0.995716,1
4305,0,0,0,0,570,122,4997,1790,6787,-0.00115631,-0.0981275,-0.995173,1
4187,0,0,0,0,498,124,4809,1728,6537,0.00409596,-0.0894471,-0.995983,1
4303,0,0,0,0,512,123,4938,1881,6819,0.0135664,-0.0922317,-0.995645,1
4601,0,0,0,0,711,170,5482,2590,8072,0.00342663,-0.0865599,-0.996241,1
4630,0,0,0,0,467,133,5230,1864,7094,-0.00225637,-0.099494,-0.995036,1
3189,0,0,0,0,343,83,3615,1363,4978,-0.0243015,-0.094021,-0.995274,1
5237,0,0,0,0,559,130,5926,3158,9084,-0.00401878,-0.0563335,-0.998404,1
5377,0,0,0,0,552,126,6055,2211,8266,-0.00999859,-0.0892181,-0.995962,1
4167,0,0,0,0,397,98,4662,2773,7435,-0.0132958,-0.112295,-0.993586,1
4338,0,0,0,0,382,98,4818,4019,8837,-0.00663327,-0.139981,-0.990132,1
4806,0,0,0,0,418,98,5322,2821,8143,-0.0070154,-0.10135,-0.994826,1
2606,0,0,0,0,315,76,2997,1242,4239,-0.0211899,-0.0981039,-0.994951,1
5784,0,0,0,0,545,124,6453,3326,9779,-0.00869561,-0.112021,-0.993668,1
5598,0,0,0,0,484,124,6206,3196,9402,-0.0131538,-0.0833789,-0.996431,1
3791,0,0,0,0,356,86,4233,2422,6655,-0.0133525,-0.109817,-0.993862,1
6102,0,0,0,0,617,130,6849,3445,10294,-0.0186798,-0.0900591,-0.995761,1
3819,0,0,0,0,335,85,4239,2338,6577,-0.018052,-0.0562102,-0.998256,1
6071,0,0,0,0,648,133,6852,3413,10265,-0.00874698,-0.034547,-0.999365,1
4170,0,0,0,0,453,94,4717,2287,7004,-0.00140424,-0.0519385,-0.998649,1
2974,0,0,0,0,281,71,3326,1606,4932,-0.0126963,-0.031367,-0.999427,1
5575,0,0,0,0,542,141,6258,3009,9267,-7.12998e-05,0.004885,-0.999988,1
6493,0,0,0,0,555,145,7193,4265,11458,0.00189891,0.0153764,-0.99988,1
3140,0,0,0,0,384,81,3605,1997,5602,0.0181348,0.00169182,-0.999834,1
5722,0,0,0,0,635,159,6516,3120,9636,0.00230653,0.172357,-0.985032,1
4231,0,0,0,0,476,115,4822,1543,6365,-0.0107423,0.0745985,-0.997156,1
2035,0,0,0,0,265,66,2366,921,3287,-0.0117733,0.075626,-0.997067,1
3871,0,0,0,0,555,140,4566,2011,6577,-0.0164178,0.0879272,-0.995992,1
5759,0,0,0,0,964,263,6986,2621,9607,-0.0394715,0.115415,-0.992533,1
5773,0,0,0,0,870,218,6861,2325,9186,-0.0241433,0.0701605,-0.997244,1
2929,0,0,0,0,466,112,3507,1268,4775,-0.0354793,0.0214312,-0.999141,1
2882,0,0,0,0,428,108,3418,1228,4646,-0.0181222,0.0800297,-0.996628,1
2799,0,0,0,0,454,104,3357,1212,4569,-0.0241795,0.109269,-0.993718,1
4436,0,0,0,0,585,147,5168,1740,6908,0.00531319,0.076718,-0.997039,1
4338,0,0,0,0,538,132,5008,1631,6639,0.000695918,0.0589617,-0.99826,1
4867,0,0,0,0,564,131,5562,2467,8029,0.00302391,0.050215,-0.998734,1
4734,0,0,0,0,620,126,5480,1857,7337,-0.00475651,0.0574289,-0.998338,1
5134,0,0,0,0,501,117,5752,2217,7969,0.00379556,0.041057,-0.99915,1
5298,0,0,0,0,521,112,5931,1925,7856,0.00813999,0.0274932,-0.999589,1
4774,0,0,0,0,607,121,5502,1407,6909,-0.0160063,0.016653,-0.999733,1
2599,0,0,0,0,285,67,2951,943,3894,-0.00433535,0.0162364,-0.999859,1
6455,0,0,0,0,669,155,7279,2302,9581,0.00817185,0.0594267,-0.998199,1
5903,0,0,0,0,664,157,6724,1442,8166,0.00744527,0.0695047,-0.997554,1
3127,0,0,0,0,347,93,3567,1161,4728,-0.019122,0.0326359,-0.999284,1
5383,0,0,0,0,662,158,6203,2605,8808,0.00932472,0.0684964,-0.997608,1
5495,0,0,0,0,652,156,6303,2080,8383,-0.00773777,0.0122136,-0.999895,1
3771,0,0,0,0,427,106,4304,1446,5750,0.00294117,0.0221157,-0.999751,1
3551,0,0,0,0,428,105,4084,1505,5589,-0.0170105,-0.000691539,-0.999855,1
4893,0,0,0,0,559,153,5605,2882,8487,-4.64234e-06,-0.00214126,-0.999998,1
4620,0,0,0,0,549,138,5307,2001,7308,-0.00774395,-0.0138504,-0.999874,1
4715,0,0,0,0,555,139,5409,1992,7401,0.0163228,-0.0133026,-0.999778,1
4552,0,0,0,0,595,153,5300,2123,7423,0.0106862,0.00349088,-0.999937,1
4726,0,0,0,0,621,160,5507,1929,7436,0.00632539,0.0155964,-0.999858,1
4898,0,0,0,0,617,206,5721,2102,7823,0.00884821,0.0289092,-0.999543,1
5164,0,0,0,0,647,157,5968,2131,8099,0.00121055,0.011734,-0.99993,1
6358,0,0,0,0,680,177,7215,2625,9840,-0.00322213,0.0406624,-0.999168,1
6067,0,0,0,0,698,167,6932,2503,9435,-0.0171926,0.0410587,-0.999009,1
3018,0,0,0,0,530,87,3635,1658,5293,-0.018208,0.0564245,-0.998241,1
6268,0,0,0,0,606,171,7045,3965,11010,0.00150644,0.0901027,-0.995931,1
3993,0,0,0,0,352,93,4438,1871,6309,0.0154946,0.0857155,-0.996199,1
5725,0,0,0,0,460,117,6302,2956,9258,-0.0304098,0.127379,-0.991388,1
5913,0,0,0,0,507,113,6533,4042,10575,-0.00133511,0.0663007,-0.997799,1
3916,0,0,0,0,271,71,4258,2805,7063,-0.0174336,0.0317367,-0.999344,1
3707,0,0,0,0,270,70,4047,4246,8293,-0.00965327,0.104627,-0.994465,1
3835,0,0,0,0,305,78,4218,2764,6982,-0.00537993,0.0832296,-0.996516,1
3631,0,0,0,0,443,114,4188,2561,6749,-0.0210949,0.0587212,-0.998052,1
3743,0,0,0,0,339,87,4169,3896,8065,0.0380987,0.00246492,-0.999271,1
6956,0,0,0,0,535,142,7633,3804,11437,0.00816477,0.0872301,-0.996155,1
4098,0,0,0,0,315,82,4495,2676,7171,-0.0163156,-0.0119156,-0.999796,1
2826,0,0,0,0,331,85,3242,2934,6176,0.00796327,-0.0475555,-0.998837,1
6156,0,0,0,0,747,191,7094,4721,11815,-0.00939238,-0.00739472,-0.999929,1
3062,0,0,0,0,396,101,3559,2009,5568,-0.0196365,0.0320889,-0.999292,1
3718,0,0,0,0,505,130,4353,4023,8376,0.00280655,0.0889311,-0.996034,1
4695,0,0,0,0,663,167,5525,5072,10597,0.0489516,0.141467,-0.988732,1
3500,0,0,0,0,495,142,4137,3487,7624,0.0598892,-0.00715129,-0.998179,1
6404,0,0,0,0,802,210,7416,4648,12064,0.0505155,0.0236063,-0.998444,1
3100,0,0,0,0,444,107,3651,2544,6195,0.0266818,0.0247822,-0.999337,1
2895,0,0,0,0,400,93,3388,3381,6769,-0.00059377,0.0424387,-0.999099,1
6137,0,0,0,0,731,183,7051,5319,12370,-0.0165436,-0.0212725,-0.999637,1
3973,0,0,0,0,503,121,4597,3468,8065,0.0121534,-0.0096731,-0.999879,1
5359,0,0,0,0,646,202,6207,5301,11508,0.0315817,0.00851416,-0.999465,1
3731,0,0,0,0,480,118,4329,3140,7469,0.035571,0.0206642,-0.999153,1
4975,0,0,0,0,576,136,5687,4066,9753,0.0737519,-0.0152242,-0.99716,1
4886,0,0,0,0,543,131,5560,2134,7694,0.0456741,-0.0191313,-0.998773,1
4232,0,0,0,0,516,117,4865,1845,6710,-0.0112579,-0.0348415,-0.999329,1
5707,0,0,0,0,712,160,6579,2524,9103,-0.00689725,-0.0371076,-0.999287,1
3852,0,0,0,0,480,109,4441,2408,6849,-0.00962485,-0.0470224,-0.998847,1
5894,0,0,0,0,782,161,6837,3384,10221,-0.0529147,0.0612489,-0.996719,1
2976,0,0,0,0,343,81,3400,1412,4812,-0.0365976,0.0336711,-0.998763,1
2046,0,0,0,0,223,53,2322,1356,3678,-0.0165273,-0.0407907,-0.999031,1
2998,0,0,0,0,314,96,3408,2259,5667,-0.0173194,0.00451203,-0.99984,1
5677,0,0,0,0,566,139,6382,3395,9777,-0.00398899,0.0563769,-0.998402,1
3594,0,0,0,0,289,77,3960,2336,6296,0.0136592,-0.00791712,-0.999875,1
3571,0,0,0,0,335,83,3989,3103,7092,-0.00662152,-0.0238056,-0.999695,1
3709,0,0,0,0,320,81,4110,3347,7457,0.00383639,-0.0586532,-0.998271,1
4655,0,0,0,0,396,104,5155,3258,8413,-0.00898577,-0.0335241,-0.999398,1
3402,0,0,0,0,292,76,3770,3311,7081,-0.0371022,-0.0822285,-0.995923,1
5764,0,0,0,0,496,128,6388,3034,9422,-0.0515104,-0.0700583,-0.996212,1
3922,0,0,0,0,331,86,4339,3020,7359,-0.0478751,-0.0173055,-0.998703,1
5194,0,0,0,0,485,127,5806,3480,9286,-0.0473286,-0.0206257,-0.998666,1
6280,0,0,0,0,381,102,6763,2573,9336,-0.0476723,-0.0374866,-0.998159,1
2325,0,0,0,0,248,64,2637,2065,4702,-0.0680916,-0.104529,-0.992188,1
6208,0,0,0,0,696,173,7077,3015,10092,-0.0523429,0.00557812,-0.998614,1
5667,0,0,0,0,543,119,6329,1645,7974,-0.0260674,0.00547036,-0.999645,1
2462,0,0,0,0,298,76,2836,1486,4322,-0.0244373,0.00379623,-0.999694,1
5602,0,0,0,0,748,193,6543,3115,9658,-0.0191492,-0.064083,-0.997761,1
6392,0,0,0,0,829,230,7451,1633,9084,-0.0314104,0.045354,-0.998477,1
3777,0,0,0,0,569,146,4492,1650,6142,-0.0423066,0.0117811,-0.999035,1
5759,0,0,0,0,911,221,6891,2565,9456,-0.0300438,0.0291054,-0.999125,1
5468,0,0,0,0,850,211,6529,2196,8725,-0.0180987,0.0249856,-0.999524,1
3780,0,0,0,0,586,144,4510,1598,6108,-0.0209381,0.0366255,-0.99911,1
6259,0,0,0,0,1176,214,7649,3316,10965,-0.0732802,0.1906,-0.978929,1
3899,0,0,0,0,533,131,4563,1105,5668,-0.0450038,0.115845,-0.992247,1
5879,0,0,0,0,676,176,6731,1977,8708,-0.0821752,0.0855864,-0.992936,1
3001,0,0,0,0,341,83,3425,1178,4603,-0.0510098,0.101217,-0.993556,1
5989,0,0,0,0,734,157,6880,2589,9469,-0.00308847,0.261938,-0.96508,1
4903,0,0,0,0,543,102,5548,1274,6822,-0.0253001,0.16655,-0.985708,1
2855,0,0,0,0,284,71,3210,724,3934,-0.0291572,0.0639194,-0.997529,1
1918,0,0,0,0,183,48,2149,770,2919,-0.0365728,0.0292839,-0.998902,1
6224,0,0,0,0,730,144,7098,2422,9520,-0.0509605,0.0514602,-0.997374,1
6446,0,0,0,0,692,145,7283,2578,9861,-0.03773,0.04472,-0.998287,1
6484,0,0,0,0,566,136,7186,2671,9857,0.00683809,0.105419,-0.994404,1
2974,0,0,0,0,333,73,3380,1406,4786,-0.0232065,0.108843,-0.993788,1
2001,0,0,0,0,207,50,2258,1180,3438,0.00733504,0.0369875,-0.999289,1
1684,0,0,0,0,183,44,1911,1109,3020,-0.00934232,-0.00461497,-0.999946,1
4422,0,0,0,0,511,128,5061,2796,7857,-0.0103894,0.0437696,-0.998988,1
4546,0,0,0,0,535,135,5216,1804,7020,0.00738472,0.0416253,-0.999106,1
3265,0,0,0,0,422,106,3793,1440,5233,-0.00346601,0.0376659,-0.999284,1
6499,0,0,0,0,791,192,7482,2684,10166,-0.0164537,0.0744932,-0.997086,1
2911,0,0,0,0,402,98,3411,1959,5370,0.0248831,0.0196576,-0.999497,1
3658,0,0,0,0,540,114,4312,2213,6525,0.00494505,0.0206271,-0.999775,1
6100,0,0,0,0,672,181,6953,3702,10655,-0.0119819,0.112963,-0.993527,1
2458,0,0,0,0,268,70,2796,1163,3959,-0.0160497,0.0483004,-0.998704,1
1692,0,0,0,0,183,45,1920,936,2856,0.00538673,0.064475,-0.997905,1
6295,0,0,0,0,523,147,6965,2290,9255,0.0192517,0.0295375,-0.999378,1
2961,0,0,0,0,368,79,3408,1957,5365,0.00872636,-0.0258137,-0.999629,1
4431,0,0,0,0,380,92,4903,3067,7970,-0.00274817,-0.0907402,-0.995871,1
4432,0,0,0,0,317,82,4831,2759,7590,0.0105235,0.00438698,-0.999935,1
4267,0,0,0,0,268,74,4609,3014,7623,0.00579216,0.0258656,-0.999649,1
4231,0,0,0,0,255,68,4554,2302,6856,0.0340923,0.035954,-0.998772,1
5270,0,0,0,0,344,130,5744,4382,10126,0.0110755,0.129052,-0.991576,1
3155,0,0,0,0,196,53,3404,1778,5182,0.0112686,0.0617298,-0.998029,1
1994,0,0,0,0,155,42,2191,1298,3489,0.00874216,-0.02042,-0.999753,1
4055,0,0,0,0,370,91,4516,2589,7105,0.0129964,0.0803222,-0.996684,1
7120,0,0,0,0,642,160,7922,4889,12811,0.0127161,0.00622693,-0.9999,1
3051,0,0,0,0,366,94,3511,2827,6338,0.0581465,-0.195224,-0.979034,1
5993,0,0,0,0,762,197,6952,4447,11399,0.00130093,0.0896019,-0.995977,1
3403,0,0,0,0,428,109,3940,2570,6510,0.00393934,-0.0690976,-0.997602,1
2006,0,0,0,0,256,64,2326,1433,3759,0.0340689,-0.186653,-0.981835,1
2179,0,0,0,0,322,87,2588,1190,3778,-0.00694054,-0.0576981,-0.99831,1
6024,0,0,0,0,914,237,7175,5666,12841,0.0110842,0.0291875,-0.999512,1
2989,0,0,0,0,408,100,3497,3734,7231,-0.0158836,0.0934864,-0.995494,1
2903,0,0,0,0,424,101,3428,2641,6069,-0.0133322,0.206531,-0.978349,1
2795,0,0,0,0,361,85,3241,2179,5420,-0.00407015,0.143659,-0.989619,1
4491,0,0,0,0,534,129,5154,4633,9787,0.1189,0.0837879,-0.989365,1
4361,0,0,0,0,539,122,5022,5002,10024,0.0734423,0.0997649,-0.992297,1
6167,0,0,0,0,814,162,7143,6067,13210,0.105704,0.177032,-0.978512,1
4348,0,0,0,0,591,134,5073,2545,7618,0.100805,0.192138,-0.976177,1
2058,0,0,0,0,236,54,2348,1168,3516,0.0775302,0.167721,-0.982781,1
1542,0,0,0,0,177,40,1759,1133,2892,0.113007,0.1537,-0.981634,1
6687,0,0,0,0,639,149,7475,2915,10390,0.0969491,0.221517,-0.970325,1
6392,0,0,0,0,848,157,7397,3449,10846,0.0840177,0.286468,-0.954399,1
2410,0,0,0,0,254,58,2722,2194,4916,0.0690468,0.281873,-0.956964,1
4261,0,0,0,0,565,120,4946,3993,8939,0.0117746,0.305852,-0.952006,1
5704,0,0,0,0,574,134,6412,5427,11839,-0.0303708,0.404278,-0.914132,1
3652,0,0,0,0,286,70,4008,1911,5919,-0.0184908,0.402127,-0.915397,1
5214,0,0,0,0,602,141,5957,3643,9600,-0.0352613,0.492984,-0.869324,1
4676,0,0,0,0,617,138,5431,2777,8208,-0.0568277,0.546077,-0.835805,1
3337,0,0,0,0,328,92,3757,2369,6126,-0.0407386,0.584537,-0.810344,1
5854,0,0,0,0,560,147,6561,4205,10766,-0.0400568,0.677236,-0.734675,1
5749,0,0,0,0,545,154,6448,-1000,-1000,-1,-1,-1,1
2420,0,0,0,0,229,58,2707,1326,4033,-0.0117683,-0.0118238,-0.999861,1
1754,0,0,0,0,173,43,1970,1458,3428,-0.0147293,-0.0450802,-0.998875,1
2383,0,0,0,0,240,60,2683,1393,4076,-0.00215522,-0.0669828,-0.997752,1
5717,0,0,0,0,571,151,6439,3959,10398,0.00720797,0.0129381,-0.99989,1
5675,0,0,0,0,591,170,6436,3286,9722,0.00440528,0.0491286,-0.998783,1
3876,0,0,0,0,429,112,4417,2446,6863,-0.033156,-0.0228694,-0.999189,1
5663,0,0,0,0,690,172,6525,4585,11110,-0.0191241,0.125416,-0.99192,1
3596,0,0,0,0,554,124,4274,1524,5798,-0.0341416,0.0508842,-0.998121,1
5526,0,0,0,0,535,139,6200,1676,7876,-0.0146348,-0.0248035,-0.999585,1
2347,0,0,0,0,333,85,2765,1230,3995,-0.0339938,0.0517816,-0.99808,1
6183,0,0,0,0,941,220,7344,2513,9857,-0.0312677,0.0521356,-0.99815,1
5649,0,0,0,0,879,227,6755,2745,9500,-0.0243519,0.0940104,-0.995273,1
5606,0,0,0,0,887,212,6705,2767,9472,-0.0303866,0.0593555,-0.997774,1
5603,0,0,0,0,851,210,6664,2524,9188,-0.0472824,0.0807135,-0.995615,1
4048,0,0,0,0,596,151,4795,1673,6468,-0.0412674,0.0505502,-0.997869,1
4862,0,0,0,0,750,175,5787,2110,7897,-0.0459929,0.0625206,-0.996983,1
4765,0,0,0,0,665,160,5590,1933,7523,-0.0413843,0.040441,-0.998325,1
5161,0,0,0,0,644,157,5962,1298,7260,-0.0492911,0.0407082,-0.997955,1
1436,0,0,0,0,170,40,1646,582,2228,-0.0386733,0.0425827,-0.998344,1
3096,0,0,0,0,370,86,3552,1124,4676,-0.0230899,0.0386195,-0.998987,1
5248,0,0,0,0,597,147,5992,2780,8772,-0.0033832,0.0434316,-0.999051,1
5647,0,0,0,0,594,140,6381,1983,8364,-0.00795306,0.0373936,-0.999269,1
5848,0,0,0,0,610,133,6591,1662,8253,-0.0424875,0.0236031,-0.998818,1
2995,0,0,0,0,303,70,3368,1099,4467,-0.0629647,0.0159045,-0.997889,1
5694,0,0,0,0,555,130,6379,2213,8592,-0.0368996,0.0775594,-0.996305,1
3077,0,0,0,0,388,80,3545,878,4423,-0.0218037,0.0335447,-0.999199,1
2311,0,0,0,0,192,46,2549,814,3363,-0.0232753,0.00257145,-0.999726,1
5797,0,0,0,0,598,133,6528,2082,8610,0.0053772,0.0169331,-0.999842,1
2770,0,0,0,0,294,68,3132,1180,4312,0.0190816,0.0239885,-0.99953,1
2782,0,0,0,0,302,72,3156,1227,4383,-0.0248234,-0.0130123,-0.999607,1
3631,0,0,0,0,380,93,4104,1495,5599,0.00344065,-0.00484809,-0.999982,1
3862,0,0,0,0,412,114,4388,1734,6122,-0.00998242,0.0285719,-0.999542,1
3433,0,0,0,0,445,112,3990,1621,5611,-0.00732868,0.0193843,-0.999785,1
3351,0,0,0,0,493,119,3963,1445,5408,-0.00274081,-0.00605104,-0.999978,1
5583,0,0,0,0,780,199,6562,2764,9326,-0.00173836,0.0858957,-0.996303,1
3754,0,0,0,0,425,110,4289,1036,5325,0.00302145,0.0288805,-0.999578,1
2065,0,0,0,0,292,74,2431,874,3305,0.00134071,0.0435806,-0.999049,1
3875,0,0,0,0,549,140,4564,1769,6333,0.00583978,-0.0171109,-0.999837,1
4251,0,0,0,0,541,137,4929,2394,7323,0.015707,-0.0227075,-0.999619,1
6003,0,0,0,0,847,188,7038,2648,9686,-0.015976,0.0585004,-0.99816,1
6001,0,0,0,0,744,200,6945,1930,8875,-0.00858909,0.0979736,-0.995152,1
2296,0,0,0,0,196,51,2543,1418,3961,-0.0184817,0.113944,-0.993315,1
1891,0,0,0,0,167,40,2098,1441,3539,0.00240997,0.0849571,-0.996382,1
3615,0,0,0,0,263,141,4019,2735,6754,0.0223722,0.081296,-0.996439,1
3553,0,0,0,0,277,66,3896,3057,6953,0.00388701,0.00253155,-0.999989,1
3604,0,0,0,0,233,64,3901,3111,7012,-0.0171471,-0.024984,-0.999541,1
3640,0,0,0,0,338,75,4053,4005,8058,-0.027237,0.0496585,-0.998395,1
3609,0,0,0,0,372,162,4143,4519,8662,-0.0396729,0.040966,-0.998373,1
3779,0,0,0,0,433,128,4340,4513,8853,-0.0663751,0.00068419,-0.997795,1
4034,0,0,0,0,462,115,4611,3406,8017,-0.0153736,0.0515754,-0.998551,1
4118,0,0,0,0,552,159,4829,3471,8300,-0.0615835,0.068549,-0.995745,1
4005,0,0,0,0,524,134,4663,2568,7231,-0.0276835,-0.0426595,-0.998706,1
4128,0,0,0,0,635,138,4901,3380,8281,-0.0197821,0.032659,-0.999271,1
7113,0,0,0,0,1029,225,8367,2745,11112,-0.00544313,0.0705979,-0.99749,1
2565,0,0,0,0,357,76,2998,2001,4999,-0.0339296,-0.0300984,-0.998971,1
1896,0,0,0,0,244,62,2202,988,3190,-0.0211599,-0.0217922,-0.999539,1
6246,0,0,0,0,504,126,6876,3157,10033,-0.0857363,-0.0175396,-0.996163,1
2502,0,0,0,0,306,75,2883,1646,4529,-0.0365788,-0.0632703,-0.997326,1
7891,0,0,0,0,856,197,8944,3800,12744,-0.0316075,0.0313434,-0.999009,1
2732,0,0,0,0,266,64,3062,1741,4803,-0.0558394,0.103053,-0.993107,1
2196,0,0,0,0,255,60,2511,1300,3811,-0.0678335,0.1548,-0.985614,1
6622,0,0,0,0,774,166,7562,5549,13111,-0.0199439,0.176048,-0.98418,1
4043,0,0,0,0,491,109,4643,2633,7276,-0.068242,0.218335,-0.973485,1
3041,0,0,0,0,354,79,3474,2085,5559,0.000973818,0.194978,-0.980807,1
4914,0,0,0,0,568,129,5611,3753,9364,0.0591376,0.26328,-0.962905,1
4815,0,0,0,0,513,117,5445,3364,8809,0.0525942,0.316248,-0.947218,1
4037,0,0,0,0,361,85,4483,2621,7104,0.0899974,0.351971,-0.931674,1
3492,0,0,0,0,342,78,3912,2543,6455,0.060715,0.392743,-0.917642,1
5922,0,0,0,0,531,126,6579,3906,10485,0.0152604,0.428197,-0.903556,1
4121,0,0,0,0,337,78,4536,2465,7001,0.0520255,0.452391,-0.890301,1
6579,0,0,0,0,613,130,7322,3246,10568,0.0490214,0.460696,-0.886203,1
3208,0,0,0,0,294,66,3568,2387,5955,0.0334823,0.499049,-0.865927,1
5040,0,0,0,0,503,115,5658,3870,9528,0.0102833,0.501985,-0.864815,1
7071,0,0,0,0,497,101,7669,3259,10928,-0.0432371,0.545591,-0.836936,1
6320,0,0,0,0,395,100,6815,2658,9473,-0.0115559,0.568965,-0.822281,1
2561,0,0,0,0,245,63,2869,1439,4308,-0.0479508,0.56059,-0.826704,1
5577,0,0,0,0,542,157,6276,4562,10838,-0.0619032,0.650019,-0.757392,1
6461,0,0,0,0,375,98,6934,-1000,-1000,-1,-1,-1,1
2035,0,0,0,0,194,51,2280,1155,3435,-0.0133075,-0.032504,-0.999383,1
5104,0,0,0,0,488,125,5717,2774,8491,-0.0231331,0.00495054,-0.99972,1
5313,0,0,0,0,483,128,5924,3990,9914,-0.0157279,-0.0109173,-0.999817,1
3554,0,0,0,0,339,85,3978,2159,6137,-0.0107117,-0.0347511,-0.999339,1
3586,0,0,0,0,358,88,4032,2380,6412,-0.0156021,-0.0581182,-0.998188,1
3503,0,0,0,0,383,93,3979,2452,6431,-7.2275e-05,0.0338057,-0.999428,1
3722,0,0,0,0,370,96,4188,2132,6320,-0.009983,-0.00124701,-0.999949,1
3516,0,0,0,0,384,97,3997,2572,6569,-0.00979803,0.0209016,-0.999734,1
2817,0,0,0,0,311,83,3211,2171,5382,-0.0229881,0.0371341,-0.999046,1
4160,0,0,0,0,648,151,4959,3279,8238,-0.0239103,0.023479,-0.999438,1
4140,0,0,0,0,539,135,4814,3043,7857,-0.033464,0.0626493,-0.997474,1
2519,0,0,0,0,478,94,3091,1846,4937,-0.0367096,0.0161103,-0.999196,1
6044,0,0,0,0,931,222,7197,2547,9744,-0.0347207,0.0545171,-0.997909,1
2084,0,0,0,0,295,76,2455,854,3309,-0.0402529,0.0364865,-0.998523,1
3162,0,0,0,0,485,122,3769,1937,5706,-0.00903702,0.0308309,-0.999484,1
5436,0,0,0,0,825,209,6470,2179,8649,-0.0184958,0.0627709,-0.997857,1
5873,0,0,0,0,934,205,7012,2181,9193,-0.0320704,0.0623704,-0.997538,1
3549,0,0,0,0,529,132,4210,1599,5809,-0.03308,0.0404482,-0.998634,1
5908,0,0,0,0,823,213,6944,2290,9234,-0.0448157,0.0691912,-0.996596,1
3842,0,0,0,0,503,125,4470,1570,6040,-0.0360073,0.0269605,-0.998988,1
4081,0,0,0,0,467,122,4670,1626,6296,-0.0385744,0.0179751,-0.999094,1
3965,0,0,0,0,447,109,4521,2473,6994,-0.039339,0.0424882,-0.998322,1
2721,0,0,0,0,268,68,3057,912,3969,-0.0284927,0.0511764,-0.998283,1
6340,0,0,0,0,914,201,7455,2365,9820,-0.0393963,0.067008,-0.996974,1
3219,0,0,0,0,306,74,3599,1222,4821,-0.0244039,0.0504734,-0.998427,1
3119,0,0,0,0,343,87,3549,1119,4668,-0.029481,0.038607,-0.998819,1
6416,0,0,0,0,620,147,7183,2371,9554,-0.0168986,0.00509396,-0.999844,1
4304,0,0,0,0,392,93,4789,1509,6298,-0.0190488,0.0236575,-0.999539,1
4273,0,0,0,0,395,91,4759,1698,6457,-0.00144373,0.0103425,-0.999945,1
4242,0,0,0,0,359,85,4686,1633,6319,0.0129271,0.00287874,-0.999912,1
4034,0,0,0,0,363,86,4483,1729,6212,0.0132482,0.00268953,-0.999909,1
3930,0,0,0,0,444,102,4476,1756,6232,0.0125305,0.0468883,-0.998822,1
3903,0,0,0,0,433,108,4444,3196,7640,0.0252955,0.151684,-0.988105,1
