Downsample[ns],BuildFilTree[ns],SearchFil[ns],DeleteFil[ns],BuildTreeSub[ns],SearchSub[ns],DeleteSub[ns],PreProcTotal[ns],Plane[ns],Total[ns],nx,ny,nz,planeCount
6134,4551,112,587,4231,65,206,15886,1847,17733,0.0348478,-0.000209231,-0.999393,0
2345,1681,19,214,1696,32,123,6110,1175,7285,0.0297298,-0.0089501,-0.999518,0
2624,1599,15,205,1583,21,113,6160,1170,7330,0.0292568,0.0210148,-0.999351,0
5195,3643,41,597,5052,74,317,14919,2314,17233,0.026234,-0.00977427,-0.999608,0
3616,2443,24,309,2017,26,139,8574,1236,9810,0.049912,-0.00260383,-0.99875,0
2210,1510,15,193,1522,31,100,5581,987,6568,0.00965067,0.00728444,-0.999927,0
5316,3469,32,471,3575,71,214,13148,2398,15546,0.0222905,0.00823453,-0.999718,0
2214,1484,14,191,1453,23,135,5514,1113,6627,0.0284848,0.00226977,-0.999592,0
5230,3502,39,476,3540,47,271,13105,1778,14883,0.0378675,0.00557658,-0.999267,0
2936,2027,21,222,1771,28,120,7125,1523,8648,0.0282599,0.00251619,-0.999597,0
5389,3545,41,457,3459,50,279,13220,2001,15221,0.0218804,0.00478605,-0.999749,0
2687,1851,22,221,1798,32,129,6740,1498,8238,0.0381601,0.0101256,-0.99922,0
5144,3606,45,500,3519,84,244,13142,2683,15825,0.00763291,0.00701366,-0.999946,0
3604,2485,24,282,2400,40,156,8991,2035,11026,0.0200583,-0.00206333,-0.999797,0
5352,3442,35,387,3095,63,224,12598,2243,14841,0.0155469,-0.000685467,-0.999879,0
3306,2274,27,278,2224,42,156,8307,1524,9831,0.0174676,0.00405958,-0.999839,0
4383,3059,41,384,2867,54,200,10988,2133,13121,0.022871,0.00963338,-0.999692,0
3130,2139,25,259,2082,38,147,7820,1664,9484,0.0263096,0.00300529,-0.999649,0
5437,3598,40,436,3453,63,241,13268,1964,15232,0.0340702,0.0119933,-0.999347,0
5417,3561,41,425,3478,84,241,13247,2405,15652,0.0316425,0.000344623,-0.999499,0
2739,1608,18,178,1486,27,102,6158,1038,7196,0.0283493,-0.000519684,-0.999598,0
1600,1077,14,130,968,20,64,3873,762,4635,0.0201801,-0.0112729,-0.999733,0
5409,3485,41,409,2949,30,157,12480,1683,14163,0.0372571,0.00228034,-0.999303,0
2907,1904,19,244,1845,25,141,7085,1443,8528,0.0149934,0.0256761,-0.999558,0
4368,2949,28,379,2861,49,211,10845,2123,12968,0.0237371,-0.0147942,-0.999609,0
3118,2126,25,282,2131,37,152,7871,1561,9432,0.00205218,-0.00203475,-0.999996,0
5359,3508,41,421,3445,90,242,13106,3060,16166,0.0134817,0.00158467,-0.999908,0
2808,1750,14,190,1461,19,96,6338,1209,7547,0.0127387,0.0106054,-0.999863,0
1631,1056,10,161,1262,17,96,4233,731,4964,0.0682425,-0.00107961,-0.997668,0
1353,970,10,114,888,17,67,3419,627,4046,0.0472376,0.0041519,-0.998875,0
2820,1950,18,234,1880,28,131,7061,1635,8696,0.026932,-0.00493026,-0.999625,0
4293,2902,28,343,2805,51,193,10615,1929,12544,0.0535703,-0.00479276,-0.998553,0
5354,3514,40,426,3494,88,168,13084,1951,15035,0.0259473,-0.000639352,-0.999663,0
2747,1846,33,230,1839,32,127,6854,1453,8307,0.0208934,0.00642069,-0.999761,0
4127,2945,28,417,2799,56,192,10564,2220,12784,0.0192731,0.0190942,-0.999632,0
5318,3551,35,475,3572,73,272,13296,1715,15011,0.0144038,-0.011092,-0.999835,0
2741,1867,18,243,1871,28,136,6904,1406,8310,0.0249453,-0.0110806,-0.999627,0
5332,3666,44,566,3602,87,268,13565,1833,15398,0.0371821,0.00584677,-0.999291,0
2803,1798,19,207,1463,22,115,6427,961,7388,0.0463844,0.00795007,-0.998892,0
1642,1068,11,123,1039,14,69,3966,827,4793,0.0576274,-0.0147958,-0.998229,0
5671,3408,34,415,3353,53,231,13165,1730,14895,0.0388628,0.0125847,-0.999165,0
2805,1464,14,208,1436,19,95,6041,885,6926,0.0315922,0.00359686,-0.999494,0
1596,1074,12,123,1066,15,69,3955,811,4766,0.015132,-0.00217871,-0.999883,0
3424,2237,21,310,2228,38,154,8412,1700,10112,0.0310142,-0.00148538,-0.999518,0
5203,3585,35,448,3356,65,266,12958,1763,14721,0.0209955,-0.00992781,-0.99973,0
3691,2377,24,320,2350,42,194,8998,1967,10965,0.052316,0.00512489,-0.998617,0
3638,2374,23,308,2386,49,173,8951,1697,10648,0.0231662,0.0112097,-0.999669,0
5240,3548,34,450,3428,47,267,13014,1903,14917,0.0310229,-0.0089299,-0.999479,0
2769,1818,18,231,1786,25,132,6779,2260,9039,0.00244294,-0.00188578,-0.999995,0
4299,2788,29,337,2788,44,193,10478,2148,12626,0.0151026,0.00793756,-0.999854,0
4345,2930,43,413,2810,44,198,10783,2036,12819,0.0181651,-0.0123413,-0.999759,0
3141,2080,20,269,2108,36,135,7789,1643,9432,0.0176921,0.00757677,-0.999815,0
5323,3559,47,444,3450,55,228,13106,2172,15278,0.00393647,0.00453299,-0.999982,0
2777,1837,18,245,1811,25,139,6852,1527,8379,0.0209284,0.0135688,-0.999689,0
5407,3517,36,454,3452,55,257,13178,1856,15034,0.0129023,0.0178391,-0.999758,0
2760,1844,18,230,1804,41,142,6839,1362,8201,0.0209937,-0.00229412,-0.999777,0
5295,3538,33,449,3504,48,278,13145,1869,15014,0.0209823,-0.0112305,-0.999717,0
3456,1911,18,287,1780,25,121,7598,1637,9235,0.0455975,0.00895368,-0.99892,0
5459,3524,34,449,3340,56,255,13117,2397,15514,0.0193733,-0.0139195,-0.999715,0
3808,2540,23,283,2389,30,157,9230,1295,10525,0.0303134,-0.0121457,-0.999467,0
2780,1898,19,250,1888,30,135,7000,2073,9073,0.0387128,0.00814723,-0.999217,0
2787,1854,22,305,2484,39,173,7664,2091,9755,0.0102594,-0.00448883,-0.999937,0
5270,3552,37,483,3507,51,265,13165,1901,15066,0.0392087,-0.00429108,-0.999222,0
3588,2381,24,310,2360,35,179,8877,1648,10525,0.0143592,-0.0125888,-0.999818,0
4300,2858,27,368,2843,39,202,10637,2260,12897,0.0242168,0.00570933,-0.99969,0
3847,2633,31,333,2710,78,265,9897,2352,12249,0.0109677,0.00374057,-0.999933,0
4411,2871,27,335,2650,36,188,10518,1758,12276,0.0179215,-0.00466138,-0.999829,0
2975,1966,23,236,2203,43,155,7601,1568,9169,0.0558523,0.0148116,-0.998329,0
3025,2027,20,237,1992,26,143,7470,1709,9179,0.0310546,0.0027717,-0.999514,0
5647,3424,41,466,3673,52,275,13578,1880,15458,0.00977626,0.00348004,-0.999946,0
2758,1789,18,247,1838,36,140,6826,1606,8432,0.00235639,-0.00510086,-0.999984,0
5315,3443,34,522,3422,47,301,13084,2607,15691,0.0207382,-0.00137576,-0.999784,0
3594,2461,23,364,2405,31,191,9069,1568,10637,0.0113527,0.0216442,-0.999701,0
2212,1483,15,185,1478,27,111,5511,1335,6846,0.0424937,-0.00874715,-0.999058,0
5075,3150,32,382,3352,43,250,12284,2194,14478,0.0269512,0.00237343,-0.999634,0
3307,2187,27,301,2267,39,187,8315,1795,10110,0.0274998,-0.00632544,-0.999602,0
3487,2062,20,242,2084,29,165,8089,1521,9610,0.0354254,0.00517047,-0.999359,0
4029,2709,27,348,2653,36,175,9977,2472,12449,0.046653,0.0139707,-0.998813,0
3048,1975,19,272,1944,25,149,7432,1545,8977,0.042706,0.00124748,-0.999087,0
3598,2407,24,338,2341,40,200,8948,2099,11047,0.0260398,0.00856546,-0.999624,0
5392,3550,34,471,3431,51,166,13095,1908,15003,0.028141,0.0104302,-0.99955,0
2723,2112,24,300,1886,27,122,7194,1446,8640,0.0131941,0.0032907,-0.999908,0
5340,3580,35,431,3516,47,232,13181,1878,15059,0.0181205,0.00321465,-0.999831,0
2860,1874,18,218,1801,31,122,6924,1401,8325,0.0633732,-0.0166079,-0.997852,0
4536,2946,38,375,2805,60,231,10991,2454,13445,0.0180403,-0.00215391,-0.999835,0
3181,2107,20,246,2162,34,161,7911,1601,9512,0.027974,-0.0156499,-0.999486,0
5303,3539,34,484,3610,52,188,13210,1901,15111,0.0130763,0.00423795,-0.999906,0
2727,1863,17,242,1872,26,141,6888,1409,8297,0.0417378,-0.00454696,-0.999118,0
4330,2860,28,375,2779,36,217,10625,1898,12523,0.0279575,0.021284,-0.999382,0
3349,2111,21,242,2060,52,134,7969,1544,9513,0.0302345,-0.0152976,-0.999426,0
4202,2759,26,359,2530,50,169,10095,2033,12128,0.0268452,-0.0139555,-0.999542,0
2915,1996,19,224,1974,36,189,7353,1826,9179,0.0264725,0.0066582,-0.999627,0
4860,3125,29,360,3228,56,225,11883,2768,14651,0.0433123,-0.00339237,-0.999056,0
3176,2186,22,216,1796,32,134,7562,1360,8922,0.0430509,-0.000908708,-0.999072,0
5325,3513,35,469,3434,66,262,13104,2489,15593,0.0337314,-0.00857848,-0.999394,0
3100,1835,19,237,1516,27,101,6835,1157,7992,0.0179514,0.00862778,-0.999802,0
1689,1055,10,129,1020,20,60,3983,704,4687,0.0260006,0.00123994,-0.999661,0
1485,996,11,121,968,13,64,3658,784,4442,0.0235268,0.0100277,-0.999673,0
5206,3668,35,468,3346,47,269,13039,2700,15739,0.0573637,-0.00562756,-0.998337,0
3596,2472,24,306,2393,45,177,9013,1379,10392,0.0286544,-0.000320595,-0.999589,0
2244,1637,16,191,1397,21,109,5615,1094,6709,0.0288711,-0.0126438,-0.999503,0
5205,3438,37,442,3551,88,266,13027,2957,15984,0.0234919,-0.00391147,-0.999716,0
5419,2261,41,314,1738,35,126,9934,1440,11374,0.0221644,-0.018293,-0.999587,0
1902,1120,14,149,1073,19,80,4357,1420,5777,0.0270605,-0.00584464,-0.999617,0
4624,2815,33,323,2590,47,180,10612,2572,13184,0.0256654,-0.00101442,-0.99967,0
5327,3138,35,449,2915,51,249,12164,1863,14027,0.0623794,-0.017588,-0.997898,0
2798,1545,18,210,1522,27,128,6248,1338,7586,0.0268436,-0.00322751,-0.999634,0
4688,2660,33,392,2512,43,225,10553,2523,13076,0.0117337,0.0232914,-0.99966,0
4582,2310,28,324,2317,36,190,9787,2478,12265,0.00828716,0.0034018,-0.99996,0
3459,1707,21,233,1677,28,136,7261,1535,8796,0.0204582,0.00784851,-0.99976,0
5798,2811,40,371,2760,73,199,12052,2455,14507,0.0599332,0.0404057,-0.997384,0
5786,2633,34,314,2670,62,177,11676,2448,14124,0.0411307,0.0450119,-0.998139,0
3769,1821,31,226,1756,40,127,7770,1939,9709,0.057811,0.0552094,-0.9968,0
5443,2421,39,304,2461,60,200,10928,2706,13634,0.0178994,0.0556302,-0.998291,0
3840,1787,22,218,1700,33,117,7717,1588,9305,0.0461118,0.040342,-0.998121,0
3481,1660,25,222,1574,50,115,7127,1876,9003,0.0511505,0.0764016,-0.995764,0
5948,2745,39,338,2582,72,185,11909,2740,14649,0.0234261,0.0523158,-0.998356,0
3811,1642,20,193,2030,33,119,7848,2040,9888,0.03851,0.0963826,-0.994599,0
2692,1207,17,143,1181,32,85,5357,1786,7143,0.0277808,0.111604,-0.993364,0
6015,2337,38,294,2320,52,160,11216,2798,14014,0.0379893,0.104343,-0.993816,0
2831,1124,16,136,1079,20,79,5285,2176,7461,0.0385508,0.14341,-0.988912,0
4868,1852,34,226,1768,37,124,8909,2721,11630,0.0346345,0.0993395,-0.994451,0
4734,1900,31,225,1577,44,125,8636,2835,11471,0.0438593,0.117504,-0.992103,0
3180,1216,22,165,1209,34,136,5962,2496,8458,-0.0570618,0.104365,-0.992901,0
4814,1904,36,253,1890,47,138,9082,2744,11826,0.0341773,0.125071,-0.991559,0
3291,1344,21,156,1319,27,107,6265,3712,9977,0.00332239,0.110734,-0.993845,0
3468,1268,19,160,1326,33,112,6386,2433,8819,0.0269087,0.0989058,-0.994733,0
4514,1852,25,249,1782,35,132,8589,2639,11228,0.0247688,0.135909,-0.990412,0
3224,1317,19,192,1230,24,86,6092,2239,8331,0.0309969,0.149463,-0.988281,0
4403,1531,29,215,1455,39,117,7789,2730,10519,0.00397233,0.219481,-0.975609,0
3510,1419,26,211,1330,39,104,6639,2913,9552,0.0108224,0.16736,-0.985836,0
3579,1361,34,178,1236,36,101,6525,2242,8767,0.0316728,0.151491,-0.987951,0
4349,1535,30,199,1452,56,141,7762,2572,10334,0.0203983,0.115438,-0.993105,0
3021,932,22,153,915,43,89,5175,1642,6817,0.0225049,0.140239,-0.989862,0
4139,1526,36,250,1305,51,101,7408,2861,10269,0.00890898,0.138921,-0.990263,0
4022,1109,29,160,1066,58,95,6539,2238,8777,0.0380468,0.139002,-0.989561,0
2808,736,20,107,711,36,63,4481,1683,6164,0.0334654,0.14736,-0.988517,0
4384,1093,33,162,1195,74,96,7037,2982,10019,0.0357205,0.118387,-0.992325,0
3155,736,24,106,671,32,55,4779,2116,6895,0.0370773,0.119164,-0.992182,0
3170,799,19,110,747,27,60,4932,1777,6709,0.0366138,0.150051,-0.988,0
4012,1343,34,216,1160,33,100,6898,2275,9173,0.0292565,0.131712,-0.990856,0
4592,1366,24,195,1269,51,97,7594,2052,9646,0.014243,0.148127,-0.988866,0
4076,1507,24,202,1615,36,115,7575,2361,9936,0.00590696,0.159532,-0.987175,0
4061,1811,30,286,1642,42,120,7992,1821,9813,0.00555751,0.140233,-0.990103,0
3464,1627,26,268,1617,37,121,7160,1956,9116,-0.00266578,0.149281,-0.988791,0
4221,2040,21,234,1888,31,144,8579,1933,10512,-0.0114663,0.267182,-0.963578,0
3752,2299,33,276,2214,39,158,8771,2043,10814,0.0374277,0.134419,-0.990218,0
2331,1530,14,197,1407,15,107,5601,1047,6648,0.0280949,0.187821,-0.981801,0
4142,3090,24,371,3406,29,188,11250,1814,13064,0.0352087,0.184585,-0.982186,0
4267,3395,24,436,3245,28,203,11598,1655,13253,0.0353744,0.235146,-0.971316,0
3162,2827,18,334,2837,22,166,9366,1572,10938,0.037309,0.20511,-0.978028,0
4825,4576,27,521,4488,40,309,14786,2168,16954,0.0488178,0.21821,-0.97468,0
2788,2772,14,301,2661,37,173,8746,1808,10554,0.0451782,0.220663,-0.974303,0
6487,5739,29,660,5691,55,389,19050,2792,21842,0.0353227,0.256523,-0.965892,0
2590,2602,12,249,2157,19,145,7774,1531,9305,-0.00899406,0.205885,-0.978535,0
1665,1434,7,172,1413,10,95,4796,1341,6137,0.031804,0.0789408,-0.996372,0
2291,2079,11,243,2082,19,142,6867,2014,8881,0.0804568,0.103222,-0.991399,0
6137,5232,27,675,4921,65,373,17430,3731,21161,0.0173776,0.136275,-0.990519,0
6269,4937,29,652,6093,78,288,18346,1943,20289,0.00355684,0.24769,-0.968833,0
2660,2127,10,218,1821,25,114,6975,1646,8621,0.00882608,0.193013,-0.981156,0
1855,1534,10,157,1370,17,84,5027,1230,6257,-0.00604487,0.0936292,-0.995589,0
1578,1212,9,138,1195,17,75,4224,1231,5455,0.0331813,0.084042,-0.99591,0
4093,2881,20,350,2821,37,182,10384,3958,14342,-0.00957545,0.0959561,-0.99534,0
5905,3824,30,454,3801,58,250,14322,3206,17528,-0.00752684,0.182656,-0.983148,0
2488,1658,14,189,1336,24,87,5796,1985,7781,0.0305061,0.0802208,-0.99631,0
1603,951,10,158,909,11,59,3701,1144,4845,0.00109043,0.105819,-0.994385,0
1331,912,8,110,911,13,66,3351,1078,4429,-0.00584349,0.0165354,-0.999846,0
3600,2484,19,346,2410,32,204,9095,3107,12202,-0.0221632,0.0981693,-0.994923,0
5127,3458,27,433,3360,36,260,12701,3514,16215,-0.0335675,0.0892109,-0.995447,0
3103,1771,15,205,1727,19,115,6955,4157,11112,0.0143632,0.0807913,-0.996628,0
4062,2698,20,335,2622,33,204,9974,5005,14979,0.00113106,0.0346137,-0.9994,0
2985,1932,15,258,1888,28,126,7232,2922,10154,0.00987911,0.0582436,-0.998254,0
5069,2977,26,364,3009,47,264,11756,3901,15657,-0.00500076,0.116477,-0.993181,0
3123,1965,16,272,1899,25,149,7449,2319,9768,-0.0170998,0.0719179,-0.997264,0
4315,2371,22,315,2302,36,198,9559,2391,11950,-0.0316302,0.0105568,-0.999444,0
3425,2063,19,279,2003,28,181,7998,3311,11309,-0.0234395,0.0254916,-0.9994,0
3389,1989,20,251,1968,29,143,7789,1920,9709,-0.0166325,0.0615585,-0.997965,0
3978,2584,22,333,2443,32,199,9591,2673,12264,0.00749429,0.108233,-0.994097,0
4452,2926,25,391,2699,47,215,10755,1793,12548,0.00677336,0.139099,-0.990255,0
2907,1870,18,247,1827,31,146,7046,1705,8751,0.00226486,0.155338,-0.987859,0
3621,2474,19,328,2473,35,174,9124,2116,11240,-0.0069998,0.186746,-0.982383,0
3855,2604,18,339,2664,34,200,9714,2053,11767,-0.0252766,0.127741,-0.991485,0
3796,3033,22,344,2738,35,206,10174,1666,11840,-0.0169236,0.244842,-0.969415,0
2240,1707,13,189,1591,18,102,5860,1153,7013,-0.0164469,0.167971,-0.985655,0
4616,3328,24,422,3234,51,215,11890,1690,13580,0.00241157,0.227708,-0.973726,0
3103,2655,16,295,2402,24,179,8674,1592,10266,-0.0102665,0.137617,-0.990432,0
3156,3070,17,275,2415,23,162,9118,1588,10706,-0.0227253,0.100195,-0.994708,0
4624,3444,22,388,3333,49,217,12077,2971,15048,-0.0276725,0.081721,-0.996271,0
3607,2611,17,278,2610,23,180,9326,1919,11245,-0.0244733,0.117905,-0.992723,0
4932,3662,22,390,3575,55,220,12856,2356,15212,-0.00910028,0.121624,-0.992534,0
4454,3580,23,403,2561,38,174,11233,1277,12510,0.00802839,0.180336,-0.983572,0
4568,3573,25,392,2945,29,168,11700,1331,13031,-0.0298242,0.20241,-0.978847,0
2070,1632,11,179,1635,19,101,5647,1436,7083,-0.0259139,0.159266,-0.986896,0
3894,2745,19,374,2749,82,210,10073,4114,14187,-0.00871194,-0.39853,-0.917114,0
2662,2307,18,269,2111,27,151,7545,4539,12084,-0.0781301,0.238428,-0.968012,0
5236,4022,36,526,3989,78,297,14184,4790,18974,-0.0888731,0.140863,-0.986032,0
2180,1651,16,201,1622,29,152,5851,3090,8941,-0.0137171,0.169054,-0.985511,0
2139,1561,13,185,1519,17,95,5529,1394,6923,0.154567,0.0302527,-0.987519,0
5427,3801,34,459,3754,38,276,13789,1695,15484,-0.0240301,0.182039,-0.982998,0
3567,2373,22,333,2418,26,185,8924,1321,10245,0.00127067,0.166724,-0.986003,0
4187,2671,27,343,2565,28,201,10022,2223,12245,-0.0249429,0.185352,-0.982356,0
4115,2324,27,364,2266,34,191,9321,1624,10945,-0.0409785,0.162255,-0.985898,0
3050,1686,19,233,1826,20,134,6968,1548,8516,-0.0669727,0.267113,-0.961335,0
4465,2534,27,302,2410,32,167,9937,1830,11767,-0.0498027,0.288544,-0.956171,0
3290,1980,19,300,2096,23,161,7869,1845,9714,-0.0955049,0.269761,-0.958179,0
4309,2750,29,322,2727,53,190,10380,3680,14060,-0.0854206,0.270929,-0.958802,0
3096,2089,20,312,2158,21,133,7829,3696,11525,-0.0657024,0.137496,-0.988321,0
3104,2004,19,270,1961,35,146,7539,2865,10404,-0.0699526,0.111407,-0.99131,0
5289,3537,34,459,3415,48,255,13037,4048,17085,0.0329976,0.228571,-0.972968,0
3264,2196,19,245,2083,21,141,7969,1761,9730,0.00181596,0.147299,-0.98909,0
2971,1822,17,241,1814,21,119,7005,1561,8566,0.0278004,0.166128,-0.985712,0
4535,2441,40,303,2329,53,156,9857,2017,11874,-0.0101832,0.132774,-0.991094,0
3025,1474,18,176,1459,25,97,6274,2078,8352,-0.0250771,0.0774767,-0.996679,0
3141,1540,19,185,1532,24,103,6544,2251,8795,0.00940281,0.14151,-0.989892,0
4969,2525,28,346,2492,47,159,10566,3086,13652,0.0356171,0.161685,-0.986199,0
2471,1271,13,127,1065,17,72,5036,1429,6465,0.042219,0.096906,-0.994398,0
1480,733,9,86,733,11,49,3101,944,4045,0.0426197,0.126252,-0.991082,0
4602,1921,25,264,1925,41,153,8931,3001,11932,0.0282026,0.174408,-0.984269,0
4428,1865,26,230,1792,33,125,8499,4627,13126,0.0131875,0.171946,-0.985018,0
4307,1553,23,232,1491,38,107,7751,3855,11606,0.0409089,0.179435,-0.982919,0
3012,1054,18,159,1037,25,87,5392,3199,8591,0.00729252,0.179799,-0.983676,0
5046,1456,32,200,1413,51,141,8339,6131,14470,0.00593693,0.134774,-0.990859,0
3367,1050,20,166,996,25,78,5702,3872,9574,0.028881,0.124196,-0.991837,0
3058,870,22,132,843,37,77,5039,3153,8192,0.00199387,0.130683,-0.991422,0
4280,1298,35,178,1333,53,128,7305,5608,12913,0.0379699,0.0571042,-0.997646,0
4194,1198,31,205,1193,33,111,6965,4193,11158,0.00960902,0.21208,-0.977205,0
3016,850,22,150,969,29,62,5098,2260,7358,0.0199543,0.172517,-0.984804,0
4535,1289,26,170,1319,34,108,7481,3030,10511,0.0183459,0.211056,-0.977302,0
4715,1741,29,221,1650,37,119,8512,2687,11199,0.0576877,0.216784,-0.974514,0
4960,2011,30,261,2062,46,157,9527,1867,11394,0.0451954,0.190915,-0.980566,0
3351,1576,25,226,1592,22,104,6896,1606,8502,0.0310694,0.163741,-0.986014,0
5239,2589,27,339,2513,33,203,10943,2611,13554,-0.00349015,0.26133,-0.965243,0
2699,1320,13,160,1216,15,92,5515,1217,6732,-0.00701478,0.164427,-0.986364,0
1563,998,10,154,1343,18,97,4183,885,5068,0.0146271,0.13587,-0.990619,0
2121,1532,13,188,1461,18,109,5442,1445,6887,-0.0244105,0.0660673,-0.997517,0
4909,3955,25,437,3586,39,221,13172,4056,17228,-0.0281528,0.108568,-0.99369,0
3565,3077,19,352,3005,42,215,10275,1987,12262,-0.00300852,0.0947497,-0.995497,0
3504,3092,19,356,3131,38,212,10352,3144,13496,0.05982,0.052495,-0.996828,0
5554,5054,26,589,4861,46,332,16462,4049,20511,0.00912092,0.116025,-0.993204,0
3970,3716,19,399,3372,53,211,11740,1557,13297,-0.0147222,0.134625,-0.990787,0
2195,1954,13,247,2037,31,131,6608,1071,7679,-0.00687005,0.113772,-0.993483,0
5730,4759,25,546,4604,73,299,16036,2589,18625,-0.0278296,0.134082,-0.990579,0
3966,3388,21,365,3134,38,162,11074,1469,12543,-0.0432235,0.126637,-0.991007,0
2491,1923,11,228,1884,33,135,6705,1206,7911,-0.0457898,0.141263,-0.988913,0
3252,2464,18,304,2506,29,176,8749,2139,10888,-0.0360718,0.096699,-0.99466,0
3868,2754,23,330,2716,61,186,9938,2579,12517,-0.0423563,0.0969226,-0.99439,0
2854,1916,16,236,1893,26,150,7091,2116,9207,-0.0123401,0.137916,-0.990367,0
5189,3246,26,405,3159,59,210,12294,2481,14775,-0.0417916,0.112076,-0.99282,0
3535,2356,23,311,2284,51,182,8742,1724,10466,-0.0146204,0.105043,-0.99436,0
7822,4756,36,584,3754,39,239,17230,2195,19425,-0.0362853,0.114133,-0.992803,0
3945,2539,19,279,2085,21,132,9020,1428,10448,-0.0243046,0.120277,-0.992443,0
1975,1447,11,161,1414,17,90,5115,1451,6566,-0.0357112,0.0940542,-0.994926,0
5664,3829,26,483,3570,45,266,13883,2761,16644,-0.0318514,0.0947714,-0.994989,0
6628,3852,27,435,3957,56,377,15332,2915,18247,0.00946122,0.216212,-0.976301,0
2596,1602,15,185,1705,22,90,6215,2170,8385,-0.0140547,0.138965,-0.990198,0
1603,1142,11,128,1095,18,73,4070,2006,6076,-0.00354721,0.114087,-0.993464,0
2110,1498,13,175,1474,27,100,5397,1296,6693,0.00833597,0.182538,-0.983163,0
4663,3446,25,376,3341,47,216,12114,1947,14061,-0.00602545,0.255398,-0.966817,0
4645,3692,30,474,3545,49,214,12649,1492,14141,-0.0114037,0.286585,-0.957987,0
2430,1886,15,233,1845,19,131,6559,1068,7627,-0.00949328,0.287427,-0.957755,0
5007,4039,25,530,4168,59,254,14082,1980,16062,-0.0297291,0.30686,-0.95129,0
3423,2730,21,302,2723,50,203,9452,1672,11124,-0.0161479,0.287735,-0.957574,0
5230,4223,31,494,4191,51,287,14507,1803,16310,-0.0274199,0.380905,-0.924208,0
2578,2105,17,240,2064,24,137,7165,1272,8437,0.0040247,0.322255,-0.946644,0
5086,4544,32,508,4108,56,288,14622,1602,16224,0.0157017,0.298203,-0.954373,0
5028,4072,31,485,3960,51,312,13939,2010,15949,0.0213936,0.288088,-0.957365,0
3434,2599,22,309,2554,32,201,9151,1386,10537,0.0241736,0.268577,-0.962955,0
5232,3593,35,445,3509,58,257,13129,2129,15258,-0.0306142,0.375119,-0.926471,0
2683,1482,15,201,1464,26,105,5976,1046,7022,-0.020838,0.308696,-0.950933,0
2336,1141,16,213,1093,14,71,4884,922,5806,-0.0193255,0.263983,-0.964334,0
2220,1502,13,172,1478,17,94,5496,1401,6897,-0.0139401,0.262867,-0.964731,0
5226,3188,29,369,3190,39,208,12249,1741,13990,-0.032588,0.267407,-0.963032,0
2647,1605,15,185,1584,22,104,6162,1535,7697,-0.0515559,0.220155,-0.974101,0
3828,2023,22,239,2027,26,135,8300,2748,11048,0.0202134,0.21066,-0.97735,0
5516,2440,36,379,2468,37,186,11062,2782,13844,0.0259361,0.181167,-0.98311,0
5131,2301,29,297,2175,40,170,10143,2943,13086,0.0431391,0.243386,-0.96897,0
3272,949,13,135,923,20,80,5392,1722,7114,0.046866,0.199327,-0.978812,0
1571,661,12,94,652,15,51,3056,1365,4421,0.0357642,0.221866,-0.974421,0
2240,891,12,137,853,16,73,4222,2815,7037,0.0229857,0.176145,-0.984096,0
5394,2016,39,326,2041,44,168,10028,3389,13417,0.0168977,0.19493,-0.980672,0
2638,905,15,140,872,24,76,4670,2885,7555,0.0284338,0.176531,-0.983884,0
3155,1015,18,149,982,29,88,5436,2179,7615,0.0280666,0.167268,-0.985512,0
3973,1298,23,172,1425,37,101,7029,3344,10373,0.0144861,0.192963,-0.981099,0
4762,1686,27,218,1640,40,117,8490,3287,11777,0.00734112,0.163966,-0.986439,0
3206,1203,19,154,1179,30,85,5876,2227,8103,0.00169902,0.172152,-0.985069,0
4856,1898,28,240,1896,40,130,9088,3121,12209,0.025022,0.149717,-0.988412,0
4857,2065,31,254,1980,36,153,9376,2616,11992,0.0309615,0.17187,-0.984633,0
2555,1159,15,144,1159,23,78,5133,1758,6891,0.0439059,0.135884,-0.989751,0
4926,2544,30,302,2483,43,186,10514,3502,14016,0.0253397,0.186136,-0.982197,0
3562,1845,37,229,1738,42,125,7578,2000,9578,0.0408267,0.194564,-0.98004,0
3490,2083,19,330,1954,25,146,8047,2288,10335,0.0387545,0.136381,-0.989898,0
3596,2177,20,273,2231,46,155,8498,2142,10640,0.0283845,0.137245,-0.99013,0
4778,3054,29,337,2901,35,191,11325,2804,14129,0.0264468,0.160306,-0.986713,0
3444,2261,19,278,2217,27,140,8386,1967,10353,-0.0245687,0.137329,-0.990221,0
4903,3321,31,399,3287,42,232,12215,2296,14511,0.0154065,0.124517,-0.992098,0
5376,4001,30,476,3939,41,306,14169,2602,16771,0.00818657,0.187484,-0.982234,0
3744,2809,26,312,2699,51,179,9820,2262,12082,-0.00755332,0.207782,-0.978146,0
2795,1862,17,210,1842,36,121,6883,1170,8053,-0.00602516,0.125388,-0.992089,0
1848,1539,12,192,1500,15,101,5207,1350,6557,-0.0264639,0.114673,-0.993051,0
6343,5259,38,660,4368,52,227,16947,1927,18874,0.0521855,0.152335,-0.98695,0
3194,2366,15,273,2322,27,157,8354,1361,9715,0.0107397,0.142578,-0.989725,0
2346,1684,12,206,2268,44,155,6715,1389,8104,-0.0154547,0.00903818,-0.99984,0
4010,2622,19,330,2560,34,189,9764,1866,11630,-0.0254199,0.0224151,-0.999426,0
2703,1541,16,176,1472,21,107,6036,1290,7326,-0.00657214,-0.0571264,-0.998345,0
4537,3285,27,433,3252,38,190,11762,3471,15233,-0.0267458,0.010484,-0.999587,0
4887,3011,26,372,2958,52,226,11532,2421,13953,-0.0240301,-0.0331742,-0.999161,0
2664,1587,15,198,1562,29,123,6178,2578,8756,0.00537423,-0.0190688,-0.999804,0
5568,3164,26,373,3368,53,223,12775,3682,16457,0.00156234,0.0135735,-0.999907,0
3535,1975,15,219,1783,32,129,7688,1742,9430,-0.0420787,-0.0604162,-0.997286,0
5962,3463,29,388,3347,43,257,13489,5084,18573,-0.014746,0.0660981,-0.997704,0
2794,1500,19,167,1755,25,115,6375,1590,7965,-0.019204,-0.00611274,-0.999797,0
1486,837,8,92,808,14,52,3297,962,4259,-0.0302791,-0.0651857,-0.997414,0
1696,1051,16,133,1034,13,69,4012,1476,5488,-0.0231203,-0.00264694,-0.999729,0
5431,3355,26,399,3265,41,206,12723,3378,16101,-0.0106193,0.0460295,-0.998884,0
3391,2288,18,286,2294,35,146,8458,2180,10638,-0.024316,-0.0101391,-0.999653,0
3167,2067,17,236,2042,24,134,7687,2313,10000,-0.0143162,0.016115,-0.999768,0
3891,2726,20,305,2643,31,178,9794,2225,12019,-0.0425073,-0.0149446,-0.998984,0
5299,3741,27,572,5097,55,323,15114,2073,17187,-0.0139627,0.207088,-0.978223,0
3441,1995,13,264,2013,20,140,7886,1540,9426,-0.0058103,0.140078,-0.990123,0
1496,1124,8,124,1024,12,74,3862,657,4519,-0.0139483,0.102396,-0.994646,0
5301,3483,23,427,3444,42,254,12974,1412,14386,-0.00945482,0.136424,-0.990605,0
5118,3451,17,323,2586,39,188,11722,1628,13350,-0.0194228,0.16674,-0.98581,0
4934,3770,25,501,3643,64,241,13178,2394,15572,0.00558973,0.349106,-0.937066,0
3380,2554,19,287,2574,27,126,8967,1196,10163,0.00648907,0.289794,-0.957067,0
1915,1261,18,141,1210,15,80,4640,735,5375,0.00394176,0.205906,-0.978564,0
1463,1038,8,116,1022,13,67,3727,691,4418,0.0105952,0.197407,-0.980264,0
3468,2596,19,346,2744,33,171,9377,1727,11104,-0.0149035,0.178917,-0.983751,0
4876,3513,26,438,3577,41,249,12720,1790,14510,0.0423655,0.168671,-0.984761,0
3344,2379,17,267,2137,37,117,8298,1337,9635,0.023505,0.220752,-0.975047,0
2541,1791,15,196,1750,34,112,6439,1212,7651,0.041881,0.220692,-0.974444,0
4574,3359,30,428,3282,63,243,11979,2048,14027,0.0150241,0.0827933,-0.996453,0
3196,2236,21,281,2268,39,152,8193,1757,9950,0.0721523,0.119331,-0.990229,0
6146,3462,33,432,2462,41,169,12745,1445,14190,0.0659682,0.0886838,-0.993873,0
2115,1418,15,191,1353,26,95,5213,1250,6463,0.041908,0.0515791,-0.997789,0
4784,2932,29,363,2893,41,190,11232,2734,13966,0.0240688,0.0529276,-0.998308,0
3158,2089,22,245,2089,51,138,7792,1589,9381,0.0384989,0.0714173,-0.996703,0
5054,3408,34,396,3247,57,221,12417,2002,14419,0.0521236,0.0720865,-0.996035,0
3220,2222,22,260,2219,38,151,8132,1566,9698,0.0620213,0.039767,-0.997282,0
5209,3539,32,462,3512,46,279,13079,2499,15578,0.0454721,0.0642298,-0.996899,0
3234,2302,21,306,2317,33,178,8391,2083,10474,0.0405962,0.0167905,-0.999035,0
5271,3665,38,439,3319,47,209,12988,2786,15774,0.0319053,0.0836485,-0.995984,0
3842,2228,26,270,2217,43,153,8779,2034,10813,0.0425655,0.10047,-0.994029,0
2489,1795,20,222,1693,43,143,6405,1429,7834,0.0668634,0.00955967,-0.997716,0
4932,3254,30,394,3185,38,236,12069,1853,13922,0.0291655,0.0116552,-0.999507,0
2548,1726,16,201,1702,24,113,6330,1595,7925,0.0483915,-0.00890211,-0.998789,0
4826,3087,30,367,3046,46,203,11605,2366,13971,0.0653243,0.0211384,-0.99764,0
2508,1711,17,214,1703,26,127,6306,1602,7908,0.0794826,0.000711078,-0.996836,0
5050,3181,30,414,3100,46,233,12054,1785,13839,0.0489499,0.090304,-0.994711,0
4842,3104,31,383,2975,46,192,11573,2325,13898,0.0335791,0.0727743,-0.996783,0
2042,1365,14,181,1326,21,104,5053,1352,6405,0.0585558,0.0982712,-0.993435,0
4626,3070,33,414,2974,65,230,11412,3528,14940,0.0405814,0.101151,-0.994043,0
4597,3135,31,401,3294,48,172,11678,2124,13802,0.072471,-0.00328858,-0.997365,0
2516,1615,18,225,1590,29,124,6117,1753,7870,0.0742475,0.00047591,-0.99724,0
4640,2910,30,340,2775,50,222,10967,3823,14790,0.068392,-0.0164711,-0.997523,0
3295,2044,21,258,2073,29,139,7859,2530,10389,0.0536562,-0.0423853,-0.99766,0
3327,2150,22,247,2078,42,138,8004,1727,9731,0.0526171,0.00149495,-0.998614,0
3040,1895,20,258,1922,31,147,7313,2545,9858,0.0668273,-0.0156497,-0.997642,0
4888,3205,36,337,2955,54,191,11666,1633,13299,0.0442685,-0.0360866,-0.998368,0
3212,2359,24,287,1966,33,139,8020,2251,10271,0.00604823,-0.0214575,-0.999751,0
4540,2755,31,346,2842,63,188,10765,2496,13261,0.0745431,-0.00508878,-0.997205,0
2591,1626,17,191,1583,36,111,6155,1629,7784,0.0523424,-0.00607593,-0.998611,0
4925,3202,37,440,2946,56,249,11855,3003,14858,0.0936714,0.0370366,-0.994914,0
4656,3122,30,350,2877,61,188,11284,2194,13478,0.108338,0.0302498,-0.993654,0
2543,1549,17,185,1694,39,158,6185,1655,7840,0.0851006,-0.00266193,-0.996369,0
4072,3240,34,379,3082,46,215,11068,3459,14527,0.0846211,0.00703021,-0.996388,0
4723,2939,53,452,2924,58,242,11391,1954,13345,0.0757917,-0.0138322,-0.997028,0
2517,1597,17,208,1573,24,122,6058,1948,8006,0.0650666,0.00572895,-0.997864,0
3762,2356,24,291,2423,44,176,9076,2594,11670,0.082182,-0.0158304,-0.996492,0
3791,2372,27,291,2313,38,184,9016,2421,11437,0.0851457,0.0163107,-0.996235,0
3498,2334,23,340,2245,38,149,8627,3219,11846,0.0374109,-0.0306582,-0.99883,0
3496,2192,24,317,2192,33,182,8436,2511,10947,0.00920615,-0.00222096,-0.999955,0
4065,2669,28,306,2505,54,173,9800,2773,12573,0.0362423,0.0262225,-0.998999,0
4328,2573,26,322,2606,85,257,10197,2240,12437,0.120626,0.00478311,-0.992687,0
3025,1936,20,232,1893,48,152,7306,1949,9255,0.0864637,0.00743421,-0.996227,0
5139,3109,32,336,2997,42,186,11841,2119,13960,0.0889363,-0.0115939,-0.99597,0
5104,3202,34,391,3118,65,234,12148,3082,15230,0.0765228,0.0395185,-0.996284,0
2879,1732,23,253,1386,28,118,6419,1536,7955,0.0440797,0.00423008,-0.999019,0
1535,928,10,107,843,15,57,3495,932,4427,0.0369786,0.0785706,-0.996222,0
4976,3333,33,389,3083,40,213,12067,2777,14844,0.11314,0.00544803,-0.993564,0
2769,1731,19,249,1678,31,132,6609,1738,8347,0.0611906,-0.0093226,-0.998083,0
5237,3274,41,401,3164,50,214,12381,2361,14742,0.091784,0.00954876,-0.995733,0
3466,2217,24,282,2266,44,180,8479,1836,10315,0.0342929,0.0900076,-0.995351,0
3492,2262,26,303,2569,46,165,8863,2570,11433,0.0461377,0.000419979,-0.998935,0
3507,2232,24,299,2179,35,170,8446,2608,11054,0.0695031,0.00236514,-0.997579,0
4951,2958,36,380,2791,74,200,11390,2433,13823,0.0489371,-0.0149803,-0.99869,0
2504,1551,20,227,1547,35,112,5996,1907,7903,0.0574378,-0.0128418,-0.998266,0
4785,2974,37,357,2823,63,207,11246,2842,14088,0.0657657,-0.0129513,-0.997751,0
3208,2076,26,294,2000,40,163,7807,2671,10478,0.0966906,0.0189505,-0.995134,0
4136,2622,27,315,2768,55,175,10098,2773,12871,0.0834986,0.0300734,-0.996054,0
5054,2686,29,346,2811,45,200,11171,2010,13181,0.101771,0.0111922,-0.994745,0
2435,1540,17,209,1510,20,111,5842,1944,7786,0.0577592,0.103395,-0.992962,0
3482,2222,26,280,2669,32,170,8881,1974,10855,0.0499686,-0.00688222,-0.998727,0
3577,2344,24,283,2148,36,146,8558,2242,10800,0.0923193,0.00331282,-0.995724,0
5235,3209,34,343,3032,56,200,12109,1961,14070,0.0611363,-0.0151686,-0.998014,0
2508,1577,18,187,1580,26,126,6022,1687,7709,0.0464099,-0.0234981,-0.998646,0
4577,2856,31,386,2750,42,192,10834,3032,13866,0.0463816,-0.00786158,-0.998893,0
4668,2907,30,393,2925,44,199,11166,2173,13339,0.0929068,0.018182,-0.995509,0
2520,1638,17,215,1587,28,106,6111,1642,7753,0.064866,-0.0253962,-0.997571,0
5059,3185,31,366,2855,50,199,11745,2824,14569,0.0918299,-0.0103508,-0.995721,0
3307,2046,20,245,2027,41,135,7821,1632,9453,0.0212503,0.0225902,-0.999519,0
2467,1521,16,198,1532,38,118,5890,1858,7748,0.0779125,-0.00176734,-0.996959,0
5236,3278,57,491,3122,52,211,12447,3008,15455,0.0699139,-0.0182478,-0.997386,0
3669,2321,25,282,2113,37,145,8592,2015,10607,0.0943866,0.0205643,-0.995323,0
4846,2951,30,406,2926,54,208,11421,2745,14166,0.0321411,0.0932334,-0.995125,0
2503,1607,17,207,1457,28,98,5917,1604,7521,0.113396,0.0295289,-0.993111,0
1565,944,11,111,956,16,63,3666,967,4633,0.0242105,-0.0156069,-0.999585,0
2921,1953,20,231,1903,32,161,7221,2161,9382,0.042589,0.042588,-0.998185,0
4787,2910,29,387,2829,49,211,11202,2992,14194,0.0881983,0.0218534,-0.995863,0
4563,2950,38,386,2844,70,242,11093,1913,13006,0.0375069,0.00563106,-0.999281,0
2498,1617,17,190,1557,32,104,6015,1599,7614,0.0229606,0.00754963,-0.999708,0
5366,3278,42,468,3285,97,306,12842,2641,15483,0.0465106,0.0710401,-0.996389,0
2663,1684,18,198,1702,45,133,6443,2408,8851,0.107374,0.000848684,-0.994218,0
3289,2024,23,272,2012,46,142,7808,2226,10034,0.0933606,0.0279802,-0.995239,0
4146,2600,34,360,2490,46,185,9861,2577,12438,0.0626318,-0.0117671,-0.997967,0
2978,1881,25,232,1862,40,132,7150,2049,9199,0.0663861,0.0205077,-0.997583,0
5073,3231,40,358,3116,51,213,12082,1850,13932,0.0496613,-0.022835,-0.998505,0
3225,2049,22,274,2019,37,171,7797,1892,9689,0.0768583,0.0035848,-0.997036,0
5043,3287,33,450,3021,51,217,12102,2285,14387,0.0884491,0.0283127,-0.995678,0
2649,2303,23,310,1940,25,140,7390,1875,9265,0.0549143,0.08063,-0.99523,0
2700,1717,18,217,1668,28,125,6473,1965,8438,0.00099208,0.0612265,-0.998123,0
2659,1749,22,301,2428,42,161,7362,1666,9028,0.0591009,0.000286374,-0.998252,0
5227,3261,30,343,3080,59,192,12192,2451,14643,0.0659671,-0.0174363,-0.997669,0
5170,3112,29,421,2633,57,148,11570,1548,13118,0.0491473,0.0824729,-0.995381,0
2071,1299,16,160,1267,30,91,4934,1542,6476,0.0574875,-0.0308111,-0.997871,0
3413,2248,22,291,2247,46,165,8432,2087,10519,0.0771695,0.0041428,-0.997009,0
5037,3178,34,388,3096,64,240,12037,2574,14611,0.089839,0.0242544,-0.995661,0
3545,2248,22,284,2228,34,150,8511,2277,10788,0.0580702,-0.0303552,-0.997851,0
5069,3364,36,495,3217,49,215,12445,1954,14399,0.0467189,0.101669,-0.993721,0
2695,1933,18,211,1683,22,176,6738,1418,8156,0.0504437,0.0868789,-0.994941,0
4767,2996,30,434,2909,52,235,11423,2506,13929,0.0891425,0.0254093,-0.995695,0
4695,2934,51,393,2976,42,193,11284,2200,13484,0.053568,-0.00657548,-0.998543,0
2545,1608,16,211,1553,29,105,6067,1692,7759,0.0500623,0.105419,-0.993167,0
3584,1930,20,227,1870,34,137,7802,2173,9975,0.0355186,0.0863298,-0.995633,0
3866,2508,25,330,2431,61,182,9403,2306,11709,0.0427516,0.0994176,-0.994127,0
3720,2346,28,323,2783,64,177,9441,2539,11980,0.0316409,-0.0151314,-0.999385,0
2825,1842,21,237,1803,26,154,6908,2296,9204,0.0634339,-0.0173208,-0.997836,0
5317,3060,32,373,3147,43,191,12163,2823,14986,0.0365007,0.0884186,-0.995414,0
2813,2185,21,210,1580,23,119,6951,1882,8833,0.0607628,-0.00740635,-0.998125,0
2605,1589,18,243,1593,29,117,6194,1555,7749,0.0773821,0.00228636,-0.996999,0
4843,2442,25,330,2442,76,193,10351,2067,12418,0.0535388,0.0943536,-0.994098,0
3821,2694,25,374,2356,34,161,9465,2198,11663,0.0225752,-0.0185672,-0.999573,0
2917,1770,20,285,1785,49,151,6977,1838,8815,0.0624476,-0.00433013,-0.998039,0
3562,2254,23,302,2147,41,172,8501,3453,11954,0.068271,-0.00494931,-0.997655,0
4558,2896,31,385,2873,55,229,11027,2313,13340,0.0459204,0.00121438,-0.998944,0
2531,1620,17,212,1558,24,124,6086,1853,7939,0.030253,-0.00280927,-0.999538,0
5088,3083,33,456,2837,38,213,11748,3016,14764,0.0483597,0.00054502,-0.99883,0
3275,2136,23,280,2012,50,171,7947,1431,9378,0.014282,0.000936437,-0.999898,0
3757,2451,40,297,2329,56,168,9098,2310,11408,0.0898402,0.0103585,-0.995902,0
4713,2857,32,354,2982,59,214,11211,3256,14467,0.0358187,0.00554048,-0.999343,0
4577,2874,30,370,3197,59,227,11334,1938,13272,0.0330028,0.00990421,-0.999406,0
2552,1585,17,207,1548,23,105,6037,1533,7570,0.0645625,0.00692696,-0.99789,0
4592,3147,34,343,2822,48,209,11195,2870,14065,0.0618945,-0.0349822,-0.997469,0
4485,3002,37,403,2873,65,218,11083,2978,14061,0.0393424,0.0861358,-0.995506,0
3221,2106,26,292,2072,35,156,7908,2562,10470,0.0564615,0.033956,-0.997827,1
4146,2820,76,399,2674,41,217,10373,2351,12724,0.0864994,0.00953736,-0.996206,1
4721,2971,30,407,2831,36,158,11154,2181,13335,0.0958674,0.00709696,-0.995369,1
2512,1614,18,209,1607,32,123,6115,1662,7777,0.109689,0.00360513,-0.993959,1
5232,3218,31,408,3093,52,217,12251,4036,16287,0.0240721,0.00169773,-0.999709,1
3227,2040,22,242,2027,42,137,7737,1843,9580,0.0621659,0.00505923,-0.998053,1
3785,2450,26,299,2518,37,260,9375,2646,12021,0.0751458,-0.0120512,-0.9971,1
4438,2479,33,323,2418,48,173,9912,2676,12588,0.0474108,0.0904477,-0.994772,1
2850,1748,19,258,1752,32,134,6793,2322,9115,0.0702665,0.0218356,-0.997289,1
3611,1849,19,186,1456,28,111,7260,1413,8673,0.0652126,-0.0224395,-0.997619,1
3220,1989,21,243,2023,35,133,7664,1930,9594,0.0118511,0.00867094,-0.999892,1
5147,3328,35,395,3134,49,215,12303,2542,14845,0.0685365,0.00962077,-0.997602,1
2657,1660,19,202,1730,36,114,6418,1850,8268,0.0804689,0.0380828,-0.996029,1
4181,2660,29,312,2506,57,173,9918,3297,13215,0.0990349,0.00791095,-0.995053,1
3491,2014,21,251,1915,44,134,7870,2129,9999,0.0566095,0.0872136,-0.99458,1
2859,1754,19,220,1766,29,119,6766,1672,8438,0.016403,0.00747644,-0.999838,1
4628,2819,30,340,2730,55,194,10796,2661,13457,0.0515877,0.0893367,-0.994665,1
4695,3042,30,356,2820,53,196,11192,2168,13360,0.119206,0.0274082,-0.992491,1
2512,1555,18,193,1600,28,107,6013,1570,7583,0.0972564,-0.000702149,-0.995259,1
4561,2802,30,339,2899,54,195,10880,3092,13972,0.090693,0.0077389,-0.995849,1
5081,2890,29,389,2404,30,161,10984,2152,13136,0.0529129,-0.020246,-0.998394,1
2624,1624,18,216,1577,43,121,6223,1488,7711,0.0879743,0.0140248,-0.996024,1
5053,3743,71,472,3169,62,214,12784,3039,15823,0.0368196,-0.0109529,-0.999262,1
3249,2098,21,241,2052,42,163,7866,1824,9690,0.0504087,-0.0190846,-0.998546,1
4642,2937,37,352,2795,67,219,11049,2158,13207,0.071066,-0.00443808,-0.997462,1
2632,1591,22,199,1585,34,125,6188,2104,8292,0.0395536,0.0496424,-0.997984,1
3581,1918,24,236,1905,42,137,7843,1706,9549,0.107038,0.00630051,-0.994235,1
4711,2860,38,403,2762,75,200,11049,3235,14284,0.0501267,0.0133789,-0.998653,1
3254,2095,26,255,1994,42,143,7809,2398,10207,0.0426475,-0.00722773,-0.999064,1
3104,1919,20,234,1909,37,130,7353,2048,9401,0.0465437,0.00127549,-0.998915,1
5039,3237,46,386,3067,69,234,12078,2999,15077,0.0399007,0.0695785,-0.996778,1
3215,2069,28,301,2038,47,145,7843,1951,9794,0.0702879,0.00695807,-0.997502,1
3235,2084,26,251,2009,37,136,7778,2224,10002,0.0313262,0.0098933,-0.99946,1
5154,3273,38,380,3029,68,202,12144,2278,14422,0.0410638,0.0553531,-0.997622,1
2647,1679,22,226,1664,37,131,6406,1690,8096,0.0420702,-0.00490915,-0.999103,1
4114,2640,48,323,2711,55,221,10112,2587,12699,0.051009,0.00721542,-0.998672,1
4461,2667,34,379,2567,64,211,10383,2649,13032,0.0675327,0.00158081,-0.997716,1
3005,1975,20,251,1982,37,134,7404,1691,9095,0.0853673,0.0169804,-0.996205,1
4807,2957,31,380,2903,62,218,11358,2659,14017,0.0311762,0.0840457,-0.995974,1
3176,2010,22,282,2059,42,158,7749,2176,9925,0.02797,-0.00644801,-0.999588,1
3031,1984,21,256,1967,58,146,7463,2187,9650,0.101839,0.0166946,-0.994661,1
4507,3277,35,344,2797,66,243,11269,3077,14346,0.0595104,-0.0151275,-0.998113,1
4713,2949,31,396,2864,60,218,11231,2814,14045,0.0532623,0.0983672,-0.993724,1
3266,2047,21,285,2058,40,160,7877,2162,10039,0.0400373,-0.0136052,-0.999106,1
5010,3205,34,341,2944,51,197,11782,2936,14718,0.0627261,0.0878037,-0.994161,1
3717,2239,23,261,2185,41,154,8620,1816,10436,0.0825929,0.0127778,-0.996501,1
3279,2008,21,242,2001,43,136,7730,2109,9839,0.0528277,0.0020045,-0.998602,1
4542,2926,32,339,2843,46,191,10919,2710,13629,0.0407257,-0.00917598,-0.999128,1
3343,2015,23,245,2019,37,154,7836,2199,10035,0.047591,0.0027288,-0.998863,1
3385,2037,22,275,2028,40,156,7943,1405,9348,0.0548413,-0.0251309,-0.998179,1
2513,1662,17,227,1566,26,125,6136,1324,7460,0.0482163,-0.0189276,-0.998658,1
5189,4468,43,588,3659,71,243,14261,2317,16578,0.040915,0.108478,-0.993256,1
2582,1616,17,222,1605,23,118,6183,1650,7833,0.0450908,-0.0239319,-0.998696,1
3017,1964,24,256,2126,36,201,7624,1876,9500,0.0460964,0.0869433,-0.995146,1
4534,3023,30,350,2878,62,194,11071,2746,13817,0.0671559,-0.0118189,-0.997672,1
4767,3409,30,411,2905,43,166,11731,2227,13958,0.053392,-0.0200591,-0.998372,1
6045,3606,37,426,3469,79,251,13913,2438,16351,0.0360461,-0.00353592,-0.999344,1
2337,1425,13,186,1397,23,107,5488,1864,7352,0.0971372,-0.00106805,-0.99527,1
1355,945,10,119,887,16,68,3400,853,4253,0.0545423,-0.03667,-0.997838,1
4688,3178,29,364,3019,46,227,11551,2704,14255,0.0632712,0.00171433,-0.997995,1
3987,2266,20,290,2180,41,158,8942,2460,11402,0.10387,0.0186314,-0.994416,1
2549,1706,16,222,1731,32,124,6380,1331,7711,0.0519836,-0.0255825,-0.99832,1
5246,3249,28,357,2944,53,202,12079,3257,15336,0.0447955,0.0840919,-0.995451,1
4506,3128,43,381,2970,60,207,11295,1814,13109,0.0457589,-0.00689324,-0.998929,1
5040,3425,32,456,3432,62,246,12693,2158,14851,0.0756061,-0.000518119,-0.997138,1
2494,1754,17,225,1676,25,113,6304,1920,8224,0.0188926,0.0048861,-0.99981,1
4769,3135,30,396,3051,41,211,11633,2407,14040,0.0336338,0.0399233,-0.998637,1
3362,2312,22,299,2256,42,182,8475,2021,10496,0.0504555,0.109317,-0.992726,1
4659,3223,28,421,3106,62,245,11744,2601,14345,0.0854035,0.0489943,-0.995141,1
3677,2372,21,337,2280,32,172,8891,1968,10859,0.088631,0.0655005,-0.993909,1
3203,2116,20,247,2066,31,139,7822,2310,10132,0.0898049,0.0344048,-0.995365,1
5388,3669,31,435,3504,36,270,13333,2999,16332,0.0557753,0.189011,-0.98039,1
2633,1988,15,257,1966,19,182,7060,1188,8248,0.0618411,0.172789,-0.983016,1
2043,1528,15,182,1471,15,94,5348,1337,6685,0.0527905,0.156814,-0.986216,1
4986,3504,27,420,3625,32,217,12811,2695,15506,0.0522044,0.0958177,-0.994029,1
4723,3432,27,398,2828,22,150,11580,2421,14001,0.0253788,0.0526666,-0.99829,1
4768,3477,27,382,3497,38,225,12414,2722,15136,0.0418994,0.0476474,-0.997985,1
2605,1868,14,212,1837,19,119,6674,2206,8880,0.0663459,-0.00757459,-0.997768,1
3142,2276,18,261,2250,24,150,8121,2079,10200,0.0416275,-0.0103254,-0.99908,1
5247,3509,39,484,3404,46,222,12951,2883,15834,0.0565868,-0.029215,-0.99797,1
3294,2362,18,303,2419,27,150,8573,1938,10511,0.0470547,-0.027025,-0.998527,1
4348,2951,24,344,2890,34,230,10821,3117,13938,0.0308088,0.0142618,-0.999424,1
3102,2183,19,282,2174,33,158,7951,1962,9913,0.0180224,-0.00285867,-0.999833,1
5274,3573,27,423,3459,51,232,13039,2058,15097,0.0308157,0.0930179,-0.995187,1
4554,3296,25,265,2193,48,138,10519,1759,12278,0.0311511,0.05013,-0.998257,1
2038,1322,14,160,1247,16,97,4894,1498,6392,0.0412276,0.0460209,-0.998089,1
6045,3240,34,442,2960,51,204,12976,3181,16157,0.0445329,0.0882639,-0.995101,1
3351,1744,19,214,1869,30,135,7362,3416,10778,0.0427898,0.0548393,-0.997578,1
2231,1083,14,150,1107,18,84,4687,1957,6644,0.046439,0.0560082,-0.99735,1
4667,2156,27,265,2208,36,148,9507,3879,13386,0.0403919,0.110394,-0.993067,1
3410,1451,22,184,1508,26,97,6698,1844,8542,0.0376909,0.115883,-0.992547,1
5201,2368,34,323,2259,59,164,10408,2779,13187,0.0293762,0.113206,-0.993137,1
3279,1465,23,209,1425,28,140,6569,1566,8135,0.0163138,0.14899,-0.988704,1
3766,2003,21,231,1890,28,126,8065,1898,9963,0.036346,0.153455,-0.987487,1
5002,2853,34,387,2643,46,192,11157,2044,13201,0.0184239,0.129341,-0.991429,1
3830,1792,18,232,1787,38,147,7844,1642,9486,0.0252694,0.130545,-0.99112,1
4624,3027,34,462,2986,33,176,11342,2878,14220,0.0460905,0.0623023,-0.996993,1
4651,2968,26,329,2764,32,185,10955,1730,12685,0.0497447,0.0868626,-0.994978,1
2552,1715,13,192,1681,23,109,6285,1420,7705,0.0340513,0.0701819,-0.996953,1
5322,3599,28,423,3411,32,229,13044,2565,15609,0.0281462,0.0263709,-0.999256,1
3741,2496,18,305,2385,26,159,9130,1682,10812,0.0582785,-0.0717005,-0.995722,1
3871,2769,20,349,2706,34,202,9951,1953,11904,0.0158183,0.000700937,-0.999875,1
4058,2754,21,301,2700,27,171,10032,1852,11884,0.037749,-0.021414,-0.999058,1
4615,3327,34,386,3270,40,222,11894,2665,14559,0.0506043,0.0616325,-0.996815,1
5179,3970,42,480,3938,64,298,13971,2387,16358,0.0316752,0.0847518,-0.995898,1
2778,1979,14,234,1810,15,105,6935,1355,8290,0.0330606,0.120813,-0.992125,1
1675,1237,9,143,1218,12,75,4369,946,5315,0.000466507,0.0707564,-0.997494,1
3304,2145,14,260,2121,20,135,7999,1841,9840,0.0339916,0.078784,-0.996312,1
4712,3939,26,423,4401,67,307,13875,2786,16661,-0.0226695,0.110879,-0.993575,1
3489,3008,18,317,3011,28,180,10051,3109,13160,-0.00513047,0.0444841,-0.998997,1
3115,2607,14,305,2488,29,165,8723,1765,10488,0.0132142,0.0461973,-0.998845,1
5946,5190,35,551,4621,53,218,16614,2136,18750,0.0153355,-0.00930488,-0.999839,1
2681,2198,13,259,2156,22,135,7464,1173,8637,0.0321317,-0.0293608,-0.999052,1
3760,2996,20,355,2886,55,211,10283,2693,12976,0.011555,0.00553599,-0.999918,1
3771,2914,16,349,2855,35,180,10120,1647,11767,-0.00361306,-0.0607264,-0.998148,1
4329,3340,27,434,3261,42,228,11661,2298,13959,-0.0350242,-0.098063,-0.994564,1
5634,4259,23,481,4312,87,407,15203,2579,17782,0.0125813,-0.0913129,-0.995743,1
6056,4339,19,364,3113,33,207,14131,1312,15443,0.0389621,-0.121701,-0.991802,1
2521,1855,15,215,1854,24,124,6608,1309,7917,0.00324452,-0.141633,-0.989914,1
5939,4420,31,473,4218,40,241,15362,2027,17389,-0.00453496,-0.145503,-0.989347,1
2894,2031,16,226,2071,21,137,7396,1625,9021,-0.0285122,-0.136374,-0.990247,1
5919,3858,30,454,3834,53,254,14402,2135,16537,-0.0344787,-0.138641,-0.989742,1
3981,2718,19,291,2645,39,166,9859,2006,11865,-0.0203884,-0.109354,-0.993794,1
2443,1550,13,176,1526,30,110,5848,1349,7197,-0.0307664,-0.075196,-0.996694,1
5136,3226,28,403,3162,42,241,12238,2569,14807,-0.00054654,-0.0583907,-0.998294,1
3580,2340,22,277,2265,40,172,8696,2854,11550,-0.00375835,-0.0983812,-0.995142,1
2743,1812,18,211,1832,29,147,6792,1481,8273,0.00140624,-0.0340834,-0.999418,1
5125,3370,27,432,3428,40,287,12709,3129,15838,0.00640726,-0.0727625,-0.997329,1
2697,1913,22,241,1866,21,138,6898,1373,8271,-0.00501066,-0.0337222,-0.999419,1
4772,3572,25,437,3379,44,259,12488,2009,14497,-0.0241115,-0.00970949,-0.999662,1
3360,2396,17,276,2431,26,154,8660,2199,10859,-0.0200465,-0.0384984,-0.999058,1
5220,3872,24,435,3984,69,249,13853,2231,16084,-0.0494849,0.0161335,-0.998645,1
2648,2044,13,234,2037,27,156,7159,1479,8638,-0.0131075,0.0611001,-0.998046,1
3173,2450,15,279,2522,26,192,8657,1581,10238,-0.00639409,0.0496439,-0.998747,1
4819,3750,23,397,3890,37,240,13156,1675,14831,0.000318365,0.0660996,-0.997813,1
2744,2079,14,222,2145,20,129,7353,1215,8568,-0.00421068,0.0494388,-0.998768,1
5099,3666,30,428,3590,56,291,13160,1663,14823,-0.0436327,0.205189,-0.977749,1
2534,1595,13,198,1556,24,114,6034,821,6855,-0.0141994,0.145779,-0.989215,1
1567,1146,10,133,1121,14,76,4067,601,4668,-0.0101602,0.109122,-0.993976,1
5124,3825,31,451,3760,77,256,13524,1543,15067,-0.00435422,0.120645,-0.992686,1
3483,2829,23,377,2817,54,206,9789,1106,10895,-0.0108584,0.064214,-0.997877,1
2191,1891,15,218,1753,28,129,6225,892,7117,-0.00969582,0.0594342,-0.998185,1
4810,3862,26,472,3827,67,301,13365,1397,14762,0.0245235,0.06511,-0.997577,1
2574,2163,18,280,2127,37,157,7356,1048,8404,0.00215382,0.0419682,-0.999117,1
5153,4336,31,550,4248,45,312,14675,1470,16145,-0.00936454,0.00910742,-0.999915,1
5277,4326,23,324,3016,69,257,13292,1188,14480,0.00491276,0.0157491,-0.999864,1
2206,1841,15,205,1805,26,118,6216,959,7175,-0.0195826,-0.0262658,-0.999463,1
5395,4503,38,513,4264,75,271,15059,1504,16563,-0.00344381,-0.0135432,-0.999902,1
3692,3141,27,353,2930,58,212,10413,1529,11942,-0.00631006,-0.0150648,-0.999867,1
3392,2759,26,331,2712,53,195,9468,1479,10947,0.0117805,0.0193787,-0.999743,1
5339,4291,38,501,4224,75,286,14754,1521,16275,-0.00770406,0.0180894,-0.999807,1
2722,2278,20,257,2236,47,208,7768,1161,8929,-0.00682159,0.0145833,-0.99987,1
5405,4260,38,505,4154,66,285,14713,1702,16415,-0.00282675,0.0330725,-0.999449,1
2804,2268,21,311,2394,45,151,7994,1202,9196,0.00667574,-0.0174019,-0.999826,1
3358,2755,24,352,2693,53,184,9419,1507,10926,-0.000326902,-0.00448447,-0.99999,1
5917,3948,27,544,3911,63,291,14701,1519,16220,0.00107862,-0.0216902,-0.999764,1
2750,2306,16,280,2225,29,161,7767,1370,9137,0.00288339,-0.0201643,-0.999793,1
5611,4877,37,583,4259,42,214,15623,1452,17075,-0.0191838,0.0273867,-0.999441,1
2782,2455,20,291,2396,30,174,8148,1367,9515,-0.0053913,-0.0231363,-0.999718,1
3278,2693,22,279,2555,32,160,9019,1711,10730,-0.0166341,-0.0266627,-0.999506,1
3869,2728,25,350,2751,41,181,9945,2848,12793,-0.00617161,0.0406201,-0.999156,1
3950,2618,30,277,2508,34,181,9598,2644,12242,-0.0107943,0.0582794,-0.998242,1
4818,2744,26,320,2935,46,182,11071,4162,15233,-0.000861937,0.0453907,-0.998969,1
3610,1829,20,225,1743,37,123,7587,2152,9739,-0.0118117,0.0593403,-0.998168,1
2134,948,15,118,904,24,68,4211,2549,6760,-0.00691252,0.0614157,-0.998088,1
5429,2017,24,235,1768,36,130,9639,4452,14091,0.0367089,0.0906014,-0.99521,1
3120,1034,21,137,978,31,79,5400,3365,8765,0.0299009,0.0259841,-0.999215,1
1911,553,15,83,539,20,45,3166,1932,5098,0.0602689,0.00923793,-0.998139,1
4711,1296,28,203,1220,45,100,7603,3624,11227,0.0663068,0.0427383,-0.996884,1
4634,1544,35,190,1438,63,107,8011,3169,11180,0.0487961,0.0238596,-0.998524,1
2948,1148,18,141,1122,26,76,5479,1840,7319,0.0642753,-0.107911,-0.992081,1
4421,1595,29,231,1563,35,120,7994,2424,10418,0.0181278,-0.0653901,-0.997695,1
3079,1341,20,164,1308,26,90,6028,1516,7544,0.0476703,-0.0506911,-0.997576,1
4690,2483,29,326,2223,29,177,9957,2310,12267,0.0466849,-0.0595168,-0.997135,1
4877,2599,30,298,2492,32,183,10511,1720,12231,0.0338046,0.00128947,-0.999428,1
2488,1476,15,191,1472,19,109,5770,1346,7116,0.0418276,-0.0685358,-0.996771,1
4411,2836,25,382,2717,38,187,10596,2597,13193,0.0457349,-0.0276184,-0.998572,1
4640,3029,25,344,2909,40,220,11207,2200,13407,0.00770553,0.0311319,-0.999486,1
3288,2250,18,281,2189,30,138,8194,1772,9966,0.00613005,0.0152569,-0.999865,1
5125,3587,25,444,3607,43,240,13071,1855,14926,-0.0345072,-0.00635151,-0.999384,1
3530,2547,21,281,2497,31,159,9066,2142,11208,-0.0176332,-0.0418951,-0.998966,1
5230,3846,24,380,3577,38,234,13329,1952,15281,0.0251504,-0.0298712,-0.999237,1
3332,2469,17,277,2511,45,156,8807,1964,10771,0.00749915,-0.0662898,-0.997772,1
3945,2989,21,350,2963,56,219,10543,2077,12620,0.011394,-0.0293014,-0.999506,1
5391,4510,28,525,4266,45,305,15070,1912,16982,0.00980662,0.108091,-0.994093,1
3448,2429,14,306,2103,22,123,8445,1227,9672,-0.00406517,0.0567389,-0.998381,1
1862,1478,9,170,1377,19,81,4996,658,5654,0.0234119,-0.00411117,-0.999717,1
2050,1582,9,188,1530,22,110,5491,849,6340,-0.00732703,-0.039932,-0.999176,1
5849,4305,23,575,4225,52,313,15342,2423,17765,-0.0156225,0.0440861,-0.998906,1
3894,3332,25,412,2928,30,215,10836,1268,12104,-0.0172192,-0.0351619,-0.999233,1
2836,2049,14,227,2054,31,177,7388,1417,8805,-0.0131793,-0.104282,-0.99446,1
4327,3027,20,334,2904,34,228,10874,1985,12859,-0.00968376,-0.0946551,-0.995463,1
6121,3449,25,405,3402,53,233,13688,1866,15554,-0.0233452,-0.0915103,-0.99553,1
2848,1891,14,216,1896,28,123,7016,1404,8420,-0.00162187,-0.10814,-0.994134,1
4283,3322,25,386,2891,32,184,11123,2228,13351,-0.0302839,-0.0728287,-0.996885,1
3188,2056,18,256,2097,24,135,7774,1838,9612,-0.0192593,-0.0856819,-0.996136,1
5074,3393,33,375,3324,56,215,12470,2643,15113,-0.00763951,-0.0648479,-0.997866,1
2780,1951,14,218,1921,23,123,7030,2131,9161,-6.72985e-05,-0.0206033,-0.999788,1
3314,2319,17,262,2352,32,153,8449,2487,10936,0.0120119,0.0232728,-0.999657,1
4054,2928,21,331,2913,36,203,10486,3180,13666,0.00300834,-0.0271531,-0.999627,1
2971,2223,15,248,2222,26,159,7864,2326,10190,-0.00482428,-0.0588047,-0.998258,1
5504,4918,33,688,4378,60,278,15859,2897,18756,-0.046632,0.0976246,-0.99413,1
2764,1721,12,183,1624,18,105,6427,1007,7434,-0.0478982,0.0183547,-0.998684,1
1432,1002,8,113,994,12,64,3625,591,4216,-0.0340709,-0.0320078,-0.998907,1
1469,1134,11,138,1125,15,75,3967,805,4772,-0.0481806,-0.0201814,-0.998635,1
4527,3299,23,374,3376,72,222,11893,2283,14176,-0.0555868,0.00822737,-0.99842,1
5119,3691,25,411,3475,76,225,13022,2348,15370,-0.0456605,0.137913,-0.989391,1
2967,1685,11,175,1491,35,103,6467,1015,7482,-0.0479452,0.0894863,-0.994833,1
1879,1037,13,120,933,16,65,4063,644,4707,-0.0366449,0.0101202,-0.999277,1
1284,940,16,111,989,14,60,3414,687,4101,-0.0295015,-0.00499972,-0.999552,1
2757,2065,15,262,2030,29,158,7316,1399,8715,-0.0160073,0.0385221,-0.99913,1
4759,3442,33,414,3368,64,269,12349,2192,14541,0.00565157,-0.0127064,-0.999903,1
3231,2450,19,302,2436,26,154,8618,1754,10372,-0.00815042,0.0245602,-0.999665,1
4608,3665,23,479,3524,61,253,12613,1983,14596,0.010035,0.0158344,-0.999824,1
3328,2652,17,330,2513,30,157,9027,1616,10643,-0.0007114,-0.00734887,-0.999973,1
5065,3805,25,466,3394,33,223,13011,2155,15166,-0.0326844,0.0474628,-0.998338,1
3314,3347,22,435,2451,26,176,9771,1524,11295,-0.0247319,0.0064793,-0.999673,1
5028,3684,29,411,3531,70,251,13004,1850,14854,-0.0434622,0.023648,-0.998775,1
3478,2482,28,293,2383,60,163,8887,1672,10559,-0.0409766,-0.00484033,-0.999148,1
4447,3299,33,371,3151,46,248,11595,1970,13565,-0.047216,0.00279394,-0.998881,1
3218,2262,22,257,2280,26,146,8211,1470,9681,-0.0275986,-0.0135616,-0.999527,1
5046,3630,34,463,3623,70,285,13151,1723,14874,-0.0291119,-0.0082705,-0.999542,1
3520,2578,21,335,2591,31,192,9268,1780,11048,-0.0522469,-0.0185752,-0.998461,1
4556,3278,38,450,3315,68,261,11966,1670,13636,-0.0583508,0.00805821,-0.998264,1
5080,3844,44,526,3772,71,266,13603,1774,15377,-0.0204902,0.00847603,-0.999754,1
2826,2113,21,255,2120,34,142,7511,1330,8841,-0.0385421,-0.0336332,-0.998691,1
4968,3791,37,504,3723,67,291,13381,2402,15783,-0.0160066,0.0125507,-0.999793,1
3512,2857,24,367,2797,30,159,9746,1302,11048,-0.0369869,0.0288852,-0.998898,1
2915,2367,20,268,2358,30,154,8112,1644,9756,-0.0244957,0.0387039,-0.99895,1
5153,4149,30,511,3763,35,224,13865,3143,17008,-0.0469741,0.0804091,-0.995654,1
5217,3061,19,303,2678,24,168,11470,1718,13188,-0.0343953,0.0361976,-0.998753,1
2162,1489,12,183,1495,16,109,5466,1537,7003,-0.0186301,-0.0257958,-0.999494,1
5026,3303,33,369,3239,37,240,12247,4228,16475,-0.00654954,0.0132846,-0.99989,1
3591,2162,23,287,2113,27,137,8340,2606,10946,-0.00460898,0.0431373,-0.999059,1
2672,1382,14,166,1366,20,90,5710,2380,8090,0.0221421,-0.0422159,-0.998863,1
5796,2586,27,352,2437,46,164,11408,3732,15140,0.0190879,0.0323846,-0.999293,1
3758,1730,20,222,1573,26,145,7474,3271,10745,-0.00901574,0.0998892,-0.994958,1
4743,1885,25,232,1811,65,161,8922,2924,11846,-0.0130062,0.06519,-0.997788,1
2542,743,13,117,734,23,68,4240,1658,5898,0.0112647,0.00859914,-0.9999,1
4740,1236,24,198,1221,31,89,7539,2615,10154,-0.00229551,0.0472508,-0.99888,1
3014,974,18,138,844,27,76,5091,2177,7268,0.0199986,0.0410356,-0.998958,1
5118,1617,29,252,1543,36,137,8732,2585,11317,0.00857806,0.0416118,-0.999097,1
3065,1172,18,175,1159,32,105,5726,1854,7580,0.0105231,0.0243036,-0.999649,1
4815,2138,29,298,1991,39,181,9491,2515,12006,-0.0110606,0.0261257,-0.999597,1
4486,2149,26,293,1992,36,176,9158,1642,10800,-0.0172367,0.0611089,-0.997982,1
2422,1303,13,151,1354,16,87,5346,1334,6680,0.000553589,0.0107726,-0.999942,1
5247,3157,27,342,3028,38,196,12035,1680,13715,0.000678471,0.0343849,-0.999408,1
3335,2223,18,278,2297,36,142,8329,1661,9990,-0.0063894,0.0177594,-0.999822,1
4264,3165,24,346,2997,61,217,11074,2082,13156,-0.0045379,0.0828949,-0.996548,1
2473,2615,16,276,2636,33,171,8220,2126,10346,-0.00769968,0.0392125,-0.999201,1
2063,1743,15,189,1741,16,108,5875,1140,7015,-0.00486768,0.027147,-0.99962,1
6314,5385,26,563,4967,54,304,17613,2396,20009,0.0827954,0.0526624,-0.995174,1
3226,2815,15,331,2791,31,193,9402,2051,11453,0.0168396,0.0115829,-0.999791,1
3752,3300,17,404,3209,27,224,10933,2229,13162,0.0259769,0.0301081,-0.999209,1
3727,3146,16,388,3178,46,230,10731,1668,12399,-0.0191751,-0.0250471,-0.999502,1
6191,4917,25,553,4177,39,231,16133,2080,18213,-0.041273,-0.0960085,-0.994524,1
2953,2428,13,253,2433,34,168,8282,2951,11233,-0.0429581,-0.11664,-0.992245,1
2768,2183,14,275,2176,29,151,7596,1783,9379,-0.0377213,-0.0958938,-0.994677,1
4028,3176,20,350,3066,40,205,10885,2094,12979,-0.0272635,-0.0735068,-0.996922,1
3131,3189,20,311,2335,30,155,9171,1738,10909,-0.0330937,-0.102692,-0.994163,1
2973,2367,16,286,2353,31,151,8177,1706,9883,-0.042039,-0.0327805,-0.998578,1
3682,2773,21,297,2710,36,173,9692,3691,13383,-0.0723835,-0.0399039,-0.996578,1
3644,2743,20,367,2699,54,188,9715,2671,12386,-0.0531302,-0.0503437,-0.997318,1
3582,2771,19,319,2699,29,193,9612,2918,12530,-0.0378555,-0.035488,-0.998653,1
4541,3397,31,409,3407,56,249,12090,3268,15358,-0.0481726,-0.117069,-0.991955,1
5896,4199,28,512,3973,53,251,14912,2602,17514,-0.0174326,0.0931484,-0.9955,1
2994,1699,12,217,1696,24,125,6767,1362,8129,-0.0235964,0.0411014,-0.998876,1
1640,1200,9,145,1178,14,72,4258,689,4947,-0.0241698,-0.0352001,-0.999088,1
5489,3817,26,474,3708,59,277,13850,1944,15794,-0.0162575,0.042582,-0.998961,1
3299,2313,16,297,2334,42,182,8483,1530,10013,-0.0224538,0.0482122,-0.998585,1
4915,3187,22,404,3153,38,238,11957,1763,13720,-0.0339089,0.107167,-0.993663,1
2384,1755,13,222,1686,25,131,6216,1365,7581,-0.0372944,0.0596624,-0.997522,1
3655,2671,23,315,2545,32,183,9424,2936,12360,-0.00727547,0.0825413,-0.996561,1
3602,2519,20,327,2439,56,184,9147,2249,11396,-0.0163408,0.0962802,-0.99522,1
2821,1910,15,234,2012,60,134,7186,1994,9180,-0.00458221,0.0751633,-0.997161,1
3391,2378,24,278,2356,34,171,8632,2977,11609,-0.00976222,0.074367,-0.997183,1
2604,1813,17,216,2321,39,196,7206,1713,8919,-0.0146365,0.071336,-0.997345,1
2505,1638,13,221,1681,23,129,6210,2414,8624,-0.0405921,0.0466516,-0.998086,1
4418,2696,29,320,2661,89,184,10397,5483,15880,-0.0586691,0.134176,-0.989219,1
3005,1875,18,223,1944,35,123,7223,4507,11730,-0.0630532,0.144695,-0.987465,1
3176,1986,23,230,1873,49,128,7465,1699,9164,-0.00128756,0.0663899,-0.997793,1
4760,3410,29,403,2874,36,199,11711,1541,13252,-0.0282626,0.0652375,-0.997469,1
3256,2121,19,273,2181,23,163,8036,1492,9528,-0.0162326,0.050397,-0.998597,1
4406,2928,27,341,3046,37,250,11035,3034,14069,-0.00863681,0.0374906,-0.99926,1
3255,2117,21,285,2221,60,157,8116,1743,9859,-0.00620559,0.0248695,-0.999671,1
3879,2731,24,372,2698,30,233,9967,2186,12153,0.0061462,0.016497,-0.999845,1
4821,3717,35,578,3535,145,369,13200,1467,14667,-0.0304833,0.110225,-0.993439,1
3371,2569,25,345,2628,33,207,9178,1613,10791,-0.0221945,0.122359,-0.992238,1
5417,4238,36,557,4111,49,226,14634,2208,16842,-0.0794789,0.182853,-0.979922,1
2695,2087,18,259,2065,31,160,7315,1894,9209,-0.0200662,0.0599317,-0.998001,1
4135,2885,27,349,2846,79,190,10511,2631,13142,-0.0234886,0.00909867,-0.999683,1
4002,2675,28,408,2713,47,209,10082,2570,12652,-0.0153719,0.020042,-0.999681,1
3077,1782,16,206,1771,29,124,7005,2320,9325,-0.00101261,-0.0303805,-0.999538,1
2859,1744,19,209,1734,28,119,6712,2832,9544,-0.0175863,-0.0822868,-0.996454,1
4963,2881,32,341,2737,38,177,11169,2302,13471,-0.00849779,-0.0819874,-0.996597,1
2459,1408,17,170,1364,21,91,5530,1484,7014,0.000685135,-0.0266721,-0.999644,1
4621,2818,27,376,2633,41,221,10737,4062,14799,-0.0224526,-0.0938642,-0.995332,1
3603,1912,24,265,1941,37,157,7939,2199,10138,0.00367303,-0.0507134,-0.998706,1
3119,1752,17,232,1713,23,118,6974,2236,9210,-0.00377646,-0.0643813,-0.997918,1
5069,2533,25,277,2600,35,158,10697,2972,13669,0.00646967,-0.0465903,-0.998893,1
3277,1935,18,201,1749,25,120,7325,3070,10395,0.0123597,-0.01789,-0.999764,1
4199,2252,24,293,2088,31,139,9026,5162,14188,0.023057,-0.00705279,-0.999709,1
3585,1543,17,206,1537,35,106,7029,3811,10840,0.0174482,-0.00920446,-0.999805,1
5482,2523,34,296,2796,55,221,11407,3932,15339,0.0221559,0.0277566,-0.999369,1
2836,1246,17,151,1239,28,88,5605,4571,10176,-0.00795863,-0.0124697,-0.999891,1
5657,1985,29,242,1913,51,140,10017,6921,16938,-0.00296473,0.0238693,-0.999711,1
3353,1278,21,212,1235,29,98,6226,2272,8498,-0.0077814,-0.0185907,-0.999797,1
2459,999,18,153,977,19,65,4690,2799,7489,-0.00133907,-0.0264967,-0.999648,1
4764,1585,29,207,1563,41,141,8330,4047,12377,-0.00781393,-0.0111384,-0.999907,1
3137,1149,27,150,1099,42,89,5693,3470,9163,-0.0051564,-0.0134241,-0.999897,1
4359,1651,27,249,1508,34,147,7975,5187,13162,0.00600436,-0.0278807,-0.999593,1
4366,1556,28,234,1544,33,147,7908,4224,12132,-0.0042353,-0.0364655,-0.999326,1
3096,1100,40,160,1078,22,93,5589,2705,8294,-0.0217746,-0.0490443,-0.998559,1
3861,1280,24,208,1347,56,98,6874,3908,10782,0.00625748,-0.0875943,-0.996137,1
4795,1706,36,295,1903,43,119,8897,-1000,-1000,-1,-1,-1,1
3610,1058,18,150,959,25,83,5903,-1000,-1000,-1,-1,-1,1
1406,503,9,63,501,11,35,2528,-1000,-1000,-1,-1,-1,1
2289,1050,15,130,1014,40,69,4607,11760,16367,0.0336502,-0.0230871,-0.999167,1
4710,2306,29,312,2217,39,181,9794,4843,14637,-0.0290308,0.0250033,-0.999266,1
3014,1558,18,197,1509,29,121,6446,2213,8659,0.00612525,-0.219839,-0.975517,1
2275,1214,14,145,1203,21,81,4953,1509,6462,0.00919032,-0.0406386,-0.999132,1
5107,2794,30,357,2730,47,215,11280,2465,13745,-0.0185232,-0.0326233,-0.999296,1
3427,1948,21,256,2157,24,149,7982,2150,10132,-0.0194634,-0.0871602,-0.996004,1
3157,1876,21,263,1800,25,146,7288,1688,8976,-0.0135885,-0.0449861,-0.998895,1
4791,3039,27,387,3468,47,230,11989,3010,14999,-0.00768465,0.00999909,-0.99992,1
3321,2256,19,280,2242,32,141,8291,1845,10136,0.0110892,-0.0259133,-0.999603,1
2899,1795,16,199,1750,23,112,6794,1656,8450,0.0088394,0.00902612,-0.99992,1
5269,4229,36,518,4194,61,267,14574,2852,17426,0.0612107,-0.0266275,-0.99777,1
2962,2489,18,322,2473,37,174,8475,1937,10412,0.107761,-0.092527,-0.989862,1
3001,2608,18,312,2571,37,164,8711,1390,10101,0.0525774,-0.0822045,-0.995228,1
5891,4968,37,625,4631,111,311,16574,2559,19133,0.0148469,-0.0604105,-0.998063,1
2976,2530,15,323,2452,51,187,8534,1727,10261,-0.0244398,-0.0930255,-0.995364,1
3456,2912,21,398,2871,61,190,9909,1875,11784,-0.0677858,-0.111771,-0.991419,1
4281,3612,23,455,3543,43,267,12224,2375,14599,-0.0544547,-0.0936485,-0.994115,1
6921,5298,46,617,5040,54,268,18244,1966,20210,-0.0631408,-0.0872506,-0.994183,1
2643,2187,15,255,2246,29,145,7520,1090,8610,-0.0402811,-0.104022,-0.993759,1
5952,4718,30,507,4295,49,207,15758,2353,18111,-0.0308716,-0.0887251,-0.995578,1
2832,2102,17,242,2163,35,142,7533,1542,9075,-0.0386742,-0.143937,-0.988831,1
3332,2405,20,301,2362,34,229,8683,1918,10601,-0.0535591,-0.0247087,-0.998259,1
4162,2850,23,349,2792,37,180,10393,2176,12569,-0.0647956,-0.0474355,-0.99677,1
3820,2528,26,286,2385,47,168,9260,2580,11840,-0.0663629,-0.0555256,-0.996249,1
2837,1861,20,235,2190,26,122,7291,2282,9573,-0.0715601,-0.081328,-0.994115,1
3574,2371,23,305,2312,51,199,8835,2907,11742,-0.0498428,0.00115853,-0.998756,1
5715,3689,36,468,3594,50,274,13826,3364,17190,-0.0541844,-0.0377165,-0.997818,1
2848,1905,18,220,1882,30,127,7030,2378,9408,-0.035197,-0.0539303,-0.997924,1
4382,3032,25,348,2897,38,199,10921,3161,14082,-0.0336356,-0.0240844,-0.999144,1
3122,2251,19,250,2168,33,169,8012,1951,9963,-0.0485272,0.0269272,-0.998459,1
2463,1711,12,187,1670,22,107,6172,1305,7477,-0.0547082,0.00135242,-0.998501,1
4751,3107,21,379,3094,64,202,11618,2143,13761,-0.0354942,0.0980233,-0.994551,1
4368,3052,22,349,3027,29,158,11005,1613,12618,-0.024396,0.109154,-0.993725,1
2394,1615,13,185,1586,30,110,5933,1220,7153,-0.0250348,0.0875628,-0.995844,1
4829,3229,31,456,3182,49,275,12051,2489,14540,-0.0253369,0.0776651,-0.996657,1
4812,3205,32,400,3122,53,251,11875,1931,13806,-0.0455786,0.082909,-0.995514,1
2437,1566,17,202,1532,39,109,5902,1406,7308,-0.0563114,0.0734109,-0.995711,1
4654,2833,28,315,2743,84,200,10857,3032,13889,-0.0680029,0.147333,-0.986746,1
4628,2772,33,334,2745,87,187,10786,2839,13625,-0.0787258,0.113319,-0.990435,1
2387,1416,15,171,1360,28,92,5469,2687,8156,-0.0648417,0.0990812,-0.992964,1
4668,2678,30,328,2648,30,179,10561,2363,12924,-0.0816767,0.0878122,-0.992783,1
3242,1830,20,247,1771,25,123,7258,2484,9742,-0.066135,0.0652279,-0.995676,1
4892,2889,29,389,2863,82,228,11372,2763,14135,-0.0260679,0.0973459,-0.994909,1
2718,1706,17,224,1656,26,114,6461,2052,8513,-0.0225202,0.0501096,-0.99849,1
4302,2846,31,360,2757,57,215,10568,3075,13643,-0.00649664,0.0390835,-0.999215,1
4317,2984,25,386,3042,42,235,11031,1826,12857,-0.00428561,0.014461,-0.999886,1
2472,1765,14,248,1830,30,132,6491,3112,9603,0.028952,0.011933,-0.99951,1
4928,3609,26,450,3598,56,228,12895,4054,16949,0.363721,0.494154,-0.789632,1
2565,1980,15,238,1984,21,121,6924,2511,9435,0.368409,0.581024,-0.725731,1
3062,2188,18,244,2128,29,167,7836,9012,16848,0.00950757,0.0414927,-0.999094,1
2456,1580,15,208,1546,22,105,5932,1801,7733,-0.00829723,-0.0274652,-0.999588,1
4648,2836,25,345,2630,34,183,10701,3458,14159,-0.0537657,0.028363,-0.998151,1
3219,1742,18,249,1688,24,160,7100,2995,10095,-0.0395457,0.00172071,-0.999216,1
2562,1470,20,225,1682,24,118,6101,3386,9487,-0.0648647,0.0136286,-0.997801,1
2573,1199,15,156,1165,23,100,5231,3160,8391,-0.0567163,-0.0426955,-0.997477,1
5635,2182,28,291,2086,45,167,10434,6304,16738,-0.0568748,0.00894279,-0.998341,1
2250,829,12,116,812,14,68,4101,4408,8509,-0.0293156,-0.0325994,-0.999038,1
2438,796,14,98,761,15,70,4192,2891,7083,-0.0406062,-0.0495567,-0.997946,1
4690,1462,32,238,1322,32,112,7888,8592,16480,-0.048547,-0.102662,-0.993531,1
3107,742,20,108,681,24,62,4744,2814,7558,-0.045024,-0.0279998,-0.998593,1
4782,1241,36,197,1191,55,113,7615,3690,11305,-0.0504667,-0.0428474,-0.997806,1
4723,969,25,160,929,29,91,6926,3314,10240,-0.0260126,-0.013788,-0.999567,1
2347,602,14,106,573,21,59,3722,2041,5763,-0.0470283,-0.0416148,-0.998026,1
2807,809,16,136,792,31,62,4653,3445,8098,-0.0412252,-0.000551895,-0.99915,1
3431,1146,23,166,1086,32,91,5975,3496,9471,-0.0518894,-0.0249925,-0.99834,1
4241,1443,26,189,1419,49,109,7476,3324,10800,-0.0658373,0.0086568,-0.997793,1
4734,2012,36,282,1945,96,156,9261,2539,11800,-0.0682248,0.0151384,-0.997555,1
2289,1123,15,155,1053,21,93,4749,1604,6353,-0.069314,-0.0325513,-0.997064,1
4585,2264,28,338,2286,94,197,9792,3826,13618,-0.0608171,0.00256577,-0.998146,1
3175,1505,19,193,1567,28,114,6601,2248,8849,-0.0437708,-0.000484335,-0.999041,1
4505,2322,29,296,2296,100,202,9750,2738,12488,-0.0647286,0.00197472,-0.997901,1
4456,2306,28,300,2293,63,203,9649,2445,12094,-0.071233,0.0129238,-0.997376,1
3117,1718,19,236,1661,24,141,6916,1661,8577,-0.0399052,-0.0253588,-0.998882,1
4682,2701,29,367,2675,38,216,10708,3089,13797,-0.0394553,0.00767776,-0.999192,1
3322,2069,20,275,2110,30,161,7987,1913,9900,-0.0368712,-0.0278855,-0.998931,1
5018,3444,28,441,3423,47,222,12623,3215,15838,-0.0348678,-0.0467875,-0.998296,1
3720,2920,19,347,2795,40,236,10077,2326,12403,-0.0362245,-0.0549156,-0.997834,1
2865,2350,15,272,2358,41,143,8044,2453,10497,-0.0432102,-0.0443612,-0.998081,1
6028,4408,25,541,4391,56,342,15791,1962,17753,-0.0451732,-0.0162149,-0.998848,1
3136,2545,16,294,2478,35,168,8672,1857,10529,-0.0400215,-0.0465368,-0.998115,1
4367,3427,18,403,3831,34,231,12311,2656,14967,-0.0410688,-0.0526115,-0.99777,1
3879,3146,18,372,3091,33,204,10743,1912,12655,-0.045323,-0.0773479,-0.995973,1
5628,4052,26,461,3927,49,263,14406,1726,16132,-0.0617253,-0.0667044,-0.995862,1
2774,1932,14,218,1944,24,135,7041,1523,8564,-0.0573272,-0.145103,-0.987754,1
4993,3291,26,388,3222,46,213,12179,2257,14436,-0.0839354,-0.110587,-0.990316,1
5061,3178,27,366,3259,69,274,12234,1904,14138,-0.0910845,-0.118757,-0.988737,1
2716,1782,17,204,1723,20,114,6576,1670,8246,-0.0784114,-0.127411,-0.988746,1
5070,3193,31,358,3119,46,258,12075,2238,14313,-0.0539394,-0.0884227,-0.994622,1
3560,2384,20,293,2313,30,169,8769,2341,11110,-0.0933234,-0.119672,-0.988418,1
4480,2977,25,371,3276,61,253,11443,3474,14917,-0.0562733,-0.110113,-0.992325,1
2604,1720,14,191,1683,19,108,6339,2470,8809,-0.0569076,-0.10288,-0.993065,1
3847,2869,20,326,2604,30,190,9886,3332,13218,-0.042727,-0.0725112,-0.996452,1
7852,2636,19,322,2406,23,142,13400,1638,15038,-0.0372115,-0.0933407,-0.994939,1
5880,3983,28,507,3994,44,282,14718,3428,18146,-0.0572513,0.0862697,-0.994625,1
2335,1575,11,173,1511,15,84,5704,1298,7002,-0.0554371,0.0367258,-0.997787,1
1419,1070,8,106,947,10,59,3619,646,4265,-0.0649283,-0.0413831,-0.997031,1
1419,962,9,109,927,10,61,3497,797,4294,-0.0710331,-0.0275357,-0.997094,1
4542,3008,23,334,2857,39,182,10985,2113,13098,-0.076273,0.0610521,-0.995216,1
4592,2615,23,332,2704,49,185,10500,1599,12099,-0.0754774,0.0380048,-0.996423,1
2272,1409,13,180,1408,20,91,5393,1314,6707,-0.0696209,0.0268804,-0.997211,1
4424,2645,25,419,2631,63,181,10388,3165,13553,-0.0727183,0.0498351,-0.996107,1
3041,1831,18,237,1818,42,133,7120,1717,8837,-0.0581162,0.0614431,-0.996417,1
4380,2578,24,379,2574,73,189,10197,3009,13206,-0.0572865,0.0512182,-0.997043,1
3036,1653,17,225,1770,156,171,7028,7609,14637,-0.0418351,0.0374137,-0.998424,1
1829,957,11,145,919,44,76,3981,6363,10344,0.444804,-0.109044,-0.888965,1
4370,2124,24,320,2083,168,177,9266,10113,19379,0.190121,-0.454023,-0.870469,1
4564,1946,24,284,1932,66,158,8974,8525,17499,0.0513128,-0.403031,-0.913747,1
2592,882,26,93,723,36,61,4413,2392,6805,-0.0122427,0.0638649,-0.997883,1
1449,494,7,63,503,25,36,2577,1153,3730,0.299259,0.0700601,-0.951596,1
2002,880,11,120,846,36,68,3963,2002,5965,0.313829,0.0361903,-0.94879,1
4760,2408,24,349,2569,53,181,10344,7164,17508,0.418738,0.294782,-0.858931,1
3323,1925,19,259,1925,46,153,7650,3196,10846,0.414736,0.377064,-0.828141,1
3215,1945,15,260,1896,30,149,7510,-1000,-1000,-1,-1,-1,1
2021,1380,13,180,1340,32,106,5072,-1000,-1000,-1,-1,-1,1
2715,1895,17,240,1833,27,123,6850,4322,11172,0.304128,0.571758,-0.76197,1
4130,2816,28,351,2715,48,215,10303,-1000,-1000,-1,-1,-1,1
1649,1023,10,128,991,14,66,3881,-1000,-1000,-1,-1,-1,1
1565,909,14,120,858,15,63,3544,2296,5840,-0.0844466,-0.0298023,-0.995982,1
4518,2377,31,283,2284,36,150,9679,5703,15382,-0.0275043,-0.0153242,-0.999504,1
4671,2129,31,315,2069,37,151,9403,5167,14570,-0.059846,-0.051991,-0.996853,1
2651,1194,19,144,1109,23,83,5223,2587,7810,-0.0300149,-0.0412386,-0.998698,1
5436,2026,39,254,1964,46,148,9913,5405,15318,-0.027736,-0.0204216,-0.999407,1
2575,1097,17,154,1075,28,89,5035,1898,6933,-0.0414709,-0.0387713,-0.998387,1
5077,2089,34,262,1906,35,157,9560,5050,14610,-0.0321357,-0.0698046,-0.997043,1
3289,1404,29,170,1410,26,94,6422,2253,8675,-0.0275371,-0.06481,-0.997518,1
4590,2026,40,305,2003,51,143,9158,2636,11794,-1.35216e-05,-0.117915,-0.993024,1
3193,1424,22,242,1355,40,113,6389,2919,9308,-0.0068227,-0.09623,-0.995336,1
5005,2317,37,255,2051,51,150,9866,2572,12438,-0.0214761,-0.077522,-0.996759,1
3295,1350,32,175,1341,35,104,6332,2948,9280,-0.0250991,-0.0518416,-0.99834,1
4734,1787,34,232,1752,48,135,8722,3501,12223,-0.0577532,-0.0269916,-0.997966,1
3212,1179,23,217,1190,29,113,5963,2233,8196,-0.0556432,-0.0671291,-0.996192,1
4132,1592,26,250,1525,37,145,7707,3105,10812,-0.0540978,-0.0847691,-0.994931,1
5620,1635,29,248,1594,35,156,9317,3081,12398,-0.045294,0.0529423,-0.99757,1
3006,1002,23,137,908,54,79,5209,1923,7132,-0.0564791,0.0602383,-0.996585,1
3929,1313,31,207,1440,59,127,7106,2660,9766,-0.0244429,-0.026142,-0.999359,1
3831,1381,27,217,1325,46,120,6947,2367,9314,0.024043,-0.0208307,-0.999494,1
5034,1883,29,273,1853,54,150,9276,2756,12032,-0.0503587,0.135161,-0.989543,1
3033,1323,16,154,1093,35,86,5740,1199,6939,-0.0459425,0.064779,-0.996841,1
1459,786,11,97,760,17,55,3185,884,4069,-0.0470119,-0.0225623,-0.998639,1
2006,1297,15,155,1258,26,88,4845,1340,6185,-0.053326,-0.0523199,-0.997206,1
4951,3743,34,437,3508,84,223,12980,2299,15279,-0.0458097,-0.0201161,-0.998748,1
3425,2734,18,339,2713,35,190,9454,1925,11379,-0.0491591,-0.0844747,-0.995212,1
5076,4411,26,544,4465,52,331,14905,1738,16643,-0.0378183,-0.0693085,-0.996878,1
3681,3657,19,448,3547,53,247,11652,1996,13648,-0.0550884,-0.0697094,-0.996045,1
3675,3662,18,423,3628,45,250,11701,1542,13243,-0.0385171,-0.0787667,-0.996149,1
4693,4605,22,534,4517,39,312,14722,1853,16575,-0.0151087,-0.0888306,-0.995932,1
3474,3280,16,391,3354,28,223,10766,1314,12080,-0.0297831,-0.125964,-0.991588,1
3231,3030,15,350,3035,28,215,9904,1668,11572,-0.00517724,-0.153535,-0.98813,1
6223,4960,26,556,4546,33,214,16558,1704,18262,-0.0547597,-0.114402,-0.991924,1
2912,2371,16,253,2379,28,147,8106,1592,9698,-0.0520924,-0.159877,-0.985762,1
5804,4371,28,535,4143,46,256,15183,2116,17299,-0.0458559,-0.14558,-0.988283,1
2819,2065,16,254,2077,20,129,7380,1417,8797,-0.0468454,-0.102877,-0.99359,1
3440,2465,18,309,2418,33,152,8835,2155,10990,-0.0520607,-0.110927,-0.992464,1
5240,3724,27,448,3639,39,251,13368,3580,16948,-0.0316083,-0.0261266,-0.999159,1
2803,2107,14,262,2036,46,171,7439,2451,9890,-0.0430796,-0.0806152,-0.995814,1
2302,1696,13,208,1676,25,112,6032,2224,8256,-0.0442348,-0.108586,-0.993102,1
3527,2325,19,259,2264,58,154,8606,3199,11805,-0.0523801,-0.118677,-0.99155,1
5003,3611,28,482,4855,48,286,14313,2683,16996,-0.0581307,-0.00477425,-0.998298,1
5187,2409,18,271,2295,45,126,10351,1734,12085,-0.0739154,0.0523294,-0.995891,1
4352,2776,23,312,2705,32,179,10379,2264,12643,-0.0596201,0.0198666,-0.998023,1
4026,2521,22,336,2474,42,193,9614,2280,11894,-0.0595942,0.0315151,-0.997725,1
3522,2082,21,292,2039,40,162,8158,2213,10371,-0.0158866,0.0909823,-0.995726,1
3576,1961,21,247,2022,60,165,8052,1771,9823,-0.0330531,0.0607824,-0.997604,1
2915,1579,17,217,1528,28,121,6405,1916,8321,-0.0344819,0.0709388,-0.996884,1
3818,2240,33,287,2062,43,157,8640,2748,11388,-0.0257069,0.0904317,-0.995571,1
4374,2161,25,274,2015,43,149,9041,3665,12706,-0.0590303,0.144342,-0.987766,1
3027,1107,15,141,1070,25,75,5460,1667,7127,-0.0429649,0.132998,-0.990185,1
1582,807,13,106,816,17,54,3395,1800,5195,-0.107783,0.0524861,-0.992788,1
4199,2160,28,259,2116,46,148,8956,3715,12671,-0.020787,0.0745256,-0.997002,1
4300,2725,28,352,2529,46,222,10202,2064,12266,-0.0264535,0.0991709,-0.994719,1
3183,2237,24,287,2250,39,155,8175,2813,10988,-0.0993764,0.100561,-0.989955,1
3368,2664,25,344,2478,30,177,9086,2301,11387,-0.080811,0.0734548,-0.994019,1
4839,2553,24,300,2623,31,192,10562,2645,13207,-0.0424908,0.0595332,-0.997322,1
2596,2244,18,275,2155,26,158,7472,1828,9300,-0.0288235,0.00979052,-0.999537,1
2657,2179,17,240,2082,25,137,7337,3775,11112,-0.0113657,0.0105075,-0.99988,1
5412,4373,29,525,4428,41,312,15120,3571,18691,0.0657211,0.0559972,-0.996266,1
2377,1767,14,211,1613,20,104,6106,1686,7792,0.0604483,-0.0568298,-0.996552,1
1596,1219,9,158,1190,14,86,4272,1099,5371,-0.0175444,-0.104028,-0.99442,1
2235,1649,13,198,1623,19,118,5855,1480,7335,-0.000505599,-0.0307076,-0.999528,1
4733,3401,25,416,3280,34,244,12133,2444,14577,-0.0311701,-0.0996432,-0.994535,1
3283,2316,18,272,2355,22,146,8412,2351,10763,-0.0371156,-0.0831586,-0.995845,1
5427,3554,27,425,3395,33,225,13086,2700,15786,-0.0385186,-0.0148334,-0.999148,1
2827,1814,16,209,1790,21,132,6809,3056,9865,-0.0443984,-0.0728399,-0.996355,1
4795,2894,30,324,2848,33,231,11155,3487,14642,-0.0289708,-0.0630085,-0.997592,1
2237,1283,12,164,1254,14,98,5062,1553,6615,-0.0217851,-0.0559412,-0.998196,1
3139,1719,17,269,2266,40,158,7608,3514,11122,-0.0214914,-0.061784,-0.997858,1
4897,2497,27,284,2269,32,152,10158,5026,15184,-0.0114793,0.000674011,-0.999934,1
3341,1392,25,168,1384,31,110,6451,2119,8570,-0.00788894,-0.0479194,-0.99882,1
4866,1619,28,207,1563,36,113,8432,3428,11860,0.00527229,0.0554614,-0.998447,1
4590,993,28,146,1033,37,67,6894,2125,9019,-0.0125455,0.0644867,-0.99784,1
1949,397,12,67,386,18,31,2860,1238,4098,0.00253494,-0.0767945,-0.997044,1
4255,1114,27,162,962,34,78,6632,2914,9546,-0.0212771,-0.0483193,-0.998605,1
3832,916,26,129,920,67,74,5964,3268,9232,-0.0344544,-0.0286755,-0.998995,1
4126,1046,27,155,1080,37,105,6576,3746,10322,-0.00448178,-0.0661731,-0.997798,1
3874,1111,28,153,1114,39,86,6405,2440,8845,-0.0156096,-0.0175923,-0.999723,1
2150,668,14,85,675,20,62,3674,1339,5013,-0.020121,-0.0560609,-0.998225,1
4196,1316,34,191,1249,41,109,7136,2510,9646,-0.0607745,-0.0338115,-0.997579,1
4197,1495,32,254,1373,83,120,7554,2413,9967,-0.0466195,-0.0327022,-0.998377,1
4325,1627,33,225,1551,42,126,7929,3070,10999,-0.00671842,0.0431338,-0.999047,1
6093,2441,35,334,2432,58,190,11583,2533,14116,0.00176459,-0.0320423,-0.999485,1
1591,617,10,78,606,21,43,2966,813,3779,-0.020175,-0.0611375,-0.997925,1
2866,1574,18,190,1513,26,104,6291,2330,8621,0.00279817,0.00838689,-0.999961,1
4820,3391,28,374,3170,41,215,12039,2550,14589,-0.00684216,-0.01047,-0.999922,1
3855,2897,20,321,2820,33,184,10130,2103,12233,-0.0500297,-0.0626078,-0.996783,1
5715,4753,27,520,5374,66,301,16756,2361,19117,-0.0387388,-0.0108057,-0.999191,1
5350,5409,26,609,4971,73,352,16790,2634,19424,-0.0712795,-0.00859833,-0.997419,1
3114,3102,14,350,3056,34,258,9928,1268,11196,-0.0351566,-0.0652646,-0.997248,1
2826,2737,12,319,2694,29,184,8801,1253,10054,-0.0514031,-0.0747052,-0.99588,1
5655,5630,25,720,5416,45,386,17877,1875,19752,-0.0399856,-0.0414472,-0.99834,1
3012,2750,14,296,2725,28,167,8992,1397,10389,-0.0426476,-0.0861238,-0.995371,1
2825,2456,18,284,2437,27,170,8217,1710,9927,-0.0332798,-0.109101,-0.993473,1
5389,4278,26,470,4959,52,271,15445,1634,17079,-0.053145,-0.0945019,-0.994105,1
2896,2481,15,292,2377,31,188,8280,1785,10065,-0.0472208,-0.138251,-0.989271,1
2868,2351,15,269,2320,25,142,7990,2093,10083,-0.0240869,-0.0911008,-0.99555,1
4347,3491,21,368,3387,43,215,11872,3306,15178,-0.0538775,-0.106911,-0.992808,1
3168,2596,18,365,2555,28,175,8905,2415,11320,-0.0444887,-0.152481,-0.987305,1
3888,3119,21,341,2975,41,184,10569,3441,14010,-0.0421621,-0.126055,-0.991127,1
3549,2711,19,293,2823,33,170,9598,2525,12123,-0.0630291,-0.105605,-0.992409,1
4492,3488,23,409,3361,39,241,12053,5823,17876,-0.0422992,-0.142795,-0.988848,1
4393,3286,23,430,3170,47,249,11598,4041,15639,-0.020724,-0.103265,-0.994438,1
2416,1714,13,195,1694,19,109,6160,2045,8205,-0.0259922,-0.103751,-0.994264,1
5130,3322,24,385,3047,41,265,12214,2384,14598,-0.0417294,-0.0647227,-0.99703,1
3815,2052,17,266,2043,28,140,8361,1532,9893,-0.0533056,-0.00750659,-0.99855,1
2307,1421,12,186,1409,22,102,5459,1346,6805,-0.0759658,-0.0307545,-0.996636,1
3865,2266,22,286,2178,47,151,8815,2424,11239,-0.0707473,-0.035804,-0.996851,1
4092,2373,27,280,2266,52,160,9250,2907,12157,-0.0183507,0.0330817,-0.999284,1
4336,2229,26,293,2195,50,177,9306,2144,11450,-0.0249993,0.0247681,-0.999381,1
2801,1487,17,202,1465,33,118,6123,1833,7956,-0.0308738,0.0254303,-0.9992,1
4104,2122,31,298,2054,68,170,8847,2898,11745,-0.031849,0.0675477,-0.997208,1
4216,2052,26,304,2135,41,158,8932,3360,12292,-8.85786e-05,0.173408,-0.98485,1
4090,2096,27,258,1573,32,107,8183,1836,10019,0.000318995,0.162312,-0.986739,1
1848,853,12,101,875,20,59,3768,1159,4927,-0.000652261,0.0582868,-0.9983,1
1425,691,10,82,686,23,46,2963,1543,4506,-0.0143244,0.0596012,-0.998119,1
4141,2273,28,311,2181,61,155,9150,5949,15099,-0.0404953,0.123642,-0.9915,1
3917,2263,28,299,2143,65,188,8903,3773,12676,-0.00556882,0.121028,-0.992633,1
2909,1886,19,258,1965,33,145,7215,5479,12694,-0.0647837,0.0874387,-0.994061,1
2803,1814,23,237,1739,42,135,6793,2776,9569,-0.0483787,0.0523671,-0.997455,1
4872,3703,29,513,3707,66,255,13145,4343,17488,-0.0606333,0.0475316,-0.997028,1
5234,4082,30,461,3098,40,187,13132,2822,15954,-0.0317691,0.0666935,-0.997268,1
2272,1831,12,201,1777,20,113,6226,2583,8809,-0.0541544,-0.0251823,-0.998215,1
3752,3090,20,333,3066,33,192,10486,5623,16109,-0.0128706,0.0490516,-0.998713,1
2972,2178,17,262,2123,31,143,7726,3188,10914,-0.0398654,0.0590912,-0.997456,1
5114,2988,29,344,3348,53,210,12086,2006,14092,-0.0225676,0.0785077,-0.996658,1
2645,1319,31,153,1356,18,86,5608,1573,7181,-0.0117979,0.0178321,-0.999771,1
4585,1876,24,299,1856,36,128,8804,3386,12190,-0.000689531,0.0247379,-0.999694,1
4351,1562,27,191,1490,37,106,7764,2796,10560,0.0361033,0.014705,-0.99924,1
3051,951,18,124,911,30,73,5158,1781,6939,-0.0138398,-0.0298655,-0.999458,1
4124,1516,24,238,1519,41,131,7593,2191,9784,-0.00184552,-0.00972374,-0.999951,1
4448,1632,34,217,1598,44,127,8100,2898,10998,-0.0229414,-0.0198206,-0.99954,1
2826,989,16,124,1014,28,85,5082,2383,7465,-0.0161336,-0.0337989,-0.999298,1
4407,1472,27,206,1529,46,147,7834,4516,12350,-0.0048156,-0.0505767,-0.998709,1
4001,1290,30,178,1263,41,123,6926,2485,9411,0.0111113,-0.0859006,-0.996242,1
2521,846,16,132,780,32,60,4387,3239,7626,-0.0126111,-0.0626841,-0.997954,1
3074,935,19,133,969,47,69,5246,11090,16336,0.0196781,-0.07082,-0.997295,1
2265,687,17,92,620,41,54,3776,-1000,-1000,-1,-1,-1,1
2866,749,22,108,706,74,57,4582,-1000,-1000,-1,-1,-1,1
2127,537,16,78,491,38,45,3332,-1000,-1000,-1,-1,-1,1
3281,736,24,114,682,78,67,4982,-1000,-1000,-1,-1,-1,1
2359,534,19,82,465,45,46,3550,-1000,-1000,-1,-1,-1,1
1946,415,13,74,411,25,33,2917,-1000,-1000,-1,-1,-1,1
2951,691,23,103,646,40,53,4507,-1000,-1000,-1,-1,-1,1
3820,1126,27,152,1102,77,96,6400,-1000,-1000,-1,-1,-1,1
1642,580,15,92,552,23,48,2952,-1000,-1000,-1,-1,-1,1
946,347,8,45,342,13,25,1726,885,2611,-0.0316905,-0.103617,-0.994112,1
3513,1485,26,199,1422,45,175,6865,3163,10028,0.017686,-0.100329,-0.994797,1
3927,1388,26,179,1360,32,97,7009,3248,10257,0.0372569,0.0016727,-0.999304,1
3539,1367,26,178,1397,31,98,6636,2534,9170,-0.0154433,-0.0652584,-0.997749,1
3915,1446,31,194,1410,39,112,7147,2725,9872,-0.0264094,-0.0780405,-0.9966,1
4008,1709,28,274,1656,47,142,7864,1992,9856,-0.0178106,-0.0714993,-0.997282,1
5326,1913,28,250,1939,40,146,9642,2471,12113,-0.0129399,-0.0841313,-0.996371,1
4257,2472,32,317,2528,35,163,9804,2930,12734,0.000994982,-0.0070946,-0.999974,1
4804,2792,26,348,1882,27,132,10011,2079,12090,-0.0450194,-0.0295011,-0.99855,1
1862,1306,10,150,1283,26,86,4723,1323,6046,-0.0230457,-0.0515756,-0.998403,1
1695,1278,10,144,1289,17,81,4514,1553,6067,-0.00512378,-0.0667423,-0.997757,1
5857,3798,28,485,3700,45,278,14191,3320,17511,-0.0391433,0.0046047,-0.999223,1
3167,2663,17,298,2596,27,170,8938,2985,11923,-0.0353549,-0.0498961,-0.998128,1
5225,4850,24,589,4679,48,341,15756,4117,19873,0.00872457,0.0406703,-0.999135,1
2682,2605,13,328,2602,46,199,8475,1979,10454,0.133154,-0.0380619,-0.990364,1
5282,4982,30,621,4881,40,317,16153,3443,19596,0.118157,-0.0293411,-0.992561,1
2917,2882,14,357,2896,33,208,9307,3668,12975,0.0396859,-0.0684924,-0.996862,1
3315,3252,17,365,3202,42,206,10399,3663,14062,0.0937225,-0.0684823,-0.99324,1
4212,4097,27,492,3940,41,298,13107,3832,16939,-0.0104367,-0.105473,-0.994367,1
2609,2496,12,301,2443,29,177,8067,2875,10942,-0.0343439,-0.117466,-0.992483,1
3471,3189,16,416,3197,37,240,10566,2712,13278,-0.0352448,-0.0784591,-0.996294,1
4232,4085,20,443,3756,41,247,12824,1924,14748,-0.0463841,-0.0599097,-0.997126,1
3678,3709,18,447,4738,43,276,12909,2281,15190,-0.0374328,-0.0950634,-0.994767,1
6146,5091,25,572,4907,50,327,17118,2605,19723,-0.0162617,-0.0728292,-0.997212,1
3130,2542,17,304,2499,26,147,8665,1518,10183,-0.0415214,-0.0777384,-0.996109,1
5871,4437,25,544,4151,39,224,15291,2200,17491,-0.0306507,-0.0958872,-0.99492,1
2502,1802,18,220,1767,25,129,6463,1771,8234,-0.0203215,-0.129222,-0.991407,1
5803,4048,30,505,4447,43,310,15186,3874,19060,-0.0306489,-0.0717932,-0.996949,1
2979,2344,18,279,2137,33,140,7930,2327,10257,0.011916,-0.0857664,-0.996244,1
3433,2713,22,434,3508,41,240,10391,4787,15178,-0.0369439,-0.0488895,-0.998121,1
2574,1948,14,215,1924,21,123,6819,2195,9014,-0.0359773,-0.0143604,-0.999249,1
3906,2837,21,352,2799,37,180,10132,4210,14342,-0.0332661,0.0246013,-0.999144,1
2922,1987,14,247,1925,20,169,7284,1820,9104,-0.0817511,-0.0132408,-0.996565,1
2634,1817,14,232,1787,19,129,6632,2131,8763,-0.0408628,-0.031077,-0.998681,1
4429,2837,21,355,2789,31,208,10670,4015,14685,-0.0506688,-0.0231174,-0.998448,1
2954,1845,16,235,1809,35,157,7051,2398,9449,-0.0254834,-0.0177545,-0.999518,1
4736,2484,24,315,2328,51,179,10117,4216,14333,-0.0438117,-0.001891,-0.999038,1
2859,1625,16,217,1535,30,110,6392,3080,9472,-0.0584322,-0.034085,-0.997709,1
2812,1531,16,227,1466,46,122,6220,2751,8971,-0.053736,-0.0469146,-0.997452,1
4363,2164,25,291,2130,53,154,9180,3595,12775,-0.0550571,-0.0368214,-0.997804,1
4590,1922,24,264,1988,52,129,8969,2773,11742,-0.0108382,-0.0490859,-0.998736,1
2690,1321,17,197,1324,41,117,5707,2330,8037,-0.0361461,-0.11851,-0.992295,1
4204,1978,30,272,2075,87,156,8802,4594,13396,0.0181939,-0.0180024,-0.999672,1
2837,1345,17,162,1357,38,92,5848,2573,8421,-0.0245881,-0.026663,-0.999342,1
4074,1883,29,261,1784,83,140,8254,3259,11513,-0.0574952,0.0128265,-0.998263,1
3607,1675,27,213,1589,46,122,7279,4171,11450,0.00877295,0.0180646,-0.999798,1
2522,1203,17,173,1123,40,82,5160,2144,7304,-0.0415958,0.0326311,-0.998602,1
4982,1922,27,245,1933,50,140,9299,3746,13045,-0.0394402,0.0337536,-0.998652,1
2717,1288,18,154,1259,34,87,5557,3174,8731,-0.026244,0.0407004,-0.998827,1
3843,1630,31,250,1969,58,154,7935,6317,14252,-0.0424963,0.152678,-0.987362,1
2642,1324,16,206,1689,64,115,6056,5792,11848,-0.0679316,0.123328,-0.990038,1
2206,1204,13,162,1215,32,103,4935,3886,8821,-0.059839,0.0987871,-0.993308,1
2661,2025,22,258,2048,64,122,7200,4600,11800,-0.0407472,0.127428,-0.99101,1
4290,2663,29,325,2541,63,173,10084,7265,17349,-0.0844798,0.0283382,-0.996022,1
2956,2080,17,267,2017,41,151,7529,13199,20728,0.211293,-0.524745,-0.82462,1
2112,1469,11,169,1418,25,81,5285,2576,7861,0.0242021,0.589325,-0.807533,1
2584,1972,14,229,1983,38,130,6950,4867,11817,0.0092745,0.521924,-0.852942,1
3804,3133,19,364,3078,50,194,10642,10252,20894,0.0310625,0.539974,-0.841108,1
2313,1953,12,240,1922,22,132,6594,12309,18903,-0.291101,0.542974,-0.78768,1
3355,1973,14,216,1870,25,153,7606,9301,16907,-0.0291841,0.0239621,-0.999287,1
1938,1572,10,197,1531,16,102,5366,1920,7286,0.00171213,-0.046323,-0.998925,1
3707,3073,19,365,3075,34,218,10491,3847,14338,-0.0116575,-0.00513528,-0.999919,1
3635,2927,18,318,3207,46,214,10365,2014,12379,0.00493327,-0.0178957,-0.999828,1
2825,2166,14,236,2173,29,132,7575,3373,10948,0.0106191,0.00735753,-0.999917,1
4746,3527,25,386,3610,32,229,12555,4403,16958,0.00674935,0.0495363,-0.99875,1
2579,1765,15,193,1763,19,109,6443,3922,10365,-0.010388,0.0267064,-0.999589,1
4793,2860,26,342,2930,42,187,11180,2926,14106,0.00656608,0.0661223,-0.99779,1
3079,1718,16,193,1746,23,110,6885,3515,10400,-0.0127779,0.0608136,-0.998067,1
4837,2296,37,308,2331,63,174,10046,4257,14303,-0.0239152,0.107873,-0.993877,1
2478,922,18,119,754,31,54,4376,2062,6438,-0.0209635,0.0492469,-0.998567,1
1282,410,10,55,383,12,31,2183,1061,3244,0.00365621,-0.013607,-0.999901,1
1519,374,14,54,343,16,33,2353,1554,3907,-0.00318032,-0.0315314,-0.999498,1
3868,622,29,103,552,39,68,5281,3965,9246,0.0122072,0.0154223,-0.999807,1
6053,680,31,130,641,63,67,7665,4015,11680,0.0173445,0.00385624,-0.999842,1
1815,182,12,33,180,11,17,2250,1789,4039,-0.00640842,-0.0540474,-0.998518,1
993,126,8,21,101,9,15,1273,941,2214,0.0161857,-0.04165,-0.999001,1
4037,476,28,112,429,34,51,5167,4829,9996,0.0101191,-0.0451061,-0.998931,1
4181,519,30,110,434,37,70,5381,3822,9203,0.0213232,-0.0566646,-0.998166,1
2776,347,23,66,305,27,39,3583,2236,5819,0.00837497,-0.0254379,-0.999641,1
3492,489,30,94,438,36,60,4639,3120,7759,-0.0152272,-0.0380732,-0.999159,1
3835,620,32,133,678,42,66,5406,2306,7712,0.0003258,-0.0190246,-0.999819,1
3927,859,33,144,802,67,83,5915,2798,8713,-0.0212864,0.0224545,-0.999521,1
4046,1089,32,191,1118,39,86,6601,2269,8870,-0.0394526,-0.0185904,-0.999048,1
3812,1257,24,172,1381,32,98,6776,2500,9276,-0.0146105,0.019197,-0.999709,1
3927,1855,32,223,1727,34,139,7937,2628,10565,-0.0449701,0.0204935,-0.998778,1
3909,2159,23,279,2288,34,143,8835,2362,11197,-0.0232048,0.0419941,-0.998848,1
4131,3004,23,342,3123,47,259,10929,1849,12778,-0.0169047,0.0342893,-0.999269,1
3183,2662,18,301,2749,33,176,9122,1622,10744,0.0114271,0.0253383,-0.999614,1
3970,4302,26,510,4428,53,261,13550,2307,15857,0.005701,-0.00412768,-0.999975,1
4448,4410,26,504,4380,39,236,14043,2178,16221,0.0439124,0.0464747,-0.997954,1
2710,2601,12,313,2575,32,187,8430,1363,9793,0.0645466,0.0253431,-0.997593,1
5046,4885,25,608,4821,66,316,15767,1932,17699,0.057952,0.0445803,-0.997323,1
2840,2764,14,343,2737,28,198,8924,1352,10276,0.0355042,0.0531067,-0.997957,1
6197,5076,24,624,4688,28,254,16891,1506,18397,0.0230428,-0.0051563,-0.999721,1
2994,2640,14,307,2651,29,183,8818,1290,10108,0.0225641,-0.0223986,-0.999494,1
5477,4757,24,583,4587,46,361,15835,2009,17844,-0.0172827,0.000310167,-0.999851,1
3748,3021,17,363,2950,30,219,10348,1536,11884,-0.0236623,-0.0355475,-0.999088,1
3459,2595,18,384,2569,32,186,9243,1735,10978,-0.00343439,-0.0617477,-0.998086,1
4304,2895,24,370,2907,44,219,10763,2345,13108,-0.00773876,-0.0406494,-0.999144,1
3181,2033,16,245,1977,28,131,7611,2267,9878,-0.0159089,-0.0601844,-0.99806,1
5660,3220,33,373,3112,52,229,12679,3005,15684,-0.00472037,0.0511379,-0.99868,1
3493,2168,24,260,2136,32,148,8261,3235,11496,-0.0153268,0.00941272,-0.999838,1
2729,1435,15,181,1433,23,108,5924,2208,8132,-0.0218578,-0.0476371,-0.998626,1
3488,2004,20,239,1996,37,134,7918,5116,13034,0.020694,0.0663422,-0.997582,1
4428,2426,32,330,2383,42,175,9816,4232,14048,-0.00803955,0.0802568,-0.996742,1
2232,1202,13,164,1195,34,93,4933,2122,7055,-0.0308957,0.118862,-0.99243,1
3154,1692,18,251,1666,44,125,6950,2380,9330,-0.0303139,0.16329,-0.986112,1
3095,1548,18,196,1630,40,150,6677,3233,9910,-0.0240635,0.188647,-0.98175,1
3117,1484,17,183,1521,30,111,6463,2567,9030,-0.0172542,0.18227,-0.983097,1
4175,2020,26,261,2064,38,168,8752,3116,11868,-0.00348338,0.216389,-0.976301,1
2840,1309,17,203,1322,25,123,5839,2218,8057,-0.0258641,0.164443,-0.986047,1
4206,1979,25,235,1960,38,168,8611,3416,12027,0.0226488,0.230217,-0.972876,1
3817,1824,33,250,1998,47,180,8149,2610,10759,0.00859968,0.191705,-0.981415,1
2105,1059,13,145,1088,22,86,4518,2663,7181,0.0377107,0.215138,-0.975855,1
3141,1628,20,199,1652,31,111,6782,2661,9443,-0.012619,0.170611,-0.985258,1
4293,2499,26,364,2439,55,202,9878,4996,14874,0.0180685,0.183658,-0.982824,1
4048,2496,24,336,2392,50,197,9543,2337,11880,-0.00942002,0.072858,-0.997298,1
2153,1359,14,192,1315,32,104,5169,2367,7536,0.00703331,0.0928669,-0.995654,1
4545,2834,25,387,2376,101,162,10430,4050,14480,0.0603373,0.106256,-0.992506,1
2841,1743,18,201,1804,32,114,6753,2996,9749,0.0584132,0.0952815,-0.993735,1
4058,2460,31,314,2449,54,187,9553,3080,12633,0.0192571,0.0477469,-0.998674,1
2165,1323,14,180,1314,29,108,5133,1792,6925,-0.0138448,0.0767963,-0.996951,1
3895,2404,30,317,2292,41,167,9146,4064,13210,0.0161623,0.0812286,-0.996564,1
4426,2429,26,309,2369,100,204,9863,5248,15111,0.048884,0.126999,-0.990697,1
2821,1754,18,223,1821,38,209,6884,2965,9849,0.0300957,0.055354,-0.998013,1
2614,1592,17,186,1730,28,126,6293,2534,8827,0.0167896,0.125094,-0.992003,1
4915,2708,32,384,2615,68,197,10919,3665,14584,0.0476222,0.167088,-0.984791,1
2906,1873,19,245,1852,32,146,7073,2787,9860,0.0401642,0.150076,-0.987858,1
4482,2754,28,380,2877,49,211,10781,3133,13914,0.0508551,0.179344,-0.982471,1
2308,1727,15,211,1713,23,111,6108,1374,7482,0.0644819,0.111535,-0.991666,1
4787,3794,34,442,3464,40,241,12802,2193,14995,0.0553013,0.109259,-0.992474,1
4460,4032,29,416,3705,47,241,12930,1743,14673,0.0711283,0.0968752,-0.992752,1
2555,2067,16,245,2073,19,132,7107,1534,8641,0.0556006,0.118887,-0.99135,1
4491,3095,25,381,2986,33,228,11239,1894,13133,0.0317504,0.0904254,-0.995397,1
4947,4054,34,537,4735,47,222,14576,1790,16366,0.0380376,0.0664976,-0.997061,1
2569,2149,18,269,2097,26,159,7287,1520,8807,0.0208755,0.0635082,-0.997763,1
3998,3422,34,424,3321,29,250,11478,2267,13745,0.0352805,0.0511292,-0.998069,1
4034,3520,26,450,3340,44,240,11654,2540,14194,-0.0252854,0.0257582,-0.999348,1
2574,2363,20,302,2253,21,163,7696,2212,9908,0.00513013,0.00505521,-0.999974,1
4556,3688,30,460,3544,73,294,12645,1772,14417,-0.00139147,0.0142789,-0.999897,1
3200,2744,21,318,2544,53,238,9118,1584,10702,0.00922261,0.0202095,-0.999753,1
2960,2376,21,285,2351,27,179,8199,2294,10493,-0.00414595,-0.0106456,-0.999935,1
4947,3937,32,468,3933,47,307,13671,1954,15625,0.0163978,0.00919777,-0.999823,1
2808,2064,18,269,2097,30,158,7444,1841,9285,0.00163445,0.0454719,-0.998964,1
4493,3756,30,413,3516,40,290,12538,2232,14770,0.0316691,-0.0123892,-0.999422,1
3268,2531,22,306,2501,39,166,8833,1966,10799,0.00643449,0.0171415,-0.999832,1
3701,2966,25,347,2851,32,200,10122,2088,12210,0.0129459,0.0134915,-0.999825,1
4849,4020,34,608,4005,40,262,13818,1885,15703,-0.00477659,0.0318276,-0.999482,1
2543,2104,17,244,2031,20,135,7094,1866,8960,0.000949468,0.0271445,-0.999631,1
3976,3298,28,389,3189,32,211,11123,1590,12713,0.00318206,0.0337258,-0.999426,1
5047,4110,48,527,3454,34,181,13401,1555,14956,-0.0169638,0.0107202,-0.999799,1
2062,1702,15,221,1671,21,109,5801,1283,7084,0.00461596,0.0202497,-0.999784,1
4760,3938,29,411,3570,41,234,12983,2166,15149,-0.0020806,0.0300213,-0.999547,1
4977,4013,34,464,4123,72,269,13952,2168,16120,0.0151716,0.0255093,-0.999559,1
2541,2079,18,244,2055,26,198,7161,1443,8604,0.0120229,-0.00376271,-0.999921,1
3071,2527,26,289,2513,31,194,8651,1968,10619,-0.000576186,0.0324032,-0.999475,1
4819,3659,34,433,3382,37,246,12610,2192,14802,-0.00429235,0.0168559,-0.999849,1
2583,2035,17,240,1906,24,129,6934,1459,8393,-0.00309568,0.0118385,-0.999925,1
2583,2296,19,309,2185,21,145,7558,1569,9127,0.0166011,-0.00403234,-0.999854,1
4878,4104,42,529,3858,31,317,13759,2742,16501,0.00496883,0.0193135,-0.999801,1
4340,3847,37,601,3805,47,238,12915,2033,14948,-0.00324683,0.0225663,-0.99974,1
3158,2572,20,339,2517,28,179,8813,1884,10697,0.00259147,0.0406827,-0.999169,1
2767,2037,17,243,1942,22,141,7169,1269,8438,0.0199771,0.0144537,-0.999696,1
5116,3969,31,462,4755,43,322,14698,1768,16466,0.00364352,0.000579398,-0.999993,1
2700,2054,18,248,1975,17,155,7167,1329,8496,0.010757,0.0124367,-0.999865,1
2935,2542,20,299,2508,21,171,8496,2624,11120,0.00213434,0.0348145,-0.999392,1
3726,3044,32,374,3030,30,216,10452,2065,12517,0.0210129,0.0199024,-0.999581,1
2732,2257,17,286,2260,19,163,7734,2164,9898,-0.0114099,0.0125384,-0.999856,1
4697,3673,31,486,3589,34,251,12761,1843,14604,0.000790045,-0.000417201,-1,1
2417,1971,17,234,1943,22,130,6734,1560,8294,-0.0101778,0.00469573,-0.999937,1
4442,3688,30,463,3594,34,269,12520,2354,14874,0.0252356,0.0158692,-0.999556,1
3895,2625,22,320,2658,25,193,9738,1596,11334,-0.00516409,0.0137586,-0.999892,1
2380,2069,17,257,1993,21,150,6887,1242,8129,0.000831615,0.011453,-0.999934,1
4775,3669,36,444,3543,42,269,12778,2297,15075,-0.00137736,0.0188237,-0.999822,1
4387,3676,30,484,3708,57,288,12630,1812,14442,-0.00338482,0.0124129,-0.999917,1
2474,1976,20,251,1932,32,133,6818,1395,8213,0.00154135,-0.00062923,-0.999999,1
4818,3810,41,480,3856,53,322,13380,2000,15380,0.00596743,0.0218067,-0.999744,1
2537,2055,21,246,2044,28,140,7071,1449,8520,-0.00986846,0.0043217,-0.999942,1
5033,3979,38,526,3707,45,245,13573,1761,15334,-0.000561198,0.0303816,-0.999538,1
2435,1970,17,260,1950,23,151,6806,1214,8020,-0.0133536,0.0243882,-0.999613,1
4579,3648,33,442,3546,31,260,12539,3871,16410,-0.0261177,0.0207807,-0.999443,1
3104,2743,28,405,2579,25,199,9083,1682,10765,-0.0104977,0.0143253,-0.999842,1
2407,1976,16,251,1975,17,146,6788,1326,8114,0.00925193,0.0139124,-0.99986,1
3667,2986,26,347,2908,42,250,10226,2288,12514,-0.0163138,0.0220186,-0.999624,1
3581,2967,24,343,2818,24,194,9951,1777,11728,-0.000197748,0.0231845,-0.999731,1
3380,2722,27,329,2714,33,185,9390,1700,11090,0.0292233,0.014403,-0.999469,1
4320,3846,37,542,3447,41,233,12466,2323,14789,0.00854087,0.00651066,-0.999942,1
3101,2484,20,292,2540,26,166,8629,1837,10466,0.00574793,0.0123445,-0.999907,1
5069,4068,38,498,3967,38,262,13940,2108,16048,-0.00967149,0.0387572,-0.999202,1
2533,2032,17,252,2011,18,145,7008,1467,8475,0.00653589,0.0100076,-0.999929,1
3158,2465,21,303,2535,27,164,8673,1942,10615,-0.00418979,-0.0060923,-0.999973,1
4507,3636,32,444,3486,43,284,12432,2304,14736,0.00587583,0.00374196,-0.999976,1
3089,2547,26,308,2636,27,195,8828,1811,10639,0.00388613,0.0149897,-0.99988,1
4435,3651,52,437,3637,32,236,12480,2457,14937,-0.00913752,0.00390427,-0.999951,1
3082,2545,26,307,2545,30,171,8706,1582,10288,-0.0114163,0.0149978,-0.999822,1
3991,3261,33,398,3116,41,218,11058,2034,13092,0.0118588,-0.00715124,-0.999904,1
4669,3631,33,436,3515,33,260,12577,2252,14829,-0.0173379,0.0205351,-0.999639,1
3259,2520,25,302,2559,33,177,8875,2107,10982,-0.0121759,0.0493104,-0.998709,1
3647,3102,31,396,2957,41,234,10408,2253,12661,-0.00499055,0.00936046,-0.999944,1
3704,2985,31,395,2964,33,223,10335,2183,12518,0.020297,0.00944602,-0.999749,1
5328,3660,30,457,3510,36,275,13296,2051,15347,-0.0140241,0.0284104,-0.999498,1
3121,2614,22,324,2481,28,192,8782,1502,10284,-0.0166034,0.0454446,-0.998829,1
5328,3543,30,474,3518,39,260,13192,2654,15846,0.00505818,0.0206995,-0.999773,1
3131,2607,28,349,2494,33,196,8838,1662,10500,0.010173,0.0207711,-0.999732,1
1985,1862,15,223,1887,22,136,6130,1341,7471,0.00805575,-0.00544009,-0.999953,1
5869,4170,33,507,3981,43,288,14891,2623,17514,0.0140101,0.00816923,-0.999868,1
3182,2602,22,316,2595,24,176,8917,1846,10763,-9.93068e-05,-0.0153346,-0.999882,1
2751,2240,20,286,2206,26,148,7677,1518,9195,-0.00991559,0.0139374,-0.999854,1
5184,3930,32,464,3889,41,259,13799,2640,16439,0.0151164,-0.00310771,-0.999881,1
3578,2819,23,321,2727,27,182,9677,1668,11345,0.0201037,0.00304283,-0.999793,1
3345,2788,29,426,2692,33,200,9513,1823,11336,0.0284223,0.00167701,-0.999595,1
4587,3967,37,415,3207,25,164,12402,1958,14360,-0.00195686,-0.00820909,-0.999964,1
2445,2185,23,360,2489,18,146,7666,1418,9084,-0.00781957,0.00744737,-0.999942,1
4568,4044,39,436,3339,27,189,12642,1859,14501,-0.00679215,0.00920958,-0.999935,1
2427,2152,17,246,1909,21,126,6898,1565,8463,-0.00164576,0.0256155,-0.999671,1
3686,3052,26,343,3137,31,193,10468,2265,12733,0.0128331,-0.00439947,-0.999908,1
3674,3115,28,352,2945,33,195,10342,2071,12413,-0.0104338,0.0151155,-0.999831,1
3613,3039,26,388,2968,79,234,10347,1489,11836,0.00225303,0.0311865,-0.999511,1
4395,3768,23,337,2546,27,191,11287,1195,12482,0.0142503,0.00755156,-0.99987,2
1995,1645,14,210,1614,15,123,5616,1143,6759,-0.0127754,0.00813154,-0.999885,2
4537,3645,39,457,3552,36,285,12551,1771,14322,-0.00274407,-0.00983949,-0.999948,2
3126,2678,21,295,2671,27,165,8983,1786,10769,-0.00146209,0.00955632,-0.999953,2
3455,2602,22,348,2609,28,193,9257,2155,11412,0.00710233,0.0111412,-0.999913,2
3101,2573,21,335,2561,48,167,8806,1923,10729,-0.00281886,-0.00625583,-0.999976,2
4389,3741,34,444,3486,42,231,12367,2306,14673,-0.00387192,0.0281056,-0.999597,2
3114,2545,26,295,2521,19,128,8648,1181,9829,-0.00971847,-0.00667043,-0.999931,2
2286,1828,17,222,1832,24,121,6330,1320,7650,0.0181851,0.00968079,-0.999788,2
3453,2971,30,369,2626,25,176,9650,3041,12691,0.01026,0.0242498,-0.999653,2
4783,4944,42,725,4746,80,291,15611,2153,17764,-0.000271128,0.0271184,-0.999632,2
2308,1695,15,216,1673,16,134,6057,981,7038,-0.0129861,0.0154855,-0.999796,2
1409,1087,12,152,1054,10,79,3803,661,4464,0.0024383,0.0278471,-0.999609,2
1356,1142,12,137,1099,11,81,3838,732,4570,0.0040578,0.0259501,-0.999655,2
4350,3643,30,473,3554,40,267,12357,3329,15686,0.0182643,0.00712961,-0.999808,2
4448,3578,30,547,4122,28,173,12926,1646,14572,0.011993,0.00482424,-0.999916,2
2423,1958,17,228,1906,21,127,6680,1263,7943,-0.00448562,-0.00983915,-0.999942,2
4862,3662,31,422,3721,37,231,12966,1913,14879,0.0121093,0.00117842,-0.999926,2
3081,2527,25,305,2725,37,257,8957,1952,10909,0.00154722,0.0187834,-0.999822,2
3592,3028,38,370,2975,35,195,10233,1879,12112,0.00248494,0.0156794,-0.999874,2
4905,4415,43,490,3838,56,270,14017,1958,15975,0.00684733,0.00319083,-0.999971,2
2557,2152,17,276,2129,25,149,7305,1380,8685,0.0133251,0.00558615,-0.999896,2
4885,3857,37,426,3795,43,270,13313,2153,15466,0.0109361,0.00804885,-0.999908,2
4385,3582,35,445,3401,42,178,12068,1596,13664,0.0279282,0.00429177,-0.999601,2
2398,2005,20,234,1919,22,133,6731,1379,8110,-0.00653908,0.0166571,-0.99984,2
4778,3505,36,503,4011,46,255,13134,2087,15221,-0.00522037,-0.0017649,-0.999985,2
4049,3200,32,388,3167,34,225,11095,2073,13168,-0.000611793,0.00926264,-0.999957,2
4155,3418,45,526,3335,37,272,11788,1556,13344,-0.00859833,0.015424,-0.999844,2
2356,1968,17,230,1838,16,137,6562,1231,7793,-0.00685423,0.010467,-0.999922,2
3487,2869,27,383,2685,38,189,9678,1756,11434,0.0111088,0.00197713,-0.999936,2
4457,4011,44,600,3850,46,291,13299,1918,15217,0.01835,0.017529,-0.999678,2
3129,2518,25,359,2586,26,165,8808,1592,10400,0.00810814,0.00151354,-0.999966,2
4881,4182,33,506,4073,44,287,14006,2639,16645,0.0127578,0.0120647,-0.999846,2
3499,2875,24,338,2717,26,196,9675,1569,11244,0.00247777,0.0089809,-0.999957,2
4953,3730,30,449,4209,51,331,13753,1730,15483,-0.011205,0.0189228,-0.999758,2
2151,1594,17,211,1486,15,99,5573,942,6515,0.0146766,0.00949671,-0.999847,2
1505,1184,10,148,1144,9,75,4075,765,4840,-0.00240097,-0.000444138,-0.999997,2
1747,1426,13,181,1441,13,103,4924,959,5883,0.0197495,0.0214358,-0.999575,2
4477,3602,30,417,3471,40,232,12269,2431,14700,-0.00680122,0.00198359,-0.999975,2
4585,3843,37,537,3606,23,165,12796,1667,14463,0.0191467,0.00625658,-0.999797,2
2935,2311,21,291,2380,22,166,8126,1755,9881,-0.00755759,0.0122499,-0.999896,2
3064,2391,21,300,2342,25,169,8312,1664,9976,0.0152312,0.0290059,-0.999463,2
4200,3689,31,464,3574,39,264,12261,2681,14942,-0.0040254,0.00908672,-0.999951,2
4588,3698,36,481,2790,28,201,11822,1594,13416,0.0154947,-0.0104841,-0.999825,2
2050,1639,13,273,2279,22,121,6397,1181,7578,0.0143552,0.01765,-0.999741,2
4976,4003,33,547,3889,45,306,13799,2638,16437,0.00356059,0.0342392,-0.999407,2
3452,2743,28,362,2735,27,209,9556,1740,11296,-0.0150101,0.00806133,-0.999855,2
4068,3414,38,428,3234,30,249,11461,2861,14322,-0.000312189,0.0162862,-0.999867,2
4021,3371,28,425,3344,43,180,11412,1642,13054,-0.00395165,0.00667875,-0.99997,2
2298,1856,17,223,1831,16,125,6366,1313,7679,0.0142356,-0.00538017,-0.999884,2
4965,4016,36,549,3977,39,305,13887,2366,16253,-0.00134499,0.0259228,-0.999663,2
4920,3922,36,546,2604,22,145,12195,1588,13783,-0.00855396,0.0103413,-0.99991,2
2092,1770,16,247,1704,16,111,5956,1176,7132,0.0271694,0.0111291,-0.999569,2
3672,3127,25,435,3013,35,278,10585,2045,12630,0.0050932,0.00567766,-0.999971,2
3736,3163,26,432,3050,28,246,10681,2192,12873,0.0121812,0.027879,-0.999537,2
4548,3571,30,437,3593,37,273,12489,1853,14342,0.000877004,0.0209915,-0.999779,2
2460,2027,17,265,2026,21,162,6978,1892,8870,0.0113725,-0.0210991,-0.999713,2
4789,3749,32,537,3619,36,294,13056,2168,15224,-0.0115332,0.00765081,-0.999904,2
2480,2009,17,268,2286,23,154,7237,1468,8705,0.0103191,-0.0152222,-0.999831,2
4582,3700,29,486,3622,45,263,12727,2260,14987,-0.0243574,-0.0207282,-0.999488,2
3243,2551,21,299,2490,27,192,8823,1665,10488,0.00404352,0.00751203,-0.999964,2
4491,3683,32,460,3930,46,326,12968,2038,15006,-0.00201287,0.0134766,-0.999907,2
5011,4700,41,501,3824,37,277,14391,2051,16442,-0.00970928,0.0315494,-0.999455,2
2555,2091,22,273,2028,29,160,7158,1546,8704,-0.00189279,0.0147707,-0.999889,2
5046,3969,39,541,3812,54,278,13739,2920,16659,0.021006,0.0246687,-0.999475,2
3185,2594,27,343,2846,32,215,9242,1805,11047,-0.00733409,0.00284102,-0.999969,2
4425,3603,38,470,3495,57,271,12359,2815,15174,-0.0236063,0.0158881,-0.999595,2
3243,2580,21,332,2531,31,238,8976,1732,10708,0.0104097,0.00541336,-0.999931,2
3759,3012,25,386,3024,33,225,10464,2069,12533,0.00180468,0.0239637,-0.999711,2
5167,3752,30,420,3436,30,231,13066,1911,14977,0.0056942,0.0396108,-0.999199,2
2469,1994,17,250,1961,22,142,6855,1777,8632,-0.0103914,0.0124963,-0.999868,2
4745,3865,31,461,3734,37,269,13142,1811,14953,0.00769299,0.0365518,-0.999302,2
3145,2575,22,333,2613,26,200,8914,1620,10534,0.0272586,-0.0213742,-0.9994,2
5078,3993,39,517,3935,55,301,13918,1957,15875,0.0348231,-0.00393309,-0.999386,2
3505,2742,23,321,2801,33,197,9622,2161,11783,0.00094597,-0.000943893,-0.999999,2
2636,2072,18,246,2125,19,139,7255,1755,9010,-0.0267173,0.0209822,-0.999423,2
5192,3973,30,426,3465,32,236,13354,2570,15924,0.00303456,0.0171517,-0.999848,2
3259,2806,26,523,3348,25,197,10184,1937,12121,0.00558493,0.00820312,-0.999951,2
2987,2450,19,277,2478,23,177,8411,1836,10247,-0.000978897,-0.0206388,-0.999787,2
3774,3001,30,370,3063,36,205,10479,2503,12982,-0.0133726,-0.00939451,-0.999866,2
3788,3063,30,374,2882,35,216,10388,2029,12417,-0.013389,-0.000477038,-0.99991,2
2860,2246,19,259,2252,22,146,7804,1884,9688,0.0358881,-0.00669155,-0.999333,2
4503,3690,37,436,3552,45,243,12506,2650,15156,0.0263394,0.0238154,-0.999369,2
3185,2612,25,307,2497,37,173,8836,2162,10998,-0.015112,0.00604517,-0.999868,2
4542,3781,37,508,3492,60,268,12688,2232,14920,-0.00681413,0.0033402,-0.999971,2
3294,2575,27,324,2587,27,166,9000,1863,10863,-0.00128755,0.00838397,-0.999964,2
2991,2428,23,275,2369,24,154,8264,2022,10286,0.0261656,-0.0170195,-0.999513,2
5399,3705,30,462,3623,38,238,13495,1833,15328,-0.0098497,0.00240519,-0.999949,2
2480,2013,17,255,1984,20,153,6922,1341,8263,0.0266136,-0.0106586,-0.999589,2
4725,3738,31,482,3730,42,282,13030,2505,15535,0.0263779,-0.00154454,-0.999651,2
5109,3992,33,470,3684,25,178,13491,2032,15523,0.0173184,0.000439672,-0.99985,2
2130,1764,15,233,1704,16,112,5974,1485,7459,0.0120494,0.0203798,-0.99972,2
5124,3907,35,467,3851,34,259,13677,1898,15575,0.003427,0.00358059,-0.999988,2
2743,2182,18,275,2099,24,161,7502,1804,9306,0.00721522,-0.00685687,-0.99995,2
4494,3787,30,508,3607,32,308,12766,2559,15325,-0.0213018,0.00169994,-0.999772,2
3218,2616,27,329,2639,22,187,9038,1498,10536,0.0170904,-0.00685863,-0.99983,2
2342,1918,15,330,2647,23,139,7414,1252,8666,0.00424681,-0.0166396,-0.999853,2
4609,3614,36,434,3558,48,331,12630,1922,14552,-0.0123149,-0.001381,-0.999923,2
2515,1980,18,235,1938,22,133,6841,1507,8348,-0.01601,-0.0173719,-0.999721,2
5076,4125,33,480,3965,38,268,13985,2537,16522,-0.00519468,-0.00596056,-0.999969,2
3533,2868,24,370,2781,33,190,9799,1888,11687,-0.0100418,-0.0179373,-0.999789,2
4506,3713,31,470,3648,41,255,12664,2862,15526,0.0334374,0.0206087,-0.999228,2
3989,3368,26,376,3279,30,219,11287,1982,13269,-0.00924762,0.00910264,-0.999916,2
4198,3878,38,442,3247,34,245,12082,1590,13672,-0.00869595,0.00848365,-0.999926,2
2339,1903,16,226,1892,17,124,6517,1208,7725,-0.0233376,-0.000122628,-0.999728,2
2799,2232,18,268,2197,18,146,7678,1837,9515,-0.0156845,0.00482606,-0.999865,2
5034,4248,44,458,3598,50,246,13678,1797,15475,0.00524306,-0.00181322,-0.999985,2
3259,2684,21,317,2662,26,183,9152,1491,10643,-0.0114185,0.00551729,-0.99992,2
2807,1911,15,234,1889,26,133,7015,1241,8256,-0.00874204,0.00909115,-0.99992,2
2346,1949,16,255,1883,22,130,6601,1492,8093,-0.0127157,0.0060053,-0.999901,2
5263,4134,38,482,3702,43,244,13906,2342,16248,0.0194808,-0.00446489,-0.9998,2
3263,2572,26,373,2477,30,174,8915,1585,10500,-0.0102774,-0.00731296,-0.99992,2
3737,3060,29,357,3018,31,203,10435,1916,12351,-0.0197954,-0.0140709,-0.999705,2
3713,3029,44,363,3053,38,207,10447,2166,12613,-0.00182908,-0.000375557,-0.999998,2
3793,3222,30,387,3060,36,210,10738,1828,12566,0.00738227,0.00615748,-0.999954,2
2840,2248,22,351,2623,23,149,8256,1598,9854,0.00247669,0.00334161,-0.999991,2
5233,4061,32,468,3896,30,189,13909,1939,15848,-0.0244166,-0.0227537,-0.999443,2
2707,2100,22,257,2046,30,143,7305,1347,8652,-0.0232458,-0.0170359,-0.999585,2
4747,3612,38,482,3697,51,250,12877,2477,15354,0.0276285,0.0212269,-0.999393,2
3204,2593,22,324,2708,24,167,9042,1637,10679,0.00493402,-0.00977356,-0.99994,2
5017,3828,47,442,3541,52,246,13173,2729,15902,-0.00159516,0.00116499,-0.999998,2
3196,2760,22,337,2676,27,194,9212,1894,11106,-0.013076,-0.0101275,-0.999863,2
2596,2088,16,276,1989,18,154,7137,1450,8587,-0.00253894,-0.0221802,-0.999751,2
3032,2446,26,286,2325,27,163,8305,1526,9831,-0.00955241,0.00402599,-0.999946,2
3883,2996,30,362,2961,36,206,10474,1895,12369,-0.0208005,-0.00386741,-0.999776,2
3812,3923,31,558,3146,44,252,11766,1669,13435,0.00014936,0.00881384,-0.999961,2
2285,1773,16,210,1781,16,117,6198,1263,7461,-0.0159387,-0.00199434,-0.999871,2
5566,4558,36,525,4019,39,320,15063,2142,17205,-0.00372641,-0.00180551,-0.999991,2
5079,4151,33,517,3930,33,230,13973,1940,15913,-0.0052701,0.00400418,-0.999978,2
2365,1710,16,215,1824,34,143,6307,1172,7479,0.0346639,-0.000614282,-0.999399,2
4703,3636,30,467,3620,36,280,12772,2769,15541,-0.00786068,-0.0236036,-0.99969,2
3278,2630,26,344,2550,30,196,9054,1905,10959,-0.0109776,-0.0257486,-0.999608,2
5002,4218,44,565,4273,28,216,14346,2074,16420,0.0252693,0.00158131,-0.999679,2
2174,1737,18,233,1679,21,131,5993,1409,7402,-0.0295637,-0.00211853,-0.999561,2
4881,3910,29,481,3553,43,248,13145,2057,15202,0.0332668,0.0116625,-0.999378,2
3222,2686,25,308,2544,30,175,8990,1905,10895,0.0260007,0.00406404,-0.999654,2
3032,2370,22,283,2457,29,175,8368,1622,9990,0.0172137,0.00930967,-0.999808,2
4720,3644,39,429,3988,49,248,13117,1494,14611,0.00976858,-0.01722,-0.999804,2
2470,2039,21,238,2080,27,138,7013,1359,8372,-0.000311877,0.000664104,-1,2
5353,4183,51,633,3950,48,283,14501,1858,16359,-0.0134098,-0.0111257,-0.999848,2
3211,2657,26,305,2511,31,174,8915,2009,10924,0.0119429,-0.00211093,-0.999926,2
4174,3360,39,422,3161,32,215,11403,2438,13841,-0.00584957,-0.0226451,-0.999726,2
3043,2469,20,329,2390,22,177,8450,2092,10542,0.0237484,0.000212061,-0.999718,2
3799,3136,27,397,2996,38,232,10625,1798,12423,0.00682994,-0.00938317,-0.999933,2
3509,2862,30,358,2852,31,199,9841,1920,11761,0.00836243,-0.00109113,-0.999964,2
3467,2825,23,361,2718,23,179,9596,1972,11568,-0.0148665,-0.0177171,-0.999733,2
3487,2839,24,330,2792,48,186,9706,2205,11911,0.00766404,-0.0135888,-0.999878,2
4622,3599,29,416,3577,37,274,12554,2145,14699,-0.0311663,0.00440656,-0.999505,2
3234,2555,27,309,2585,31,201,8942,1959,10901,-0.00407249,-0.0263745,-0.999644,2
4569,3595,44,455,3548,44,257,12512,2207,14719,-0.024738,0.00081141,-0.999694,2
4580,3654,44,437,3550,31,179,12475,1688,14163,-0.0148444,-0.022501,-0.999637,2
2508,1990,20,236,1910,28,134,6826,1561,8387,-0.00989275,-0.010456,-0.999896,2
4599,3608,45,434,3511,62,246,12505,1799,14304,-0.0173374,-0.00486366,-0.999838,2
3821,2662,25,310,2615,29,224,9686,1689,11375,-0.00055299,-0.0096808,-0.999953,2
4131,3301,26,381,3300,39,236,11414,2122,13536,0.00820483,-0.0106245,-0.99991,2
2999,2379,20,305,2467,46,158,8374,1788,10162,-0.0235758,-0.0171264,-0.999575,2
3809,3447,31,406,3079,34,202,11008,1730,12738,0.0152453,-0.00731943,-0.999857,2
2822,2247,18,268,2293,21,149,7818,1449,9267,-0.00148262,-0.0243576,-0.999702,2
5278,4319,40,484,3895,42,272,14330,1836,16166,-0.00722901,-0.00226499,-0.999971,2
2627,2169,21,254,2146,38,149,7404,1517,8921,0.000766852,-0.0126191,-0.99992,2
5026,3843,36,434,3690,40,246,13315,1980,15295,0.0457789,-0.00656159,-0.99893,2
2491,1980,38,251,1923,27,135,6845,1356,8201,0.00325895,0.00828334,-0.99996,2
4746,3667,29,425,3596,40,236,12739,2314,15053,-0.0234065,-0.0266685,-0.99937,2
4543,3649,31,475,3444,40,175,12357,1606,13963,-0.0072574,0.000360917,-0.999974,2
2540,2004,17,249,1999,19,129,6957,1561,8518,0.00723975,-0.0185995,-0.999801,2
4641,3724,31,451,3544,39,240,12670,2648,15318,0.00628825,-0.000800556,-0.99998,2
3249,2669,21,336,2604,29,192,9100,1534,10634,0.00757418,-0.0130239,-0.999886,2
3013,2470,21,312,2397,23,181,8417,1857,10274,-0.0201706,-0.0118932,-0.999726,2
5035,4254,34,484,4000,36,262,14105,1959,16064,0.0340464,-0.0110251,-0.999359,2
3450,2957,26,427,2708,25,196,9789,1956,11745,-0.0199855,-0.00646864,-0.999779,2
4659,3862,113,483,3644,37,239,13037,1739,14776,-0.0209844,0.00105655,-0.999779,2
2533,2112,20,258,2028,21,145,7117,1443,8560,-0.00425364,0.00297103,-0.999987,2
5985,4312,38,585,3992,39,275,15226,2049,17275,0.00596295,-0.0213281,-0.999755,2
2638,2145,18,247,2068,20,138,7274,1692,8966,0.00219101,-0.00862662,-0.99996,2
4910,3821,36,433,3670,42,254,13166,1822,14988,0.017413,0.0017973,-0.999847,2
3254,2566,27,314,2526,34,177,8898,1739,10637,-0.00521894,0.00244111,-0.999983,2
3820,3113,30,406,2974,36,243,10622,2391,13013,0.0274722,-0.00431333,-0.999613,2
5224,4082,38,467,3775,44,324,13954,2389,16343,-0.0262108,-0.00199198,-0.999654,2
3304,2576,26,357,2509,31,174,8977,1850,10827,0.00333349,-0.0111006,-0.999933,2
3048,2412,24,325,2386,23,184,8402,1511,9913,-0.0143862,-0.00370655,-0.99989,2
5556,4294,39,486,3766,45,245,14431,1971,16402,0.00372226,0.00085922,-0.999993,2
3238,2625,28,340,2483,30,195,8939,1448,10387,-0.00789161,-0.0127111,-0.999888,2
3799,3102,30,433,3191,36,234,10825,2046,12871,-0.00391496,-0.0171737,-0.999845,2
3837,3236,30,386,3075,29,227,10820,2924,13744,0.00857229,-0.00587384,-0.999946,2
2859,2355,19,293,2242,18,166,7952,1567,9519,-0.00636056,-0.0208902,-0.999762,2
4516,4257,30,486,3640,38,273,13240,2117,15357,0.0097587,-0.0275566,-0.999573,2
3258,2626,23,338,2573,23,192,9033,1925,10958,-0.0156552,-0.0189572,-0.999698,2
3264,2399,19,343,2453,27,184,8689,2070,10759,-0.0149593,-0.0064323,-0.999867,2
5050,3591,32,436,3965,29,174,13277,1820,15097,-0.00239789,-0.0151374,-0.999883,2
2548,1988,17,237,1978,19,129,6916,1757,8673,-0.00660096,-0.00388422,-0.999971,2
4547,3578,31,568,4353,58,247,13382,1866,15248,0.00635764,0.00790186,-0.999949,2
3186,2678,21,356,2575,26,168,9010,1739,10749,-0.02352,0.0141371,-0.999623,2
3277,2427,22,281,2586,30,165,8788,1447,10235,-0.0224379,-0.000611345,-0.999748,2
4584,3674,31,427,3613,31,246,12606,2184,14790,-0.0187542,-0.00238628,-0.999821,2
3462,2737,33,337,2791,25,193,9578,1807,11385,-0.0104307,-0.00955438,-0.9999,2
2547,2074,16,240,2103,19,134,7133,1410,8543,-0.00590537,-0.00605996,-0.999964,2
4620,3691,30,482,3623,51,289,12786,3507,16293,0.0080122,-0.0047142,-0.999957,2
3213,2602,26,311,2882,32,180,9246,1339,10585,0.0255212,-0.0249797,-0.999362,2
2836,2374,20,294,2214,27,176,7941,1625,9566,0.00444162,-0.0128033,-0.999908,2
5247,4034,43,477,4073,40,268,14182,1679,15861,-0.000755502,0.00739349,-0.999972,2
5230,4109,35,543,3982,55,271,14225,2092,16317,-0.00476311,0.0540123,-0.998529,2
2583,1900,22,310,1809,13,109,6746,964,7710,-0.0102833,0.0285374,-0.99954,2
1604,1302,10,163,1305,12,96,4492,820,5312,-0.00329297,0.0388,-0.999242,2
3294,2715,21,348,2766,41,202,9387,1884,11271,-0.0195175,0.0797912,-0.996621,2
5365,4259,28,500,3896,51,245,14344,2641,16985,-0.0351963,0.0823777,-0.995979,2
3428,2490,23,286,2488,36,159,8910,1908,10818,0.0160005,0.0400264,-0.999071,2
2418,1725,17,198,1676,19,108,6161,2015,8176,-0.00138709,0.0948304,-0.995492,2
4762,3329,28,416,3737,68,279,12619,3547,16166,0.0163569,0.0581088,-0.998176,2
3407,2121,19,268,2126,24,159,8124,2084,10208,-0.00124408,0.0425423,-0.999094,2
5364,2716,30,360,2128,29,154,10781,2382,13163,-0.00837177,0.154415,-0.987971,2
1863,945,11,136,904,16,66,3941,1186,5127,0.0315512,0.106919,-0.993767,2
1140,601,11,74,569,17,43,2455,1475,3930,0.0108489,0.0604354,-0.998113,2
1028,471,15,65,499,8,33,2119,698,2817,0.0144189,0.0655672,-0.997744,2
4753,1857,28,230,1786,38,128,8820,3254,12074,-0.00111117,0.0900249,-0.995939,2
4479,2017,40,256,1509,36,107,8444,3888,12332,0.014722,0.0296881,-0.999451,2
3114,969,22,129,1087,24,68,5413,2891,8304,0.0178528,0.0627832,-0.997868,2
3982,1102,37,164,1069,35,80,6469,3839,10308,0.0168311,0.0803302,-0.996626,2
3921,1265,24,189,971,31,100,6501,4523,11024,0.0213349,0.0794481,-0.996611,2
2913,676,17,114,643,22,61,4446,2523,6969,0.0302689,0.0573033,-0.997898,2
3518,757,22,134,711,38,84,5264,3440,8704,0.023369,0.0826238,-0.996307,2
4444,830,26,176,830,35,92,6433,3053,9486,0.0154976,0.10352,-0.994507,2
4324,726,32,153,687,41,73,6036,3900,9936,0.0438309,0.0586722,-0.997315,2
2244,310,15,55,276,19,29,2948,1759,4707,-0.0212122,0.0590746,-0.998028,2
3919,477,26,114,463,31,50,5080,3707,8787,-0.0198826,0.147164,-0.988912,2
4198,504,28,119,474,51,68,5442,3829,9271,-0.0289877,0.183667,-0.982561,2
3981,456,28,85,425,31,62,5068,3549,8617,-0.0215135,0.0722294,-0.997156,2
2714,336,19,59,318,38,34,3518,2501,6019,-0.0301474,0.0569088,-0.997924,2
4110,614,28,115,558,39,60,5524,2357,7881,-0.00530448,0.0660835,-0.9978,2
4061,815,28,162,734,48,88,5936,3303,9239,0.00412511,0.0442243,-0.999013,2
4242,839,29,133,818,46,76,6183,3442,9625,-0.00343289,0.115968,-0.993247,2
4358,1063,28,201,1086,42,87,6865,2898,9763,-0.000180721,0.0997454,-0.995013,2
2916,847,19,147,781,36,126,4872,2090,6962,0.0182574,0.0317842,-0.999328,2
4367,1453,28,234,1404,35,121,7642,2476,10118,0.00919604,0.0893271,-0.99596,2
4088,1669,25,249,1748,53,130,7962,2489,10451,-0.00419914,0.113606,-0.993517,2
3865,2192,24,257,2053,36,154,8581,2439,11020,-0.00205429,0.0896384,-0.995972,2
4822,3679,28,542,3500,34,254,12859,2325,15184,0.00830784,0.0869279,-0.99618,2
3409,2997,19,417,2902,33,219,9996,1513,11509,-0.00106892,0.0611385,-0.998129,2
6061,5212,29,600,5216,27,231,17376,3290,20666,-0.032738,0.103983,-0.99404,2
2609,2352,13,282,2354,29,160,7799,1387,9186,-0.0519112,0.130612,-0.990074,2
5571,5001,38,617,4226,49,250,15752,1605,17357,-0.048583,0.180222,-0.982425,2
2470,2403,13,291,2402,23,162,7764,1306,9070,-0.0371102,0.177617,-0.9834,2
5603,4941,29,604,4907,53,359,16496,2363,18859,0.00449405,0.109995,-0.993922,2
3774,3568,27,464,2952,47,187,11019,1639,12658,-0.0187006,0.117339,-0.992916,2
2326,1715,14,226,1709,23,121,6134,995,7129,-0.000985207,0.0813919,-0.996682,2
5154,3408,24,443,3400,56,229,12714,2599,15313,-0.0227425,0.114943,-0.993112,2
3588,2404,23,436,2515,71,214,9251,2253,11504,-0.0374867,0.0416938,-0.998427,2
3641,2101,22,307,2089,37,150,8347,2051,10398,-0.0187474,0.0625834,-0.997864,2
5531,3186,27,445,3009,39,194,12431,3074,15505,-0.0302318,0.0740907,-0.996793,2
3438,2085,24,242,1939,39,107,7874,3693,11567,-0.0340667,0.0371935,-0.998727,2
2459,1322,17,164,1276,28,95,5361,3079,8440,-0.0349021,0.0271114,-0.999023,2
4392,2238,25,307,2188,38,157,9345,7697,17042,-0.0460908,0.102673,-0.993647,2
2874,1343,16,182,1320,25,119,5879,4448,10327,-0.0287821,0.138369,-0.989962,2
3409,1516,24,199,1539,37,117,6841,4596,11437,-0.0284193,0.164419,-0.985981,2
4129,1786,29,213,1651,59,146,8013,4710,12723,-0.0625428,0.206434,-0.97646,2
4037,1871,27,223,1765,40,130,8093,3481,11574,-0.0734654,0.258148,-0.963308,2
2057,862,12,127,727,16,61,3862,1649,5511,-0.0641969,0.133664,-0.988945,2
1219,528,9,68,505,11,37,2377,975,3352,-0.0392747,0.0838473,-0.995704,2
3941,1618,23,192,1796,37,127,7734,3623,11357,-0.0769954,0.231796,-0.969713,2
4341,1790,27,281,1678,33,157,8307,3449,11756,-0.104172,0.260175,-0.959926,2
4127,1666,24,213,2115,35,167,8347,2970,11317,-0.0816242,0.259973,-0.96216,2
2533,1115,16,138,1140,21,98,5061,1778,6839,-0.0717862,0.220427,-0.972758,2
3727,1736,25,253,1712,46,162,7661,2658,10319,-0.0344089,0.186612,-0.981831,2
4103,2268,27,315,2454,56,161,9384,2730,12114,-0.016405,0.223608,-0.974541,2
4131,2004,20,272,1822,24,142,8415,1558,9973,-0.0152423,0.263945,-0.964417,2
2915,2463,20,307,2462,22,193,8382,1384,9766,-0.00609379,0.225773,-0.974161,2
4910,4278,39,527,4177,54,314,14299,1808,16107,-0.0240847,0.271079,-0.962256,2
3186,2973,22,365,2965,34,223,9768,1803,11571,-0.0211945,0.23621,-0.971471,2
5394,4983,33,634,4809,41,313,16207,1700,17907,-0.0584227,0.265344,-0.962382,2
6404,4835,22,372,3302,31,205,15171,1567,16738,-0.0639275,0.261904,-0.962974,2
2238,1960,13,225,1904,19,132,6491,1239,7730,-0.0474114,0.229218,-0.97222,2
3748,2877,20,335,2792,32,175,9979,2095,12074,-0.0679461,0.245446,-0.967026,2
4406,3086,27,400,3241,53,283,11496,2307,13803,-0.055824,0.203511,-0.97748,2
2332,1380,14,161,1395,19,92,5393,1884,7277,-0.0515281,0.161671,-0.985499,2
4789,2475,30,271,2107,38,156,9866,4208,14074,-0.0505695,0.185494,-0.981343,2
4364,1462,24,204,1459,32,106,7651,6957,14608,-0.0572983,0.225013,-0.97267,2
1845,565,15,75,538,15,42,3095,4656,7751,-0.0592022,0.227892,-0.971885,2
4515,1290,48,176,1313,47,112,7501,-1000,-1000,-1,-1,-1,2
1279,381,11,54,371,17,27,2140,-1000,-1000,-1,-1,-1,2
1338,395,10,57,375,16,32,2223,8613,10836,-0.165502,0.59299,-0.788018,2
3081,1007,18,139,945,26,73,5289,-1000,-1000,-1,-1,-1,2
1668,506,11,91,530,13,37,2856,2111,4967,-0.0200998,0.0902893,-0.995713,2
2392,730,14,100,703,22,55,4016,2879,6895,-0.0371717,0.132786,-0.990447,2
4101,1210,25,166,1283,48,106,6939,2830,9769,-0.0318535,0.128041,-0.991257,2
4479,1314,29,233,1213,41,108,7417,4826,12243,-0.0378484,0.169995,-0.984718,2
3058,870,20,116,768,24,62,4918,2770,7688,-0.00208739,0.0951106,-0.995465,2
5637,1111,37,198,1138,44,112,8277,3322,11599,-0.0683508,0.107083,-0.991898,2
3774,782,21,139,699,39,65,5519,2097,7616,0.00766104,0.0949791,-0.99545,2
5561,992,31,155,1037,43,88,7907,3307,11214,-0.00629236,0.0956367,-0.995396,2
4643,817,24,123,812,43,70,6532,2187,8719,0.0134407,0.147171,-0.98902,2
4465,1012,29,186,912,57,106,6767,3810,10577,0.00662786,-0.011459,-0.999912,2
4605,926,29,179,938,40,70,6787,2277,9064,0.0127981,-0.0114718,-0.999852,2
2267,487,15,90,452,31,47,3389,1799,5188,0.0163981,-0.0131229,-0.999779,2
3758,838,29,122,767,39,73,5626,3502,9128,0.150584,0.0931861,-0.984196,2
3673,829,27,126,812,50,75,5592,3215,8807,0.00308315,0.110087,-0.993917,2
4343,1186,32,205,1204,40,95,7105,3487,10592,0.015266,0.120002,-0.992656,2
4644,1571,35,216,1293,47,114,7920,1808,9728,-0.0116563,0.108634,-0.994013,2
2471,887,17,120,869,27,77,4468,1381,5849,0.0188057,0.123044,-0.992223,2
4500,1889,28,287,1851,45,156,8756,2746,11502,-0.00434236,0.141595,-0.989915,2
4571,2210,23,314,2305,39,225,9687,1712,11399,0.0252482,0.135631,-0.990438,2
5060,3197,43,518,2908,44,202,11972,3153,15125,0.00200023,0.181257,-0.983434,2
2958,1755,14,233,1790,24,98,6872,1196,8068,0.0131064,0.127579,-0.991742,2
1951,1246,9,142,1166,13,77,4604,1061,5665,0.00739508,0.0963345,-0.995322,2
1512,1109,9,142,1106,12,83,3973,827,4800,0.0106306,0.102446,-0.994682,2
2992,2609,15,331,2774,24,172,8917,2278,11195,-0.0284783,0.0783033,-0.996523,2
5302,4811,26,614,4574,29,247,15603,2123,17726,-0.0278029,0.0726667,-0.996969,2
2966,2901,15,357,2796,21,214,9270,1696,10966,-0.0146094,0.0991572,-0.994965,2
5424,5527,24,672,4745,32,272,16696,1477,18173,-0.0329304,0.103076,-0.994128,2
2442,2422,12,309,2432,28,177,7822,1378,9200,-0.00719776,0.0934226,-0.995601,2
3261,3291,15,462,3247,44,236,10556,1547,12103,-0.0200224,0.0905395,-0.995692,2
5568,5455,24,730,5367,33,275,17452,1747,19199,-0.0125342,0.0813332,-0.996608,2
3028,3168,14,385,3143,29,221,9988,1749,11737,-0.0506114,0.105296,-0.993152,2
4663,4749,22,554,4728,61,303,15080,1490,16570,-0.00370491,0.111161,-0.993795,2
3388,3627,18,407,3496,35,231,11202,1446,12648,-0.0226667,0.0561977,-0.998162,2
2668,3007,14,330,2841,26,184,9070,1334,10404,-0.0226156,0.0147084,-0.999636,2
3698,4069,20,462,3898,48,258,12453,1864,14317,-0.000948531,0.017121,-0.999853,2
3710,4074,20,458,3973,51,269,12555,2493,15048,-0.0281148,0.0348335,-0.998998,2
5729,5912,23,697,4377,26,264,17028,1829,18857,0.000583807,0.0494656,-0.998776,2
2539,2689,16,299,2654,31,170,8398,1408,9806,0.00216234,0.0630722,-0.998007,2
4424,4434,19,527,4428,36,272,14140,2031,16171,-0.0280145,0.0835937,-0.996106,2
4336,4378,23,512,4210,48,277,13784,1552,15336,-0.0264533,0.0830305,-0.996196,2
3083,2910,16,332,2947,27,190,9505,1263,10768,-0.0188627,0.0341923,-0.999237,2
3853,3514,19,387,3469,36,223,11501,1539,13040,-0.0579836,0.0492971,-0.9971,2
4635,4164,24,470,4072,44,269,13678,1816,15494,-0.0260512,0.0533306,-0.998237,2
3378,3032,16,355,3029,39,196,10045,1340,11385,-0.0302742,0.0104396,-0.999487,2
5577,4964,30,555,4529,48,223,15926,1803,17729,-0.0311222,0.0206816,-0.999302,2
6308,5361,34,613,5082,56,311,17765,1916,19681,-0.0265451,0.00281716,-0.999644,2
2609,2240,14,253,1905,30,120,7171,1122,8293,-0.0373652,-0.00290302,-0.999297,2
1831,1410,8,161,1367,19,91,4887,616,5503,-0.0176657,0.0152973,-0.999727,2
1520,1361,9,155,1325,16,88,4474,674,5148,-0.0386256,0.00988617,-0.999205,2
5831,5273,27,642,5043,80,300,17196,1701,18897,-0.0283601,0.0311,-0.999114,2
6037,5355,31,658,5632,48,249,18010,1984,19994,-0.0397976,0.013205,-0.999121,2
2560,2248,11,218,1873,30,125,7065,1028,8093,-0.0226314,0.018555,-0.999572,2
1659,1447,10,167,1334,16,83,4716,690,5406,-0.00551316,-0.0123082,-0.999909,2
6307,5417,33,608,4301,49,237,16952,1646,18598,-0.0207736,0.0258369,-0.99945,2
2590,2248,14,259,2280,24,148,7563,1041,8604,-0.0303296,0.0103964,-0.999486,2
4464,4080,23,495,3988,48,261,13359,1856,15215,-0.0212969,0.00399579,-0.999765,2
3358,3050,16,367,2994,38,191,10014,1562,11576,-0.00910976,0.0265125,-0.999607,2
5854,4851,29,557,4470,59,262,16082,1596,17678,-0.0349663,0.0112303,-0.999325,2
3023,2750,17,340,2694,34,199,9057,1242,10299,-0.0338836,0.0128045,-0.999344,2
4597,4107,30,508,4034,62,297,13635,2254,15889,-0.03035,0.00873571,-0.999501,2
6115,5441,31,682,5217,44,280,17810,1711,19521,-0.032594,0.0142733,-0.999367,2
2756,2221,12,238,1903,23,131,7284,998,8282,-0.0266357,-0.000337899,-0.999645,2
1831,1435,8,181,1426,23,103,5007,745,5752,-0.0159704,0.0112175,-0.99981,2
1531,1381,9,169,1406,17,123,4636,816,5452,-0.0244986,-0.029431,-0.999267,2
2998,2916,14,317,2891,27,178,9341,1416,10757,-0.0337805,0.00996971,-0.99938,2
6252,5333,29,591,5153,69,321,17748,2167,19915,-0.0237248,-0.0276128,-0.999337,2
3070,2651,15,349,2943,26,180,9234,1230,10464,-0.0287635,0.0142594,-0.999485,2
2667,2416,12,301,2452,21,153,8022,1306,9328,-0.0156365,-0.0135495,-0.999786,2
6119,5341,31,595,4594,36,231,16947,1602,18549,-0.0165067,-0.000834489,-0.999863,2
2429,2191,11,267,2160,27,138,7223,1205,8428,-0.0344289,-0.00928284,-0.999364,2
3285,2861,15,425,2865,42,222,9715,1490,11205,-0.0269566,0.0200326,-0.999436,2
5434,4710,27,551,4475,67,319,15583,1916,17499,-0.0344675,0.00129825,-0.999405,2
2878,2504,12,297,2545,25,160,8421,1236,9657,-0.032035,0.000821694,-0.999486,2
4290,3936,18,429,3651,42,234,12600,1924,14524,-0.0341683,0.000303998,-0.999416,2
3140,2837,17,328,2821,32,186,9361,1917,11278,-0.0232751,0.00823975,-0.999695,2
6203,5417,32,639,4963,41,248,17543,1719,19262,-0.0366445,-0.0096027,-0.999282,2
6037,5439,32,627,4222,53,247,16657,1400,18057,-0.0229056,-0.0129041,-0.999654,2
2593,2063,13,223,1939,40,131,7002,819,7821,-0.00567789,0.0120959,-0.999911,2
1501,1324,10,155,1334,17,85,4426,709,5135,-0.029928,0.00372798,-0.999545,2
6284,5295,24,555,4959,43,356,17516,1747,19263,-0.0266565,0.0116674,-0.999577,2
6372,4404,19,469,3314,24,211,14813,1375,16188,-0.00623038,-0.00343512,-0.999975,2
6177,4247,18,483,3182,26,210,14343,1103,15446,-0.0110149,-0.0122179,-0.999865,2
2326,2231,12,250,2248,21,146,7234,1070,8304,-0.0330161,0.00535127,-0.99944,2
6042,4930,24,558,4911,51,267,16783,1769,18552,-0.0254847,-0.0140563,-0.999576,2
3063,2683,13,309,2737,23,185,9013,1192,10205,-0.0266854,0.00128565,-0.999643,2
3555,3082,14,350,3019,29,196,10245,1676,11921,-0.0221368,0.00570382,-0.999739,2
6256,5847,26,713,4814,34,274,17964,1302,19266,-0.0308745,0.00150099,-0.999522,2
3155,2145,10,239,1948,17,137,7651,839,8490,-0.0378029,0.0155802,-0.999164,2
1638,1485,8,179,1425,11,93,4839,763,5602,-0.0199474,0.0200274,-0.9996,2
2205,2028,12,242,1983,17,138,6625,1017,7642,-0.0186905,-0.0105445,-0.99977,2
