Downsample[ns],BuildFilTree[ns],SearchFil[ns],DeleteFil[ns],BuildTreeSub[ns],SearchSub[ns],DeleteSub[ns],PreProcTotal[ns],Plane[ns],Total[ns],nx,ny,nz,planeCount
0,0,0,0,0,2416,444,2860,1249,4109,-0.0748654,-0.0834853,-0.993693,0
0,0,0,0,0,2354,453,2807,1080,3887,0.0448227,0.0819919,-0.995625,0
0,0,0,0,0,2473,478,2951,1173,4124,0.0382326,0.0392635,-0.998497,0
0,0,0,0,0,2399,456,2855,1158,4013,0.0169091,0.0545177,-0.99837,0
0,0,0,0,0,2394,478,2872,1126,3998,0.0123655,0.0639076,-0.997879,0
0,0,0,0,0,3052,600,3652,1700,5352,0.00693006,0.0530426,-0.998568,0
0,0,0,0,0,2343,452,2795,1035,3830,0.0269091,0.0179073,-0.999477,0
0,0,0,0,0,2392,447,2839,985,3824,-0.0112526,0.0425083,-0.999033,0
0,0,0,0,0,2366,435,2801,865,3666,-0.00510077,0.0649472,-0.997876,0
0,0,0,0,0,2441,424,2865,1012,3877,0.00442496,0.0134275,-0.9999,0
0,0,0,0,0,2639,441,3080,973,4053,-0.00396803,0.0537876,-0.998545,0
0,0,0,0,0,2549,476,3025,1033,4058,-0.00653099,0.0532773,-0.998558,0
0,0,0,0,0,2499,426,2925,962,3887,0.0109541,0.0487215,-0.998752,0
0,0,0,0,0,2465,439,2904,949,3853,-0.0136334,0.0497221,-0.99867,0
0,0,0,0,0,2339,443,2782,1029,3811,-0.0158653,0.053856,-0.998423,0
0,0,0,0,0,2365,496,2861,1069,3930,-0.0184689,0.0461902,-0.998762,0
0,0,0,0,0,2938,445,3383,1092,4475,0.000377904,0.0328919,-0.999459,0
0,0,0,0,0,2325,463,2788,961,3749,0.00664152,-0.00622144,-0.999959,0
0,0,0,0,0,2343,434,2777,967,3744,0.00940598,-0.015363,-0.999838,0
0,0,0,0,0,2385,479,2864,1081,3945,-0.0111757,0.0250836,-0.999623,0
0,0,0,0,0,2424,461,2885,1111,3996,0.00862505,0.0296227,-0.999524,0
0,0,0,0,0,2505,464,2969,1003,3972,0.0151317,0.0231924,-0.999616,0
0,0,0,0,0,2555,456,3011,1056,4067,0.0230612,0.0217806,-0.999497,0
0,0,0,0,0,2487,455,2942,1139,4081,0.02228,0.0489987,-0.99855,0
0,0,0,0,0,2537,462,2999,1169,4168,0.0272317,0.0406663,-0.998802,0
0,0,0,0,0,2394,450,2844,1099,3943,0.0201373,-9.33161e-05,-0.999797,0
0,0,0,0,0,2488,441,2929,1123,4052,0.0060092,-0.0091182,-0.99994,0
0,0,0,0,0,2400,447,2847,971,3818,0.0205328,-0.0199333,-0.99959,0
0,0,0,0,0,2557,432,2989,987,3976,-0.0138089,0.0169529,-0.999761,0
0,0,0,0,0,2457,443,2900,1030,3930,0.00504072,0.0177851,-0.999829,0
0,0,0,0,0,2642,446,3088,914,4002,-0.0179638,0.0141472,-0.999739,0
0,0,0,0,0,2356,445,2801,1012,3813,-0.0450588,0.0820135,-0.995612,0
0,0,0,0,0,2423,443,2866,1124,3990,-0.0424209,0.0384975,-0.998358,0
0,0,0,0,0,2521,479,3000,1116,4116,0.0337784,0.0307755,-0.998955,0
0,0,0,0,0,2503,437,2940,1205,4145,0.00464001,-0.000361758,-0.999989,0
0,0,0,0,0,2518,442,2960,927,3887,0.0152117,0.00594349,-0.999867,0
0,0,0,0,0,2428,447,2875,820,3695,-0.0224675,0.0252141,-0.99943,0
0,0,0,0,0,2351,436,2787,1092,3879,-0.023702,0.0180269,-0.999557,0
0,0,0,0,0,2492,460,2952,1045,3997,-0.0252196,0.0567568,-0.998069,0
0,0,0,0,0,2404,443,2847,1068,3915,-0.0132039,0.0475699,-0.998781,0
0,0,0,0,0,2431,447,2878,1004,3882,0.00299582,0.0553409,-0.998463,0
0,0,0,0,0,2494,450,2944,991,3935,0.00164949,0.0266682,-0.999643,0
0,0,0,0,0,2349,445,2794,944,3738,-0.0228365,0.0131416,-0.999653,0
0,0,0,0,0,2456,441,2897,936,3833,-0.0139355,0.0388864,-0.999146,0
0,0,0,0,0,2438,440,2878,940,3818,-0.0207787,0.0538517,-0.998333,0
0,0,0,0,0,2555,446,3001,959,3960,-0.00169465,0.0448028,-0.998994,0
0,0,0,0,0,3465,453,3918,1092,5010,0.00867732,0.043797,-0.999003,0
0,0,0,0,0,2524,437,2961,1034,3995,-0.00583588,0.0448967,-0.998975,0
0,0,0,0,0,2383,449,2832,1013,3845,0.00710621,0.0657742,-0.997809,0
0,0,0,0,0,2498,428,2926,1159,4085,0.00849184,0.027081,-0.999597,0
0,0,0,0,0,2366,453,2819,926,3745,0.0157183,0.0133745,-0.999787,0
0,0,0,0,0,2466,440,2906,1026,3932,0.0104655,0.0107158,-0.999888,0
0,0,0,0,0,2562,467,3029,915,3944,-0.0205288,0.0472892,-0.99867,0
0,0,0,0,0,2423,454,2877,999,3876,-0.0192529,0.0123275,-0.999739,0
0,0,0,0,0,2554,440,2994,993,3987,-0.0407797,0.0367256,-0.998493,0
0,0,0,0,0,2523,443,2966,995,3961,-0.0398859,0.0589529,-0.997464,0
0,0,0,0,0,2460,444,2904,1005,3909,-0.0648077,0.0653666,-0.995755,0
0,0,0,0,0,2505,480,2985,1091,4076,-0.0546235,0.0906754,-0.994381,0
0,0,0,0,0,2454,445,2899,1316,4215,-0.0281159,0.0555087,-0.998062,0
0,0,0,0,0,2436,452,2888,980,3868,-0.0321313,0.085654,-0.995807,0
0,0,0,0,0,2548,439,2987,1202,4189,-0.0349891,0.0847872,-0.995785,0
0,0,0,0,0,2856,464,3320,1183,4503,-0.046285,0.10869,-0.992998,0
0,0,0,0,0,2523,458,2981,965,3946,-0.05484,0.1216,-0.991063,0
0,0,0,0,0,2465,449,2914,1611,4525,-0.0726093,0.142583,-0.987116,0
0,0,0,0,0,2413,448,2861,1712,4573,-0.0369523,0.0880825,-0.995428,0
0,0,0,0,0,2568,515,3083,1362,4445,-0.0379497,0.0812118,-0.995974,0
0,0,0,0,0,2411,447,2858,1260,4118,-0.0375926,0.080932,-0.99601,0
0,0,0,0,0,2619,513,3132,1455,4587,-0.026315,0.0606071,-0.997815,0
0,0,0,0,0,2522,466,2988,1035,4023,-0.0308477,0.089443,-0.995514,0
0,0,0,0,0,2424,439,2863,1460,4323,-0.0314106,0.0880821,-0.995618,0
0,0,0,0,0,2593,460,3053,1391,4444,-0.0369849,0.112897,-0.992918,0
0,0,0,0,0,2604,436,3040,2228,5268,-0.0515106,0.135602,-0.989423,0
0,0,0,0,0,2472,462,2934,1277,4211,-0.0124745,0.113767,-0.993429,0
0,0,0,0,0,2372,466,2838,1337,4175,0.00392153,0.119858,-0.992783,0
0,0,0,0,0,2421,432,2853,1695,4548,-0.0507328,0.0504878,-0.997435,0
0,0,0,0,0,4095,538,4633,1587,6220,0.0170569,-0.00196391,-0.999853,0
0,0,0,0,0,2624,442,3066,1019,4085,0.0147879,0.00338154,-0.999885,0
0,0,0,0,0,2556,452,3008,1055,4063,0.0215989,0.00431631,-0.999757,0
0,0,0,0,0,2507,431,2938,934,3872,0.0268049,-0.00026455,-0.999641,0
0,0,0,0,0,2610,480,3090,1156,4246,0.0301422,0.0315472,-0.999048,0
0,0,0,0,0,2556,471,3027,1170,4197,-0.0027869,0.0726786,-0.997352,0
0,0,0,0,0,2936,517,3453,1039,4492,-0.00577882,0.0635094,-0.997965,0
0,0,0,0,0,2564,438,3002,1357,4359,0.00500169,0.0586014,-0.998269,0
0,0,0,0,0,2420,438,2858,1299,4157,0.0126528,0.0312107,-0.999433,0
0,0,0,0,0,2435,483,2918,988,3906,-0.0345599,0.0258617,-0.999068,0
0,0,0,0,0,2594,480,3074,1071,4145,-0.0538989,0.0181165,-0.998382,0
0,0,0,0,0,2435,473,2908,983,3891,-0.0755502,-0.00975767,-0.997094,0
0,0,0,0,0,2525,467,2992,1183,4175,-0.0572765,0.0292201,-0.997931,0
0,0,0,0,0,2612,472,3084,1209,4293,-0.0184809,0.0748994,-0.99702,0
0,0,0,0,0,2533,482,3015,1146,4161,-0.0239496,0.0595744,-0.997937,0
0,0,0,0,0,2519,506,3025,1053,4078,-0.0343889,0.0598411,-0.997615,0
0,0,0,0,0,2534,479,3013,1188,4201,-0.0415529,0.0878216,-0.995269,0
0,0,0,0,0,2435,491,2926,1124,4050,-0.00884444,0.0404319,-0.999143,0
0,0,0,0,0,2558,491,3049,1251,4300,-0.0540034,0.024931,-0.998229,0
0,0,0,0,0,2418,476,2894,1188,4082,-0.0767338,0.0177514,-0.996894,0
0,0,0,0,0,2450,491,2941,1096,4037,-0.0677885,0.0471506,-0.996585,0
0,0,0,0,0,2660,483,3143,1321,4464,-0.0462093,0.0479093,-0.997782,0
0,0,0,0,0,2636,557,3193,1410,4603,-0.0334045,0.0590511,-0.997696,0
0,0,0,0,0,2443,474,2917,1178,4095,-0.0156202,0.0241716,-0.999586,0
0,0,0,0,0,2488,474,2962,1218,4180,-0.0489029,0.00189147,-0.998802,0
0,0,0,0,0,2409,448,2857,1099,3956,-0.0505472,0.00456009,-0.998711,0
0,0,0,0,0,2640,492,3132,1038,4170,-0.041894,0.006158,-0.999103,0
0,0,0,0,0,2474,456,2930,844,3774,-0.0313667,-0.00401675,-0.9995,0
0,0,0,0,0,2543,457,3000,1073,4073,-0.042728,0.00669588,-0.999064,0
0,0,0,0,0,2503,487,2990,1018,4008,-0.0423162,0.00013649,-0.999104,0
0,0,0,0,0,2774,470,3244,1229,4473,-0.0402025,0.0250944,-0.998876,0
0,0,0,0,0,2523,469,2992,1077,4069,-0.0441305,0.0519987,-0.997672,0
0,0,0,0,0,4211,634,4845,1873,6718,-0.0419668,0.0276324,-0.998737,0
0,0,0,0,0,2580,508,3088,1355,4443,-0.0294142,0.0876536,-0.995717,0
0,0,0,0,0,2542,447,2989,1330,4319,-0.00477477,-0.0140798,-0.999889,0
0,0,0,0,0,2442,446,2888,827,3715,-0.000314008,0.0144294,-0.999896,0
0,0,0,0,0,2475,461,2936,1155,4091,0.0010046,-0.0263685,-0.999652,0
0,0,0,0,0,2611,455,3066,875,3941,0.00200619,-0.0397364,-0.999208,0
0,0,0,0,0,2840,460,3300,888,4188,0.00152886,-0.069171,-0.997604,0
0,0,0,0,0,3969,669,4638,1578,6216,0.026947,-0.0840118,-0.9961,0
0,0,0,0,0,2511,487,2998,1027,4025,0.0436062,-0.0304528,-0.998585,0
0,0,0,0,0,2565,466,3031,999,4030,0.02991,-0.0164587,-0.999417,0
0,0,0,0,0,2948,507,3455,897,4352,0.00390024,-0.000925373,-0.999992,0
0,0,0,0,0,2598,454,3052,820,3872,0.0139006,-0.0102592,-0.999851,0
0,0,0,0,0,2484,471,2955,836,3791,0.00861554,-0.0082637,-0.999929,0
0,0,0,0,0,2572,430,3002,838,3840,-0.00516907,-0.00617838,-0.999968,0
0,0,0,0,0,2769,491,3260,880,4140,-0.00272549,-0.0227627,-0.999737,0
0,0,0,0,0,2534,458,2992,830,3822,-0.000248193,-0.0487034,-0.998813,0
0,0,0,0,0,2797,456,3253,952,4205,-0.0147251,-0.0481792,-0.99873,0
0,0,0,0,0,2812,521,3333,1071,4404,-0.00504951,0.0176833,-0.999831,0
0,0,0,0,0,2789,440,3229,1012,4241,-0.0177435,0.198723,-0.979895,0
0,0,0,0,0,2811,474,3285,869,4154,-0.0146938,0.190048,-0.981665,0
0,0,0,0,0,2761,462,3223,1107,4330,-0.000312113,0.142627,-0.989776,0
0,0,0,0,0,2725,483,3208,1105,4313,0.0051942,0.128463,-0.991701,0
0,0,0,0,0,2725,450,3175,1200,4375,-0.0175197,0.11769,-0.992896,0
0,0,0,0,0,2769,492,3261,1252,4513,0.0153568,0.0435021,-0.998935,0
0,0,0,0,0,2682,466,3148,1343,4491,-0.00705511,0.050856,-0.998681,0
0,0,0,0,0,2828,466,3294,1386,4680,-0.000460122,-0.0196634,-0.999807,0
0,0,0,0,0,3042,483,3525,1904,5429,-0.0414154,0.524691,-0.850285,0
0,0,0,0,0,3020,483,3503,1164,4667,-0.0299484,0.412918,-0.910276,0
0,0,0,0,0,2907,526,3433,2220,5653,-0.017145,0.417046,-0.908724,0
0,0,0,0,0,2870,498,3368,3236,6604,-0.00262635,0.459762,-0.888038,0
0,0,0,0,0,3098,571,3669,2612,6281,0.0180601,0.227774,-0.973547,0
0,0,0,0,0,2993,543,3536,3019,6555,-0.0120748,0.167927,-0.985726,0
0,0,0,0,0,3175,556,3731,2963,6694,0.0191468,-0.130625,-0.991247,0
0,0,0,0,0,3135,534,3669,2306,5975,0.0258567,-0.131332,-0.991001,0
0,0,0,0,0,3147,544,3691,2757,6448,0.0164359,-0.0496275,-0.998633,0
0,0,0,0,0,3254,564,3818,2411,6229,0.0507837,0.146095,-0.987966,0
0,0,0,0,0,2977,558,3535,2279,5814,0.00741799,-0.0622448,-0.998033,0
0,0,0,0,0,3525,555,4080,1797,5877,0.0314804,-0.0470404,-0.998397,0
0,0,0,0,0,3434,628,4062,1767,5829,0.00515093,0.0157642,-0.999862,0
0,0,0,0,0,3207,547,3754,1538,5292,-0.001777,-0.0154744,-0.999879,0
0,0,0,0,0,3092,555,3647,1594,5241,0.00196576,-0.0463384,-0.998924,0
0,0,0,0,0,3031,534,3565,1875,5440,0.0519484,-0.0414574,-0.997789,0
0,0,0,0,0,3043,556,3599,1883,5482,0.0992622,-0.169056,-0.980595,0
0,0,0,0,0,3157,537,3694,1914,5608,0.0148821,0.0614246,-0.998001,0
0,0,0,0,0,2991,609,3600,1669,5269,-0.008004,0.103086,-0.99464,0
0,0,0,0,0,2912,534,3446,1176,4622,-0.0131706,0.0583076,-0.998212,0
0,0,0,0,0,2786,542,3328,1990,5318,-0.0140099,0.184999,-0.982639,0
0,0,0,0,0,2936,524,3460,1993,5453,-0.0225561,-0.0094732,-0.999701,0
0,0,0,0,0,2972,581,3553,2261,5814,-0.00698625,-0.00414868,-0.999967,0
0,0,0,0,0,2832,536,3368,4419,7787,0.00512473,0.160967,-0.986946,0
0,0,0,0,0,2741,476,3217,8432,11649,-0.0452494,0.253871,-0.966179,0
0,0,0,0,0,2506,478,2984,8259,11243,-0.101291,0.408253,-0.907232,0
0,0,0,0,0,2673,484,3157,14439,17596,-0.465565,-0.152479,-0.871779,0
0,0,0,0,0,2622,524,3146,18406,21552,0.0115696,0.20622,-0.978437,0
0,0,0,0,0,2720,473,3193,7880,11073,0.202672,-0.137018,-0.969613,0
0,0,0,0,0,2743,494,3237,3161,6398,0.24614,-0.0554426,-0.967647,0
0,0,0,0,0,2663,451,3114,4367,7481,0.208322,-0.213014,-0.954582,0
0,0,0,0,0,2690,533,3223,1668,4891,0.19815,-0.213752,-0.956581,0
0,0,0,0,0,2775,468,3243,1210,4453,-0.00591937,-0.205446,-0.97865,0
0,0,0,0,0,2725,492,3217,1035,4252,0.00585886,-0.282007,-0.959394,0
0,0,0,0,0,2680,484,3164,955,4119,-0.00589215,-0.357266,-0.933984,0
0,0,0,0,0,2871,548,3419,935,4354,-0.0122066,-0.423907,-0.905624,0
0,0,0,0,0,2740,508,3248,831,4079,-0.0262512,-0.490719,-0.870922,0
0,0,0,0,0,3345,524,3869,776,4645,-0.00826966,0.0111841,-0.999903,0
0,0,0,0,0,2898,507,3405,959,4364,0.00185848,0.0551369,-0.998477,0
0,0,0,0,0,2863,526,3389,962,4351,0.000729105,-0.0591349,-0.99825,0
0,0,0,0,0,2989,534,3523,882,4405,-0.016629,-0.16007,-0.986966,0
0,0,0,0,0,3023,553,3576,1035,4611,-0.0384442,-0.240615,-0.969859,0
0,0,0,0,0,2844,529,3373,837,4210,-0.0489997,-0.278311,-0.95924,0
0,0,0,0,0,2874,535,3409,1316,4725,-0.0604559,-0.377398,-0.924075,0
0,0,0,0,0,3254,541,3795,1408,5203,-0.0763519,-0.46448,-0.882286,0
0,0,0,0,0,2876,540,3416,1323,4739,-0.0930829,-0.517088,-0.850856,0
0,0,0,0,0,2946,583,3529,1614,5143,-0.139682,-0.672535,-0.726764,0
0,0,0,0,0,2691,551,3242,1301,4543,-0.0105441,0.00010371,-0.999944,0
0,0,0,0,0,2878,554,3432,1506,4938,-0.0510091,-0.144436,-0.988199,0
0,0,0,0,0,2678,562,3240,1166,4406,0.0216328,-0.00691301,-0.999742,0
0,0,0,0,0,2656,604,3260,1317,4577,-0.00808214,-0.11113,-0.993773,0
0,0,0,0,0,2693,556,3249,1243,4492,0.00463409,-0.0882543,-0.996087,0
0,0,0,0,0,2575,533,3108,1349,4457,-0.00662543,-0.231706,-0.972763,0
0,0,0,0,0,2607,570,3177,1920,5097,-0.010752,0.0601779,-0.99813,0
0,0,0,0,0,2548,561,3109,1388,4497,-0.00987036,0.0886355,-0.996015,0
0,0,0,0,0,2815,553,3368,2372,5740,-0.0166503,0.0419017,-0.998983,0
0,0,0,0,0,2576,560,3136,2391,5527,-0.0324806,-0.202601,-0.978723,0
0,0,0,0,0,2625,538,3163,2563,5726,-0.0506136,-0.174225,-0.983404,0
0,0,0,0,0,3339,610,3949,2346,6295,-9.96102e-05,0.120471,-0.992717,0
0,0,0,0,0,2780,547,3327,2575,5902,-0.0753175,-0.0974548,-0.992386,0
0,0,0,0,0,3305,652,3957,2792,6749,0.0158008,0.181306,-0.9833,0
0,0,0,0,0,2580,551,3131,3202,6333,0.0481017,0.222334,-0.973783,0
0,0,0,0,0,2493,562,3055,2425,5480,-0.00911802,-0.11708,-0.993081,0
0,0,0,0,0,2691,568,3259,2029,5288,-0.00111019,-0.0352411,-0.999378,0
0,0,0,0,0,2810,594,3404,2055,5459,-0.0142257,-0.190922,-0.981502,0
0,0,0,0,0,3212,539,3751,1266,5017,-0.00431791,-0.313715,-0.949507,0
0,0,0,0,0,4194,751,4945,2236,7181,-0.0433658,-0.213413,-0.975999,0
0,0,0,0,0,2473,512,2985,1400,4385,-0.0615228,0.153388,-0.986249,0
0,0,0,0,0,2716,494,3210,1318,4528,0.0179748,0.118819,-0.992753,0
0,0,0,0,0,2495,574,3069,1177,4246,-0.00342525,0.0216048,-0.999761,0
0,0,0,0,0,2579,463,3042,1213,4255,0.00662358,0.101125,-0.994852,0
0,0,0,0,0,2589,513,3102,981,4083,-0.000476544,0.0941072,-0.995562,0
0,0,0,0,0,2634,452,3086,1227,4313,0.0251121,-0.0990947,-0.994761,0
0,0,0,0,0,2606,477,3083,885,3968,0.00393884,-0.107785,-0.994166,0
0,0,0,0,0,2637,450,3087,1073,4160,-0.0253116,-0.141138,-0.989666,0
0,0,0,0,0,2781,483,3264,896,4160,-0.0228756,-0.180733,-0.983266,0
0,0,0,0,0,2919,505,3424,1201,4625,-0.0381509,-0.227251,-0.973089,0
0,0,0,0,0,2709,480,3189,1176,4365,-0.0322969,-0.293987,-0.955263,0
0,0,0,0,0,4686,700,5386,2536,7922,-0.0223782,-0.0567738,-0.998136,0
0,0,0,0,0,2921,525,3446,1916,5362,0.01569,0.232726,-0.972416,0
0,0,0,0,0,2715,517,3232,1755,4987,0.0253482,0.264008,-0.964187,0
0,0,0,0,0,2833,472,3305,1881,5186,0.0286496,0.402089,-0.915152,0
0,0,0,0,0,2852,511,3363,1719,5082,0.0255852,0.441972,-0.896664,0
0,0,0,0,0,2836,497,3333,1823,5156,0.0190804,0.418383,-0.90807,0
0,0,0,0,0,3196,528,3724,2417,6141,0.000409723,0.14381,-0.989605,0
0,0,0,0,0,2740,556,3296,2446,5742,0.00281878,-0.0945626,-0.995515,0
0,0,0,0,0,2849,530,3379,2783,6162,0.00408429,-0.299427,-0.95411,0
0,0,0,0,0,2767,559,3326,2408,5734,-0.00803769,0.0358087,-0.999326,0
0,0,0,0,0,2854,524,3378,2344,5722,0.0222263,-0.165032,-0.986038,0
0,0,0,0,0,3030,539,3569,2247,5816,-0.00251263,-0.106414,-0.994319,0
0,0,0,0,0,3164,586,3750,1936,5686,0.0477329,0.090956,-0.99471,0
0,0,0,0,0,3052,616,3668,2343,6011,0.0255486,-0.153489,-0.98782,0
0,0,0,0,0,2945,531,3476,1996,5472,0.025444,-0.0894515,-0.995666,0
0,0,0,0,0,2954,600,3554,2089,5643,0.0461196,0.148344,-0.98786,0
0,0,0,0,0,3085,542,3627,1557,5184,0.0283538,-0.0439525,-0.998631,0
0,0,0,0,0,3069,631,3700,1644,5344,0.0340129,-0.130653,-0.990845,0
0,0,0,0,0,3131,572,3703,2013,5716,0.0371096,-0.132041,-0.990549,0
0,0,0,0,0,3040,557,3597,2700,6297,0.0309689,-0.208422,-0.977549,0
0,0,0,0,0,2862,539,3401,2003,5404,0.0258984,0.0817281,-0.996318,0
0,0,0,0,0,2832,535,3367,1981,5348,0.0295332,0.235353,-0.971461,0
0,0,0,0,0,2793,508,3301,2062,5363,0.000824961,0.0583225,-0.998297,0
0,0,0,0,0,2772,614,3386,2016,5402,-0.0162633,0.104503,-0.994392,0
0,0,0,0,0,2831,563,3394,2295,5689,-0.0354575,0.0612549,-0.997492,0
0,0,0,0,0,2667,483,3150,2402,5552,-0.0483139,0.00784994,-0.998801,0
0,0,0,0,0,2662,496,3158,-1000,-1000,-1,-1,-1,0
0,0,0,0,0,2485,437,2922,7311,10233,0.0978279,-0.681502,-0.725248,0
0,0,0,0,0,2770,480,3250,1551,4801,0.017244,0.0981107,-0.995026,0
0,0,0,0,0,2601,535,3136,9805,12941,0.195433,-0.2962,-0.934918,0
0,0,0,0,0,2483,476,2959,1947,4906,-0.00210044,-0.147187,-0.989106,0
0,0,0,0,0,2722,471,3193,6777,9970,0.203809,-0.426646,-0.881156,0
0,0,0,0,0,2673,464,3137,1748,4885,0.00280901,-0.327361,-0.944895,0
0,0,0,0,0,2628,466,3094,1508,4602,0.000912893,-0.402974,-0.915211,0
0,0,0,0,0,2937,477,3414,1145,4559,-0.0009475,-0.319197,-0.947688,0
0,0,0,0,0,2574,524,3098,937,4035,0.0149311,-0.00915208,-0.999847,0
0,0,0,0,0,2612,506,3118,758,3876,-0.017721,-0.0907743,-0.995714,0
0,0,0,0,0,2786,533,3319,847,4166,-0.011996,-0.00256289,-0.999925,0
0,0,0,0,0,3599,504,4103,770,4873,0.00345036,0.0538372,-0.998544,0
0,0,0,0,0,2762,529,3291,841,4132,0.00755411,0.0208353,-0.999754,0
0,0,0,0,0,4565,730,5295,839,6134,0.0236368,0.02436,-0.999424,0
0,0,0,0,0,3136,517,3653,963,4616,-0.0231683,-0.0631442,-0.997735,0
0,0,0,0,0,2846,546,3392,932,4324,-0.000422563,-0.147546,-0.989055,0
0,0,0,0,0,3023,549,3572,1297,4869,-0.027027,-0.254985,-0.966567,0
0,0,0,0,0,2864,532,3396,1252,4648,-0.0067019,-0.26599,-0.963952,0
0,0,0,0,0,2869,553,3422,1445,4867,-0.0268637,-0.368181,-0.929366,0
0,0,0,0,0,3114,528,3642,1204,4846,-0.026921,-0.520857,-0.853219,0
0,0,0,0,0,2697,530,3227,1165,4392,-0.0743293,-0.572189,-0.816747,0
0,0,0,0,0,2750,530,3280,1653,4933,-0.00880416,-0.010077,-0.99991,0
0,0,0,0,0,2795,609,3404,1276,4680,-0.0109001,-0.0850306,-0.996319,0
0,0,0,0,0,2695,543,3238,1282,4520,-0.0332644,-0.22368,-0.974095,0
0,0,0,0,0,2761,574,3335,1435,4770,-0.048354,-0.308919,-0.949858,0
0,0,0,0,0,2745,575,3320,1299,4619,-0.0577603,-0.349793,-0.935045,0
0,0,0,0,0,2522,619,3141,1301,4442,-0.077668,-0.468871,-0.879845,0
0,0,0,0,0,2594,542,3136,1280,4416,-0.00969036,0.0210526,-0.999731,0
0,0,0,0,0,2704,550,3254,1797,5051,-0.021705,-0.0525154,-0.998384,0
0,0,0,0,0,2565,608,3173,1706,4879,0.00331865,-0.147062,-0.989122,0
0,0,0,0,0,2480,575,3055,2140,5195,0.0182804,-0.358249,-0.933447,0
0,0,0,0,0,2607,552,3159,2332,5491,0.0453458,-0.154612,-0.986934,0
0,0,0,0,0,2486,529,3015,2194,5209,-0.0180918,-0.460922,-0.887256,0
0,0,0,0,0,2731,554,3285,2041,5326,0.0249748,-0.415463,-0.909267,0
0,0,0,0,0,2527,558,3085,2159,5244,0.0134456,-0.47498,-0.879894,0
0,0,0,0,0,3363,651,4014,3812,7826,-0.0296117,-0.660995,-0.749806,0
0,0,0,0,0,2756,628,3384,1510,4894,0.00784671,0.179628,-0.983703,0
0,0,0,0,0,2629,543,3172,2140,5312,-0.000782497,0.176922,-0.984224,0
0,0,0,0,0,2516,541,3057,1822,4879,-0.00572795,0.058408,-0.998276,0
0,0,0,0,0,2588,562,3150,1518,4668,-0.0247213,-0.0859345,-0.995994,0
0,0,0,0,0,2746,516,3262,1355,4617,-0.0182885,-0.10316,-0.994497,0
0,0,0,0,0,4398,761,5159,1288,6447,0.0259632,0.178939,-0.983518,0
0,0,0,0,0,2663,556,3219,1453,4672,0.0252248,0.0349778,-0.99907,0
0,0,0,0,0,2559,503,3062,1231,4293,0.0416473,-0.0128593,-0.99905,0
0,0,0,0,0,2480,499,2979,1321,4300,0.0103743,-0.0815429,-0.996616,0
0,0,0,0,0,2846,507,3353,1237,4590,-0.00315299,-0.119499,-0.992829,0
0,0,0,0,0,2596,452,3048,1348,4396,-0.0112957,0.193135,-0.981107,0
0,0,0,0,0,2566,460,3026,971,3997,-0.0183188,0.112862,-0.993442,0
0,0,0,0,0,2923,463,3386,1221,4607,-0.0250836,0.107438,-0.993895,0
0,0,0,0,0,2466,432,2898,987,3885,-0.0300075,0.0279696,-0.999158,0
0,0,0,0,0,2789,497,3286,1298,4584,-0.0226081,0.310134,-0.950424,0
0,0,0,0,0,2558,542,3100,1439,4539,-0.0248353,0.2783,-0.960173,0
0,0,0,0,0,2697,478,3175,1245,4420,-0.0554004,0.37786,-0.924204,0
0,0,0,0,0,2801,503,3304,1223,4527,-0.0384878,0.319759,-0.946717,0
0,0,0,0,0,2776,482,3258,1946,5204,-0.0156793,0.198434,-0.979989,0
0,0,0,0,0,2798,486,3284,2791,6075,0.00891836,0.352358,-0.935823,0
0,0,0,0,0,2962,516,3478,3404,6882,-0.00972105,0.42704,-0.90418,0
0,0,0,0,0,2955,590,3545,3107,6652,-0.0141086,0.343746,-0.938957,0
0,0,0,0,0,2825,555,3380,2770,6150,-0.0275502,0.117252,-0.99272,0
0,0,0,0,0,3122,537,3659,3746,7405,-0.0229545,-0.224354,-0.974237,0
0,0,0,0,0,3069,552,3621,2163,5784,0.0247677,-0.338241,-0.940733,0
0,0,0,0,0,3091,576,3667,2538,6205,0.0332092,0.0253613,-0.999127,0
0,0,0,0,0,3129,660,3789,2016,5805,0.0408837,0.0717783,-0.996582,0
0,0,0,0,0,3121,551,3672,2067,5739,-0.0378087,0.144178,-0.988829,0
0,0,0,0,0,2944,548,3492,2403,5895,-0.0237433,0.111244,-0.993509,0
0,0,0,0,0,3172,587,3759,1976,5735,0.0217684,-0.14133,-0.989723,0
0,0,0,0,0,2864,578,3442,1815,5257,0.0130403,0.0545641,-0.998425,0
0,0,0,0,0,3295,587,3882,2157,6039,0.00974843,0.168955,-0.985576,0
0,0,0,0,0,2971,786,3757,1794,5551,0.0407738,0.00793418,-0.999137,0
0,0,0,0,0,2915,625,3540,1236,4776,0.0570406,0.0868581,-0.994586,0
0,0,0,0,0,2959,538,3497,1288,4785,0.0339952,-0.112543,-0.993065,0
0,0,0,0,0,3005,565,3570,1641,5211,0.0187553,0.0199414,-0.999625,0
0,0,0,0,0,2829,521,3350,1665,5015,0.014817,0.156247,-0.987607,0
0,0,0,0,0,2793,553,3346,1693,5039,0.0165108,0.107249,-0.994095,0
0,0,0,0,0,2735,522,3257,1996,5253,0.00821996,0.106624,-0.994265,0
0,0,0,0,0,3221,563,3784,1655,5439,0.0181147,0.222177,-0.974838,0
0,0,0,0,0,2752,564,3316,1502,4818,0.00582916,0.203485,-0.979061,0
0,0,0,0,0,3032,638,3670,1395,5065,0.0112503,0.247039,-0.96894,0
0,0,0,0,0,3144,476,3620,5783,9403,0.00696349,0.174541,-0.984625,0
0,0,0,0,0,2681,555,3236,7166,10402,0.0237013,-0.368051,-0.929504,0
0,0,0,0,0,2616,510,3126,1964,5090,-0.0105662,-0.117371,-0.993032,0
0,0,0,0,0,2626,469,3095,14909,18004,0.00781157,-0.22335,-0.974707,0
0,0,0,0,0,2705,455,3160,5241,8401,-0.0269263,-0.204515,-0.978493,0
0,0,0,0,0,2685,521,3206,4073,7279,0.0269303,-0.1801,-0.98328,0
0,0,0,0,0,2583,503,3086,5403,8489,0.0487925,0.42339,-0.904632,0
0,0,0,0,0,2705,513,3218,4245,7463,0.138379,0.0708871,-0.987839,0
0,0,0,0,0,2614,476,3090,1435,4525,0.127468,0.0799246,-0.988617,0
0,0,0,0,0,2781,477,3258,1456,4714,0.193719,0.398444,-0.896502,0
0,0,0,0,0,2632,482,3114,2263,5377,0.131158,0.453911,-0.881341,0
0,0,0,0,0,2876,498,3374,2752,6126,0.0839663,0.37102,-0.924821,0
0,0,0,0,0,2903,517,3420,2563,5983,0.0565143,0.4048,-0.912657,0
0,0,0,0,0,2870,492,3362,2781,6143,0.108386,0.633581,-0.766047,0
0,0,0,0,0,3003,517,3520,2541,6061,0.0795842,0.562069,-0.823253,0
0,0,0,0,0,2908,506,3414,2308,5722,0.0861942,0.589699,-0.80301,0
0,0,0,0,0,3180,485,3665,-1000,-1000,-1,-1,-1,0
0,0,0,0,0,3022,560,3582,1387,4969,-0.00183822,0.107551,-0.994198,0
0,0,0,0,0,2748,517,3265,1239,4504,-0.123701,-0.13013,-0.98375,0
0,0,0,0,0,2943,561,3504,1207,4711,-0.00560875,0.0573968,-0.998336,0
0,0,0,0,0,2702,589,3291,1366,4657,-0.0844943,-0.0957622,-0.991812,0
0,0,0,0,0,3006,622,3628,1278,4906,-0.100796,-0.146627,-0.984043,0
0,0,0,0,0,2741,578,3319,1503,4822,-0.196922,-0.346111,-0.917294,0
0,0,0,0,0,2728,545,3273,1697,4970,-0.1459,-0.212709,-0.966162,0
0,0,0,0,0,2610,554,3164,1352,4516,-0.157166,-0.306112,-0.938932,0
0,0,0,0,0,2921,623,3544,2001,5545,0.000665141,0.0879514,-0.996125,0
0,0,0,0,0,2601,558,3159,1872,5031,0.0378391,0.0943417,-0.994821,0
0,0,0,0,0,2641,538,3179,1720,4899,0.12091,0.230341,-0.965569,0
0,0,0,0,0,2573,533,3106,1414,4520,-0.0191631,0.0247942,-0.999509,0
0,0,0,0,0,2525,566,3091,2089,5180,-0.00304998,0.0819542,-0.996631,0
0,0,0,0,0,2500,521,3021,2215,5236,-0.033164,0.01576,-0.999326,0
0,0,0,0,0,2456,548,3004,2666,5670,-0.0601422,-0.0254414,-0.997866,0
0,0,0,0,0,2521,556,3077,2243,5320,-0.0989134,-0.102624,-0.98979,0
0,0,0,0,0,2528,595,3123,2738,5861,-0.0266669,-0.024232,-0.999351,0
0,0,0,0,0,2505,595,3100,3031,6131,-0.192829,-0.207579,-0.959025,0
0,0,0,0,0,2389,513,2902,1734,4636,-0.208914,-0.247624,-0.946064,0
0,0,0,0,0,2599,537,3136,2778,5914,0.064386,0.108501,-0.992009,0
0,0,0,0,0,2450,568,3018,1820,4838,-0.0557806,0.0459937,-0.997383,0
0,0,0,0,0,2558,521,3079,2336,5415,-0.0650282,0.0250245,-0.99757,0
0,0,0,0,0,2402,529,2931,2143,5074,-0.153299,-0.0681474,-0.985827,0
0,0,0,0,0,3154,671,3825,2200,6025,0.0618002,0.061046,-0.99622,0
0,0,0,0,0,2475,495,2970,1528,4498,0.030688,0.0717037,-0.996954,0
0,0,0,0,0,2508,539,3047,1330,4377,-0.0399574,0.039145,-0.998434,0
0,0,0,0,0,2322,487,2809,1426,4235,-0.143289,-0.115651,-0.9829,0
0,0,0,0,0,2402,500,2902,1403,4305,-0.100994,-0.137504,-0.985339,0
0,0,0,0,0,2649,459,3108,1386,4494,-0.181182,-0.163303,-0.969796,0
0,0,0,0,0,2497,466,2963,1579,4542,0.120541,0.0725023,-0.990057,0
0,0,0,0,0,2451,458,2909,1210,4119,0.11343,0.0652012,-0.991404,0
0,0,0,0,0,2524,455,2979,1167,4146,0.0744803,0.0416471,-0.996352,0
0,0,0,0,0,2442,469,2911,1040,3951,0.052622,0.0389166,-0.997856,0
0,0,0,0,0,2533,497,3030,985,4015,-0.0198371,0.0350547,-0.999188,0
0,0,0,0,0,2726,496,3222,1381,4603,0.00716224,0.0250687,-0.99966,0
0,0,0,0,0,2607,505,3112,1225,4337,0.385125,0.0850479,-0.918937,0
0,0,0,0,0,2552,474,3026,1392,4418,0.421088,0.0578306,-0.905174,0
0,0,0,0,0,2613,466,3079,1086,4165,0.414497,0.0783292,-0.906673,0
0,0,0,0,0,2666,496,3162,1436,4598,0.389955,0.0558868,-0.919137,0
0,0,0,0,0,3800,479,4279,1690,5969,0.526189,0.0771347,-0.846862,0
0,0,0,0,0,2675,478,3153,2306,5459,0.477021,0.0260825,-0.878505,0
0,0,0,0,0,2762,469,3231,2778,6009,0.249379,0.0363362,-0.967724,0
0,0,0,0,0,2719,573,3292,4146,7438,0.103269,0.0272722,-0.99428,0
0,0,0,0,0,2968,570,3538,2834,6372,-0.0778772,0.0322729,-0.99644,0
0,0,0,0,0,3264,611,3875,2374,6249,0.0553904,-0.0286822,-0.998053,0
0,0,0,0,0,3014,535,3549,2191,5740,-0.066198,0.00786843,-0.997775,0
0,0,0,0,0,2890,557,3447,1564,5011,-0.0193633,0.0131913,-0.999725,0
0,0,0,0,0,2932,539,3471,1749,5220,0.129862,-0.0386789,-0.990777,0
0,0,0,0,0,3125,542,3667,1518,5185,0.166653,-0.0479554,-0.984849,0
0,0,0,0,0,3071,564,3635,1286,4921,-0.011894,-0.00154007,-0.999928,0
0,0,0,0,0,2878,571,3449,1597,5046,-0.0612835,-0.0108655,-0.998061,0
0,0,0,0,0,2912,523,3435,1537,4972,-0.0312301,-0.00681552,-0.999489,0
0,0,0,0,0,3074,569,3643,1521,5164,-0.163419,0.0215686,-0.986321,0
0,0,0,0,0,2981,530,3511,1384,4895,-0.179295,0.0223568,-0.983541,0
0,0,0,0,0,2746,531,3277,1324,4601,-0.15395,0.0357373,-0.987432,0
0,0,0,0,0,2893,620,3513,1265,4778,-0.155816,0.0650987,-0.985639,0
0,0,0,0,0,2765,556,3321,1570,4891,-0.240514,0.0862286,-0.966808,0
0,0,0,0,0,4610,720,5330,2208,7538,-0.062162,0.051337,-0.996745,0
0,0,0,0,0,2726,528,3254,1323,4577,0.130567,-0.0360732,-0.990783,0
0,0,0,0,0,2807,527,3334,1544,4878,0.169667,-0.0711576,-0.982929,0
0,0,0,0,0,2749,626,3375,1393,4768,0.152851,-0.109794,-0.982131,0
0,0,0,0,0,2781,531,3312,1615,4927,0.14336,-0.0760046,-0.986748,0
0,0,0,0,0,2683,585,3268,2652,5920,0.198905,-0.132179,-0.971064,0
0,0,0,0,0,2705,501,3206,8402,11608,-0.369086,-0.0674407,-0.926945,0
0,0,0,0,0,2745,502,3247,1990,5237,0.0455336,0.0560656,-0.997388,0
0,0,0,0,0,2484,470,2954,4868,7822,-0.328882,-0.0413131,-0.943467,0
0,0,0,0,0,2743,493,3236,1592,4828,0.0662145,0.0358259,-0.997162,0
0,0,0,0,0,2582,477,3059,3464,6523,-0.152274,-0.0169148,-0.988194,0
0,0,0,0,0,2751,507,3258,3956,7214,0.0607878,-0.0344346,-0.997557,0
0,0,0,0,0,2609,472,3081,2352,5433,0.00571249,0.0346715,-0.999382,0
0,0,0,0,0,2453,454,2907,1100,4007,-0.0143635,0.110062,-0.993821,0
0,0,0,0,0,2483,464,2947,987,3934,-0.049915,0.177375,-0.982877,0
0,0,0,0,0,2465,462,2927,832,3759,-0.0817918,0.236884,-0.968089,0
0,0,0,0,0,2510,470,2980,982,3962,0.0307834,-0.0296376,-0.999087,0
0,0,0,0,0,2693,498,3191,922,4113,0.0141751,0.0586702,-0.998177,0
0,0,0,0,0,2554,510,3064,903,3967,-0.0465785,0.10384,-0.993503,0
0,0,0,0,0,2935,548,3483,925,4408,0.0169622,0.0937987,-0.995447,0
0,0,0,0,0,2832,523,3355,1098,4453,0.0246896,0.0270582,-0.999329,0
0,0,0,0,0,2764,561,3325,1155,4480,0.0489125,0.0487826,-0.997611,0
0,0,0,0,0,2920,564,3484,1204,4688,0.0281197,0.177473,-0.983724,0
0,0,0,0,0,3296,547,3843,1371,5214,0.0511951,0.0812178,-0.995381,0
0,0,0,0,0,2801,568,3369,1357,4726,0.0360742,0.17274,-0.984307,0
0,0,0,0,0,2755,537,3292,1449,4741,0.056058,0.196478,-0.978904,0
0,0,0,0,0,2780,568,3348,1319,4667,0.0625007,0.343734,-0.936985,0
0,0,0,0,0,2839,538,3377,1518,4895,0.0471616,0.445904,-0.893837,0
0,0,0,0,0,2802,622,3424,1524,4948,0.0801231,0.12875,-0.988435,0
0,0,0,0,0,2986,643,3629,1694,5323,-0.000641601,-0.0496414,-0.998767,0
0,0,0,0,0,2737,549,3286,1618,4904,0.0220733,0.147277,-0.988849,0
0,0,0,0,0,2774,563,3337,1682,5019,0.0251574,0.0621497,-0.99775,0
0,0,0,0,0,2698,587,3285,1960,5245,0.0309154,0.166888,-0.985491,0
0,0,0,0,0,2549,538,3087,2704,5791,0.0294615,0.271749,-0.961917,0
0,0,0,0,0,2565,528,3093,1645,4738,-0.00153882,0.364623,-0.931154,0
0,0,0,0,0,2547,541,3088,2404,5492,0.0657126,0.515627,-0.85429,0
0,0,0,0,0,2470,550,3020,2159,5179,0.0229864,0.522646,-0.85224,0
0,0,0,0,0,2576,531,3107,2412,5519,0.0938995,0.659216,-0.746068,0
0,0,0,0,0,2695,586,3281,2606,5887,0.0641567,0.674245,-0.735716,0
0,0,0,0,0,2771,569,3340,3651,6991,0.0327691,0.451263,-0.891789,0
0,0,0,0,0,2519,567,3086,2216,5302,0.0043121,-0.0183044,-0.999823,0
0,0,0,0,0,2523,557,3080,2077,5157,-0.0530899,-0.256887,-0.964982,0
0,0,0,0,0,2599,504,3103,1524,4627,-0.0294604,-0.102332,-0.994314,0
0,0,0,0,0,2716,498,3214,1463,4677,0.01184,0.054523,-0.998442,0
0,0,0,0,0,2547,531,3078,1102,4180,0.0351103,0.129685,-0.990933,0
0,0,0,0,0,2381,470,2851,1247,4098,0.0390868,0.235952,-0.970978,0
0,0,0,0,0,2341,460,2801,1221,4022,0.063108,0.378875,-0.923294,0
0,0,0,0,0,2344,453,2797,1105,3902,0.0705429,0.410133,-0.909293,0
0,0,0,0,0,2426,436,2862,916,3778,0.0841358,0.442166,-0.892978,0
0,0,0,0,0,4049,635,4684,1865,6549,-0.0203544,-0.140878,-0.989818,0
0,0,0,0,0,2639,439,3078,1099,4177,-0.0308552,-0.120204,-0.99227,0
0,0,0,0,0,2630,498,3128,1639,4767,0.00807015,-0.0677146,-0.997672,0
0,0,0,0,0,2619,472,3091,1582,4673,0.0239852,-0.00415468,-0.999704,0
0,0,0,0,0,4281,700,4981,2710,7691,-0.00438113,-0.262109,-0.965028,0
0,0,0,0,0,2574,505,3079,2001,5080,-0.0254189,-0.269246,-0.962736,0
0,0,0,0,0,2804,480,3284,2447,5731,-0.0473617,-0.424046,-0.904402,0
0,0,0,0,0,2725,471,3196,2762,5958,-0.0571153,-0.364418,-0.929482,0
0,0,0,0,0,2662,537,3199,2137,5336,-0.0563854,-0.308099,-0.949682,0
0,0,0,0,0,2807,557,3364,2593,5957,-0.0486845,0.0344582,-0.99822,0
0,0,0,0,0,2658,534,3192,2147,5339,-0.0691024,-0.0647873,-0.995504,0
0,0,0,0,0,2859,531,3390,2233,5623,-0.0171659,0.186496,-0.982306,0
0,0,0,0,0,3273,571,3844,2603,6447,-0.0285862,0.0455883,-0.998551,0
0,0,0,0,0,2844,557,3401,2346,5747,-0.0249722,-0.0364342,-0.999024,0
0,0,0,0,0,2847,576,3423,2021,5444,-0.0252247,0.0756479,-0.996815,0
0,0,0,0,0,2794,543,3337,1829,5166,-0.00390319,0.0972808,-0.995249,0
0,0,0,0,0,3277,540,3817,1756,5573,-0.00734794,-0.0142064,-0.999872,0
0,0,0,0,0,2787,531,3318,1622,4940,-0.0491493,-0.0533045,-0.997368,0
0,0,0,0,0,2754,570,3324,1316,4640,-0.0286836,-0.0161549,-0.999458,0
0,0,0,0,0,2814,532,3346,1418,4764,0.00179628,0.0452195,-0.998975,0
0,0,0,0,0,2740,547,3287,1335,4622,-0.00564591,0.144997,-0.989416,0
0,0,0,0,0,2880,544,3424,1130,4554,0.0131085,0.133524,-0.990959,0
0,0,0,0,0,2922,531,3453,1245,4698,0.0284495,0.170865,-0.984884,0
0,0,0,0,0,2850,558,3408,1251,4659,-0.0416456,-0.0988214,-0.994233,0
0,0,0,0,0,3039,579,3618,1210,4828,-0.0265459,-0.270031,-0.962485,0
0,0,0,0,0,2905,524,3429,1117,4546,-0.0302967,-0.185223,-0.982229,0
0,0,0,0,0,2714,531,3245,1400,4645,-0.00994743,-0.171529,-0.985129,0
0,0,0,0,0,2723,525,3248,1402,4650,-0.0227254,-0.0711222,-0.997209,0
0,0,0,0,0,2702,541,3243,1476,4719,-0.0125634,-0.0368628,-0.999241,0
0,0,0,0,0,2808,564,3372,1564,4936,0.00157229,-0.0157149,-0.999875,0
0,0,0,0,0,2630,466,3096,4000,7096,-0.0683717,-0.422235,-0.903904,0
0,0,0,0,0,2559,466,3025,4474,7499,-0.0447608,-0.420781,-0.906057,0
0,0,0,0,0,2624,485,3109,10167,13276,-0.207574,0.298117,-0.931686,0
0,0,0,0,0,2958,520,3478,1843,5321,-0.0295286,-0.0934261,-0.995188,0
0,0,0,0,0,2477,454,2931,4775,7706,-0.268291,0.317097,-0.909653,0
0,0,0,0,0,2513,491,3004,1079,4083,0.0167181,0.0599234,-0.998063,0
0,0,0,0,0,2491,466,2957,3333,6290,0.0239758,0.120949,-0.992369,0
0,0,0,0,0,2419,503,2922,2182,5104,-0.0240144,0.177284,-0.983867,0
0,0,0,0,0,2623,643,3266,1183,4449,0.0515803,0.246242,-0.967835,0
0,0,0,0,0,2554,447,3001,944,3945,0.0735841,0.31244,-0.947083,0
0,0,0,0,0,2503,485,2988,914,3902,0.0941907,0.374191,-0.922556,0
0,0,0,0,0,2557,469,3026,884,3910,0.133227,0.458218,-0.878798,0
0,0,0,0,0,2652,485,3137,855,3992,-0.0203243,0.00499073,-0.999781,0
0,0,0,0,0,2635,507,3142,812,3954,-0.0159557,-0.0209425,-0.999653,0
0,0,0,0,0,2712,490,3202,950,4152,0.0107748,0.0800172,-0.996735,0
0,0,0,0,0,2792,550,3342,883,4225,0.042056,0.145436,-0.988473,0
0,0,0,0,0,2803,565,3368,960,4328,0.0840735,0.252034,-0.964059,0
0,0,0,0,0,2819,552,3371,967,4338,0.150524,0.434714,-0.8879,0
0,0,0,0,0,2651,515,3166,1061,4227,0.042183,0.0615478,-0.997212,0
0,0,0,0,0,2676,542,3218,1127,4345,0.135934,0.219964,-0.965991,0
0,0,0,0,0,2686,542,3228,1213,4441,0.105294,0.245753,-0.963597,0
0,0,0,0,0,2642,517,3159,1085,4244,0.141829,0.384073,-0.912344,0
0,0,0,0,0,2725,523,3248,1405,4653,0.127535,0.397634,-0.908637,0
0,0,0,0,0,2688,574,3262,1056,4318,0.172665,0.490878,-0.853947,0
0,0,0,0,0,2631,573,3204,1292,4496,0.0194735,-0.0172429,-0.999662,0
0,0,0,0,0,2710,530,3240,1373,4613,-0.00799354,-0.0777351,-0.996942,0
0,0,0,0,0,2669,584,3253,1463,4716,-0.00207386,-0.0399233,-0.999201,0
0,0,0,0,0,2523,545,3068,1023,4091,0.00663934,0.027415,-0.999602,0
0,0,0,0,0,2524,521,3045,1406,4451,0.0593533,0.187791,-0.980414,0
0,0,0,0,0,2495,565,3060,1499,4559,0.144786,0.287,-0.946925,0
0,0,0,0,0,2598,535,3133,1986,5119,0.0830493,-0.0700538,-0.99408,0
0,0,0,0,0,2573,554,3127,2582,5709,-0.0632867,-0.0683017,-0.995655,0
0,0,0,0,0,2598,565,3163,1788,4951,0.0419008,0.00558543,-0.999106,0
0,0,0,0,0,2434,539,2973,1767,4740,0.0564486,0.0534387,-0.996974,0
0,0,0,0,0,2582,541,3123,2514,5637,0.00347467,-0.100331,-0.994948,0
0,0,0,0,0,2555,584,3139,1819,4958,0.0293708,0.0145397,-0.999463,0
0,0,0,0,0,2718,554,3272,2764,6036,-0.00453294,-0.0495847,-0.99876,0
0,0,0,0,0,2566,532,3098,2310,5408,-0.0109152,-0.0107523,-0.999883,0
0,0,0,0,0,2488,541,3029,1577,4606,0.0379576,0.106888,-0.993546,0
0,0,0,0,0,2593,580,3173,1274,4447,0.0659972,0.174309,-0.982477,0
0,0,0,0,0,2790,516,3306,1280,4586,0.112931,0.269493,-0.956358,0
0,0,0,0,0,2521,512,3033,1262,4295,0.128497,0.376634,-0.917407,0
0,0,0,0,0,2396,489,2885,1074,3959,0.164411,0.459835,-0.872652,0
0,0,0,0,0,2289,511,2800,1018,3818,0.20936,0.527859,-0.823124,0
0,0,0,0,0,2491,495,2986,1103,4089,-0.0389465,-0.134627,-0.990131,0
0,0,0,0,0,2372,464,2836,1074,3910,-0.0537056,-0.166853,-0.984518,0
0,0,0,0,0,2449,444,2893,1261,4154,0.00662477,-0.0779788,-0.996933,0
0,0,0,0,0,2568,466,3034,932,3966,-0.0450616,-0.190326,-0.980686,0
0,0,0,0,0,2471,466,2937,1099,4036,-0.0275054,-0.165792,-0.985777,0
0,0,0,0,0,2469,498,2967,1174,4141,-0.03835,-0.13699,-0.98983,0
0,0,0,0,0,2673,456,3129,1262,4391,-0.0364688,-0.148637,-0.988219,0
0,0,0,0,0,2483,484,2967,1267,4234,0.012181,-0.0672917,-0.997659,0
0,0,0,0,0,2707,527,3234,1866,5100,0.0224812,0.0616937,-0.997842,0
0,0,0,0,0,4296,507,4803,2250,7053,-0.0301633,-0.324981,-0.945239,0
0,0,0,0,0,2728,503,3231,2691,5922,-0.0584452,-0.257241,-0.964578,0
0,0,0,0,0,2745,545,3290,3463,6753,-0.00790875,-0.0758263,-0.99709,0
0,0,0,0,0,2866,527,3393,3560,6953,0.0343188,0.188315,-0.981509,0
0,0,0,0,0,2723,518,3241,2031,5272,0.0622228,0.237501,-0.969392,0
0,0,0,0,0,2933,529,3462,1721,5183,0.0799592,0.242657,-0.966811,0
0,0,0,0,0,3026,578,3604,2374,5978,0.090564,0.268921,-0.958895,0
0,0,0,0,0,3023,573,3596,1916,5512,0.137331,0.470424,-0.871689,0
0,0,0,0,0,3061,552,3613,1933,5546,-0.0390613,-0.0118656,-0.999166,0
0,0,0,0,0,3195,619,3814,2082,5896,-0.0150926,0.132099,-0.991122,0
0,0,0,0,0,2969,525,3494,1931,5425,-0.0389736,-0.0815657,-0.995906,0
0,0,0,0,0,2872,524,3396,1421,4817,-0.0538468,-0.0024464,-0.998546,0
0,0,0,0,0,2875,530,3405,1467,4872,0.0124157,0.0195221,-0.999732,0
0,0,0,0,0,2795,579,3374,1592,4966,0.0310097,0.199616,-0.979383,0
0,0,0,0,0,2978,568,3546,1781,5327,0.0314226,0.22263,-0.974397,0
0,0,0,0,0,2907,526,3433,1464,4897,0.0522466,0.267034,-0.96227,0
0,0,0,0,0,2695,539,3234,1684,4918,0.0621915,0.242688,-0.968109,0
0,0,0,0,0,2676,610,3286,1434,4720,0.0994248,0.448617,-0.888177,0
0,0,0,0,0,2860,600,3460,1637,5097,0.103801,0.407876,-0.907118,0
0,0,0,0,0,2803,557,3360,1527,4887,0.132169,0.511258,-0.849203,0
0,0,0,0,0,2635,498,3133,1265,4398,0.136334,0.518296,-0.844264,0
0,0,0,0,0,2836,483,3319,7303,10622,0.0853948,0.503256,-0.859907,0
0,0,0,0,0,2595,481,3076,1310,4386,-0.0292921,-0.116372,-0.992774,0
0,0,0,0,0,2538,441,2979,5448,8427,-0.0497916,0.385156,-0.921507,0
0,0,0,0,0,2627,518,3145,1286,4431,-0.0225523,-0.0848051,-0.996142,0
0,0,0,0,0,2570,464,3034,5261,8295,-0.219189,0.544854,-0.809376,0
0,0,0,0,0,2555,448,3003,1954,4957,0.0605305,0.146385,-0.987374,0
0,0,0,0,0,2596,456,3052,2340,5392,-0.083714,0.244127,-0.966123,0
0,0,0,0,0,2660,497,3157,1827,4984,-0.0642738,0.206055,-0.976427,0
0,0,0,0,0,2592,454,3046,1961,5007,-0.0710503,0.176281,-0.981772,0
0,0,0,0,0,3267,492,3759,1916,5675,-0.282873,-0.325703,-0.902164,0
0,0,0,0,0,2743,497,3240,2196,5436,-0.248206,-0.268861,-0.930649,0
0,0,0,0,0,2594,471,3065,1689,4754,-0.256406,-0.266328,-0.929153,0
0,0,0,0,0,2798,492,3290,2347,5637,-0.38103,-0.56415,-0.732496,0
0,0,0,0,0,2765,498,3263,-1000,-1000,-1,-1,-1,0
0,0,0,0,0,2733,514,3247,1056,4303,0.0646844,0.124342,-0.990129,0
0,0,0,0,0,2675,543,3218,1005,4223,0.111849,0.260151,-0.959068,0
0,0,0,0,0,2770,549,3319,1103,4422,0.153177,0.320667,-0.934724,0
0,0,0,0,0,2854,598,3452,1294,4746,0.168692,0.43029,-0.886788,0
0,0,0,0,0,3076,551,3627,1268,4895,0.174032,0.407585,-0.896431,0
0,0,0,0,0,2864,553,3417,1420,4837,0.00788307,-0.0457425,-0.998922,0
0,0,0,0,0,2594,529,3123,1527,4650,0.0223837,0.00433721,-0.99974,0
0,0,0,0,0,2648,573,3221,1535,4756,0.0519896,0.143387,-0.9883,0
0,0,0,0,0,2466,566,3032,1645,4677,0.0705687,0.0833765,-0.994016,0
0,0,0,0,0,2633,530,3163,1813,4976,0.142931,0.311618,-0.939396,0
0,0,0,0,0,2448,532,2980,1887,4867,0.180899,0.36802,-0.912051,0
0,0,0,0,0,2643,539,3182,1925,5107,0.221933,0.410165,-0.884596,0
0,0,0,0,0,2506,597,3103,2984,6087,-0.0664388,-0.174747,-0.982369,0
0,0,0,0,0,2523,532,3055,3649,6704,-0.0179294,-0.0930258,-0.995502,0
0,0,0,0,0,2717,596,3313,2795,6108,0.0446579,0.0553251,-0.997469,0
0,0,0,0,0,2630,579,3209,2718,5927,0.087525,0.168186,-0.981862,0
0,0,0,0,0,2565,565,3130,2377,5507,0.123952,0.322603,-0.938383,0
0,0,0,0,0,2563,536,3099,2291,5390,0.155225,0.378426,-0.912523,0
0,0,0,0,0,2577,534,3111,1278,4389,0.186647,0.412967,-0.891415,0
0,0,0,0,0,2778,535,3313,1524,4837,-0.0409723,-0.0402311,-0.99835,0
0,0,0,0,0,2577,568,3145,1065,4210,0.0083037,-0.0383936,-0.999228,0
0,0,0,0,0,2475,474,2949,1091,4040,-0.0331844,0.0517587,-0.998108,0
0,0,0,0,0,2619,516,3135,1117,4252,-0.0177427,-0.156828,-0.987467,0
0,0,0,0,0,2464,500,2964,1286,4250,0.00338657,-0.0899567,-0.99594,0
0,0,0,0,0,3245,454,3699,1054,4753,-0.00731636,-0.205543,-0.978621,0
0,0,0,0,0,2500,436,2936,1044,3980,0.01131,-0.162674,-0.986615,0
0,0,0,0,0,2729,490,3219,1067,4286,0.0240364,-0.150041,-0.988388,0
0,0,0,0,0,2618,494,3112,1248,4360,-0.0019825,-0.132643,-0.991162,0
0,0,0,0,0,2773,493,3266,1461,4727,0.0090282,-0.114936,-0.993332,0
0,0,0,0,0,2577,474,3051,1214,4265,-0.17252,-0.531564,-0.829263,0
0,0,0,0,0,2543,476,3019,1426,4445,-0.189445,-0.595679,-0.780562,0
0,0,0,0,0,2892,474,3366,3760,7126,-0.0429261,-0.11872,-0.991999,0
0,0,0,0,0,2922,565,3487,3385,6872,-0.0786205,0.0296916,-0.996462,0
0,0,0,0,0,2766,542,3308,1994,5302,-0.00633437,0.101884,-0.994776,0
0,0,0,0,0,4316,628,4944,2269,7213,-0.0224621,0.0505044,-0.998471,0
0,0,0,0,0,2975,578,3553,2472,6025,-0.0895592,-0.0598511,-0.994182,0
0,0,0,0,0,2860,552,3412,2579,5991,-0.0158481,0.0841555,-0.996327,0
0,0,0,0,0,2836,543,3379,1586,4965,0.0445468,0.182488,-0.982198,0
0,0,0,0,0,3021,561,3582,1878,5460,0.0199912,0.228519,-0.973334,0
0,0,0,0,0,3272,548,3820,1861,5681,-0.025787,-0.0689435,-0.997287,0
0,0,0,0,0,3211,557,3768,1723,5491,-0.0317161,-0.0207114,-0.999282,0
0,0,0,0,0,2974,565,3539,1617,5156,-0.0488804,-0.0932521,-0.994442,0
0,0,0,0,0,2778,612,3390,1498,4888,-0.0382149,0.000631247,-0.999269,0
0,0,0,0,0,2835,535,3370,1131,4501,-0.0497254,-0.10742,-0.992969,0
0,0,0,0,0,2797,537,3334,1572,4906,-0.04523,-0.0708349,-0.996462,0
0,0,0,0,0,2985,560,3545,1200,4745,-0.0190793,0.0430043,-0.998893,0
0,0,0,0,0,2811,595,3406,1179,4585,-0.0214101,0.0882499,-0.995868,0
0,0,0,0,0,2834,540,3374,1317,4691,0.030575,0.131212,-0.990883,0
0,0,0,0,0,2665,540,3205,1393,4598,0.0495792,0.132071,-0.99,0
0,0,0,0,0,2967,529,3496,1125,4621,-0.0601412,-0.103463,-0.992813,0
0,0,0,0,0,2736,533,3269,1416,4685,-0.0525321,-0.139675,-0.988803,0
0,0,0,0,0,2963,533,3496,1664,5160,-0.0659656,-0.103543,-0.992435,0
0,0,0,0,0,2991,534,3525,1697,5222,-0.0663424,-0.0607462,-0.995946,0
0,0,0,0,0,2863,557,3420,1740,5160,-0.0650592,-0.062108,-0.995947,0
0,0,0,0,0,2764,480,3244,3871,7115,-0.102681,-0.278121,-0.955042,0
0,0,0,0,0,2748,484,3232,4475,7707,0.118184,0.104875,-0.987438,0
0,0,0,0,0,2886,537,3423,2075,5498,-0.0330841,-0.0275168,-0.999074,0
0,0,0,0,0,2782,471,3253,2293,5546,-0.0448473,-0.045564,-0.997954,0
0,0,0,0,0,2735,484,3219,8385,11604,0.114926,0.145946,-0.982594,0
0,0,0,0,0,2873,538,3411,1780,5191,-0.0189245,0.0796441,-0.996644,0
0,0,0,0,0,3073,536,3609,1356,4965,-0.0606561,-0.11778,-0.991186,0
0,0,0,0,0,2699,515,3214,6217,9431,-0.0611644,-0.115304,-0.991445,0
0,0,0,0,0,2804,495,3299,2548,5847,-0.0665873,-0.121675,-0.990334,0
0,0,0,0,0,2757,570,3327,2013,5340,-0.0606696,-0.121147,-0.990779,0
0,0,0,0,0,2742,516,3258,1953,5211,-0.0545222,-0.174036,-0.983229,0
0,0,0,0,0,2817,501,3318,2554,5872,-0.0329517,-0.131434,-0.990777,0
0,0,0,0,0,2776,513,3289,2071,5360,-0.0851998,-0.217303,-0.972379,0
0,0,0,0,0,2670,555,3225,1918,5143,-0.0806124,-0.196835,-0.977117,0
0,0,0,0,0,2755,559,3314,2332,5646,-0.118756,-0.264204,-0.957128,0
0,0,0,0,0,3134,519,3653,2695,6348,-0.139152,-0.353533,-0.925014,0
0,0,0,0,0,2665,523,3188,2064,5252,-0.0839554,-0.0672619,-0.994197,0
0,0,0,0,0,2861,509,3370,2344,5714,-0.102188,-0.182952,-0.977797,0
0,0,0,0,0,2765,546,3311,2426,5737,-0.100897,-0.171435,-0.980015,0
0,0,0,0,0,2786,526,3312,2113,5425,-0.171048,-0.252028,-0.952483,0
0,0,0,0,0,2773,562,3335,1772,5107,-0.152384,-0.306059,-0.939738,0
0,0,0,0,0,2886,556,3442,2275,5717,-0.143124,-0.279549,-0.949404,0
0,0,0,0,0,2817,541,3358,2628,5986,-0.168715,-0.372384,-0.912615,0
0,0,0,0,0,3179,554,3733,2420,6153,-0.198527,-0.396452,-0.896333,0
0,0,0,0,0,3043,610,3653,1955,5608,-0.233575,-0.437867,-0.868168,0
0,0,0,0,0,2956,555,3511,2003,5514,-0.22818,-0.468837,-0.853303,0
0,0,0,0,0,2921,549,3470,2990,6460,-0.0270145,0.04552,-0.998598,0
0,0,0,0,0,2850,550,3400,2485,5885,-0.0333546,-0.0241764,-0.999151,0
0,0,0,0,0,2952,533,3485,1954,5439,-0.0573271,0.0871139,-0.994548,0
0,0,0,0,0,2961,544,3505,1329,4834,-0.0298674,0.0369984,-0.998869,0
0,0,0,0,0,3029,537,3566,1753,5319,-0.0592407,-0.105487,-0.992655,0
0,0,0,0,0,3070,547,3617,1529,5146,0.00016588,0.034733,-0.999397,0
0,0,0,0,0,3098,593,3691,1456,5147,-0.0318181,-0.0349031,-0.998884,0
0,0,0,0,0,3070,571,3641,1368,5009,0.010875,0.161816,-0.986761,0
0,0,0,0,0,2778,571,3349,1413,4762,-0.0315071,-0.0640201,-0.997451,0
0,0,0,0,0,2952,568,3520,1343,4863,-0.00736863,0.12532,-0.992089,0
0,0,0,0,0,2747,500,3247,983,4230,-0.0269814,0.075165,-0.996806,0
0,0,0,0,0,2691,517,3208,1371,4579,-0.0321865,-0.0846914,-0.995887,0
0,0,0,0,0,2621,535,3156,1175,4331,-0.0573615,-0.164061,-0.984781,0
0,0,0,0,0,2775,520,3295,1178,4473,0.00318881,0.0320435,-0.999481,0
0,0,0,0,0,2764,504,3268,991,4259,0.0157062,0.016932,-0.999733,0
0,0,0,0,0,2670,530,3200,1089,4289,-0.0262115,-0.0491512,-0.998447,0
0,0,0,0,0,2722,504,3226,913,4139,-0.0297758,-0.119269,-0.992415,0
0,0,0,0,0,2602,521,3123,916,4039,-0.0463952,-0.181768,-0.982246,0
0,0,0,0,0,2473,497,2970,912,3882,-0.0245417,-0.220817,-0.975006,0
0,0,0,0,0,2585,505,3090,927,4017,0.0182575,-0.0128085,-0.999751,0
0,0,0,0,0,2528,485,3013,827,3840,0.00602692,-0.052834,-0.998585,0
0,0,0,0,0,2520,523,3043,952,3995,-0.0084472,-0.104547,-0.994484,0
0,0,0,0,0,2515,485,3000,1031,4031,-0.00812431,-0.106696,-0.994258,0
0,0,0,0,0,2564,495,3059,850,3909,-0.0320196,-0.126294,-0.991476,0
0,0,0,0,0,2620,499,3119,996,4115,-0.0487441,-0.159214,-0.98604,0
0,0,0,0,0,2446,495,2941,951,3892,-0.0385578,-0.099919,-0.994248,0
0,0,0,0,0,2637,523,3160,929,4089,-0.0764365,-0.10739,-0.991274,0
0,0,0,0,0,2554,565,3119,978,4097,-0.0557759,-0.118857,-0.991344,0
0,0,0,0,0,2501,467,2968,867,3835,-0.0686857,-0.112441,-0.991282,0
0,0,0,0,0,4343,638,4981,1521,6502,-0.0448205,-0.0421973,-0.998103,0
0,0,0,0,0,2502,449,2951,946,3897,-0.030666,-0.0433706,-0.998588,0
0,0,0,0,0,2399,478,2877,840,3717,-0.0522882,-0.0407104,-0.997802,0
0,0,0,0,0,2509,432,2941,1025,3966,0.000472466,-0.0748039,-0.997198,0
0,0,0,0,0,2431,449,2880,1071,3951,-0.0381935,-0.0343039,-0.998681,0
0,0,0,0,0,2421,452,2873,1014,3887,-0.0508696,-0.0496536,-0.99747,0
0,0,0,0,0,2579,464,3043,933,3976,-0.0117368,-0.0767264,-0.996983,0
0,0,0,0,0,2487,438,2925,887,3812,-0.00845122,-0.0709083,-0.997447,0
0,0,0,0,0,2395,453,2848,864,3712,-0.00263827,-0.0764093,-0.997073,0
0,0,0,0,0,2466,438,2904,803,3707,0.00944877,-0.0430362,-0.999029,0
0,0,0,0,0,2541,460,3001,914,3915,0.0098212,-0.0930478,-0.995613,0
0,0,0,0,0,2682,445,3127,901,4028,-0.036036,-0.055301,-0.997819,0
0,0,0,0,0,2578,476,3054,934,3988,-0.0287574,-0.0623524,-0.99764,0
0,0,0,0,0,2435,446,2881,821,3702,-0.00473545,-0.0614601,-0.998098,0
0,0,0,0,0,2403,448,2851,857,3708,-0.00335329,-0.0463608,-0.998919,0
0,0,0,0,0,2537,417,2954,933,3887,-0.0243688,-0.0450607,-0.998687,0
0,0,0,0,0,2421,435,2856,875,3731,-0.0471603,-0.0427368,-0.997973,0
0,0,0,0,0,2400,425,2825,898,3723,-0.0222311,-0.0627957,-0.997779,0
0,0,0,0,0,2365,511,2876,984,3860,-0.0267007,-0.0752708,-0.996806,0
0,0,0,0,0,2490,424,2914,907,3821,-0.0162376,-0.0676886,-0.997574,0
0,0,0,0,0,2535,481,3016,1022,4038,-0.0310885,-0.073135,-0.996837,0
0,0,0,0,0,2558,446,3004,1005,4009,-0.0179891,-0.0406549,-0.999011,0
0,0,0,0,0,2395,426,2821,956,3777,-0.0144642,-0.0605576,-0.99806,0
0,0,0,0,0,2482,429,2911,886,3797,-0.0145298,-0.0570437,-0.998266,0
0,0,0,0,0,2521,447,2968,913,3881,-0.00421281,-0.0531646,-0.998577,0
0,0,0,0,0,2385,446,2831,1002,3833,-0.00279092,-0.0440083,-0.999027,0
0,0,0,0,0,2389,422,2811,942,3753,-0.0163404,-0.0388684,-0.999111,0
0,0,0,0,0,2595,433,3028,915,3943,-0.0184739,-0.0349535,-0.999218,0
0,0,0,0,0,2440,449,2889,910,3799,-0.0206821,-0.0599142,-0.997989,0
0,0,0,0,0,2569,488,3057,922,3979,-0.0251149,-0.0773218,-0.99669,0
0,0,0,0,0,2493,429,2922,919,3841,-0.0478303,-0.0811921,-0.99555,0
0,0,0,0,0,2441,440,2881,958,3839,-0.00911823,-0.0597466,-0.998172,0
0,0,0,0,0,2496,436,2932,795,3727,-0.00338137,-0.039151,-0.999228,0
0,0,0,0,0,2369,437,2806,854,3660,-0.0225191,-0.0501453,-0.998488,0
0,0,0,0,0,2481,467,2948,926,3874,-0.00298181,-0.0483572,-0.998826,0
0,0,0,0,0,2512,451,2963,969,3932,-0.0160862,-0.0449912,-0.998858,0
0,0,0,0,0,2376,456,2832,934,3766,0.00657546,-0.0569031,-0.998358,0
0,0,0,0,0,2446,411,2857,970,3827,-0.0222774,-0.0512872,-0.998435,0

