Downsample[ns],BuildFilTree[ns],SearchFil[ns],DeleteFil[ns],BuildTreeSub[ns],SearchSub[ns],DeleteSub[ns],PreProcTotal[ns],Plane[ns],Total[ns],nx,ny,nz,planeCount
0,0,0,0,0,7289,1032,8321,7731,16052,-0.0438871,0.216924,-0.975202,0
0,0,0,0,0,2924,508,3432,1852,5284,-0.0118617,0.082875,-0.996489,0
0,0,0,0,0,6225,945,7170,2533,9703,-0.0195029,0.098876,-0.994909,0
0,0,0,0,0,5624,949,6573,2746,9319,-0.0302343,0.102489,-0.994275,0
0,0,0,0,0,5718,1065,6783,2394,9177,-0.0165391,0.0799944,-0.996658,0
0,0,0,0,0,5582,957,6539,2745,9284,0.0112832,0.0757208,-0.997065,0
0,0,0,0,0,5982,960,6942,2754,9696,0.0249854,0.0597133,-0.997903,0
0,0,0,0,0,5425,963,6388,2535,8923,0.027496,0.065124,-0.997498,0
0,0,0,0,0,6286,1073,7359,2723,10082,-0.00684633,0.0587899,-0.998247,0
0,0,0,0,0,5466,934,6400,2556,8956,-0.000950165,0.0473559,-0.998878,0
0,0,0,0,0,5717,936,6653,2224,8877,0.00591905,0.0668465,-0.997746,0
0,0,0,0,0,6303,1029,7332,2481,9813,0.0051627,0.0491612,-0.998778,0
0,0,0,0,0,5623,952,6575,2412,8987,0.00198812,0.0545215,-0.998511,0
0,0,0,0,0,5901,922,6823,2533,9356,0.00391501,0.07288,-0.997333,0
0,0,0,0,0,5406,955,6361,2546,8907,-0.0289286,0.0588512,-0.997848,0
0,0,0,0,0,3703,660,4363,1314,5677,-0.0292064,0.0213894,-0.999345,0
0,0,0,0,0,4043,678,4721,1870,6591,-0.0179948,0.0528426,-0.998441,0
0,0,0,0,0,5655,953,6608,2880,9488,-0.0210286,0.0336055,-0.999214,0
0,0,0,0,0,5452,934,6386,2669,9055,-0.0269304,0.0208058,-0.999421,0
0,0,0,0,0,6120,1014,7134,2614,9748,-0.0328538,-0.00794892,-0.999429,0
0,0,0,0,0,5285,909,6194,1968,8162,-0.030672,-0.00985062,-0.999481,0
0,0,0,0,0,5139,617,5756,1412,7168,-0.0250168,-0.0310545,-0.999205,0
0,0,0,0,0,3260,594,3854,1470,5324,-0.0246636,-0.0308581,-0.999219,0
0,0,0,0,0,5421,1216,6637,2236,8873,-0.0251988,-0.0234507,-0.999407,0
0,0,0,0,0,6329,1272,7601,2220,9821,-0.0168598,-0.0182909,-0.999691,0
0,0,0,0,0,5561,897,6458,2279,8737,-0.00620349,-0.00254853,-0.999978,0
0,0,0,0,0,7142,976,8118,1899,10017,-0.0147329,-0.00621554,-0.999872,0
0,0,0,0,0,3765,621,4386,1440,5826,-0.0106185,0.0020568,-0.999942,0
0,0,0,0,0,5516,1101,6617,2224,8841,-0.0161308,-0.000805042,-0.99987,0
0,0,0,0,0,5518,1123,6641,2198,8839,-0.032563,-0.000935596,-0.999469,0
0,0,0,0,0,3761,638,4399,1443,5842,-0.0290756,0.00157551,-0.999576,0
0,0,0,0,0,5324,909,6233,2190,8423,-0.0250264,-0.00147768,-0.999686,0
0,0,0,0,0,5350,908,6258,2129,8387,-0.0109791,0.000382428,-0.99994,0
0,0,0,0,0,5667,901,6568,2426,8994,-0.0323809,0.0159873,-0.999348,0
0,0,0,0,0,5846,635,6481,1846,8327,-0.0234583,-0.00844244,-0.999689,0
0,0,0,0,0,2872,474,3346,1208,4554,-0.0274489,-0.00248714,-0.99962,0
0,0,0,0,0,5481,914,6395,2240,8635,-0.0295747,-0.0101139,-0.999511,0
0,0,0,0,0,5466,895,6361,2319,8680,-0.0332965,-0.00092751,-0.999445,0
0,0,0,0,0,5568,925,6493,2232,8725,-0.0357822,0.00182721,-0.999358,0
0,0,0,0,0,5594,998,6592,3161,9753,-0.0330146,-0.00337475,-0.999449,0
0,0,0,0,0,2318,384,2702,895,3597,-0.0339303,-0.00700118,-0.9994,0
0,0,0,0,0,5550,935,6485,2098,8583,-0.0282607,0.00195326,-0.999599,0
0,0,0,0,0,5518,924,6442,2103,8545,-0.0320366,0.0181019,-0.999323,0
0,0,0,0,0,6238,946,7184,2607,9791,-0.0431149,-0.0129735,-0.998986,0
0,0,0,0,0,5423,897,6320,2107,8427,-0.0501865,-0.00894054,-0.9987,0
0,0,0,0,0,5866,915,6781,2224,9005,-0.040949,-0.0069046,-0.999137,0
0,0,0,0,0,5411,897,6308,2523,8831,-0.0416268,-0.000686791,-0.999133,0
0,0,0,0,0,5321,928,6249,2107,8356,-0.0385349,0.0103216,-0.999204,0
0,0,0,0,0,5993,1017,7010,2186,9196,-0.0373081,0.0137863,-0.999209,0
0,0,0,0,0,5299,894,6193,2086,8279,-0.0302427,0.0162168,-0.999411,0
0,0,0,0,0,4044,687,4731,1503,6234,-0.00362041,-0.0130412,-0.999908,0
0,0,0,0,0,4613,739,5352,2063,7415,0.00705605,-0.00612627,-0.999956,0
0,0,0,0,0,5573,913,6486,2394,8880,0.0037744,0.00231024,-0.99999,0
0,0,0,0,0,5428,911,6339,2760,9099,-0.0313377,0.0175502,-0.999355,0
0,0,0,0,0,6567,1147,7714,2763,10477,-0.0410042,0.00559632,-0.999143,0
0,0,0,0,0,4990,618,5608,1376,6984,-0.0447555,-0.00108104,-0.998997,0
0,0,0,0,0,5297,890,6187,1509,7696,-0.0462817,-0.00110108,-0.998928,0
0,0,0,0,0,4756,901,5657,2012,7669,-0.0390387,0.0195913,-0.999046,0
0,0,0,0,0,5382,890,6272,2556,8828,-0.0368658,0.0176689,-0.999164,0
0,0,0,0,0,5443,935,6378,2325,8703,-0.0442286,0.00973138,-0.998974,0
0,0,0,0,0,5278,1106,6384,2144,8528,-0.0414496,0.00388754,-0.999133,0
0,0,0,0,0,5387,893,6280,2051,8331,-0.0418045,0.00487353,-0.999114,0
0,0,0,0,0,6034,914,6948,1978,8926,-0.0609688,0.00808282,-0.998107,0
0,0,0,0,0,5388,897,6285,2130,8415,-0.0359421,-0.0113173,-0.99929,0
0,0,0,0,0,5536,892,6428,2187,8615,-0.034538,-0.00432381,-0.999394,0
0,0,0,0,0,5418,929,6347,2069,8416,-0.0581395,-5.61095e-05,-0.998308,0
0,0,0,0,0,5402,918,6320,2284,8604,-0.0546544,-0.0131957,-0.998418,0
0,0,0,0,0,6016,915,6931,2235,9166,-0.0507532,-0.00791735,-0.99868,0
0,0,0,0,0,5378,889,6267,2145,8412,-0.0473294,-0.00738849,-0.998852,0
0,0,0,0,0,5434,913,6347,2291,8638,-0.0532199,0.00367444,-0.998576,0
0,0,0,0,0,5424,935,6359,2371,8730,-0.0622629,-0.00388818,-0.998052,0
0,0,0,0,0,5314,893,6207,2267,8474,-0.0640919,-0.00784594,-0.997913,0
0,0,0,0,0,5264,893,6157,2224,8381,-0.0514969,-0.0134603,-0.998582,0
0,0,0,0,0,5484,888,6372,2398,8770,-0.0546873,-0.0197015,-0.998309,0
0,0,0,0,0,5312,892,6204,2231,8435,-0.0517226,-0.0178081,-0.998503,0
0,0,0,0,0,5430,892,6322,2660,8982,-0.0460839,-0.00579871,-0.998921,0
0,0,0,0,0,5505,968,6473,2168,8641,-0.055617,-0.00550425,-0.998437,0
0,0,0,0,0,5356,895,6251,2108,8359,-0.0486127,0.00181784,-0.998816,0
0,0,0,0,0,6102,1002,7104,2519,9623,-0.0544161,-0.00896827,-0.998478,0
0,0,0,0,0,3953,667,4620,1122,5742,-0.0422733,0.00758051,-0.999077,0
0,0,0,0,0,4828,818,5646,2175,7821,-0.0417783,0.00466019,-0.999116,0
0,0,0,0,0,6285,999,7284,2091,9375,-0.0431634,-0.00540497,-0.999053,0
0,0,0,0,0,5337,894,6231,2332,8563,-0.0489584,-0.00579541,-0.998784,0
0,0,0,0,0,4836,805,5641,1955,7596,-0.0490796,-0.013546,-0.998703,0
0,0,0,0,0,5844,1011,6855,2039,8894,-0.0378316,0.00263266,-0.999281,0
0,0,0,0,0,5372,899,6271,2205,8476,-0.0310755,-0.00659491,-0.999495,0
0,0,0,0,0,5543,894,6437,2078,8515,-0.0242152,-0.0138989,-0.99961,0
0,0,0,0,0,5342,891,6233,2693,8926,-0.0238414,0.000638497,-0.999716,0
0,0,0,0,0,5365,897,6262,2055,8317,-0.0329401,-0.0129051,-0.999374,0
0,0,0,0,0,5278,888,6166,2211,8377,-0.0242051,-0.0128386,-0.999625,0
0,0,0,0,0,5378,891,6269,2346,8615,-0.00271748,-0.0170708,-0.999851,0
0,0,0,0,0,5313,904,6217,2668,8885,0.0311474,-0.0305764,-0.999047,0
0,0,0,0,0,5373,920,6293,2862,9155,0.0379428,-0.0447257,-0.998278,0
0,0,0,0,0,6101,949,7050,2943,9993,0.041479,-0.0265212,-0.998787,0
0,0,0,0,0,5504,933,6437,2460,8897,0.0124666,-0.0350295,-0.999309,0
0,0,0,0,0,3708,653,4361,1935,6296,-0.00139213,-0.0337558,-0.999429,0
0,0,0,0,0,5580,929,6509,2797,9306,-0.019172,-0.0426193,-0.998907,0
0,0,0,0,0,5467,898,6365,2511,8876,-0.0226168,-0.0225603,-0.99949,0
0,0,0,0,0,6394,1082,7476,2209,9685,-0.0122659,-0.0330198,-0.999379,0
0,0,0,0,0,5338,897,6235,2266,8501,0.0122216,-0.0366693,-0.999253,0
0,0,0,0,0,3911,684,4595,1674,6269,0.0279523,-0.0239264,-0.999323,0
0,0,0,0,0,5404,976,6380,2634,9014,0.0482406,-0.0328617,-0.998295,0
0,0,0,0,0,5359,969,6328,2703,9031,0.0185278,-0.0167306,-0.999688,0
0,0,0,0,0,5479,1074,6553,2621,9174,0.00676177,-0.0108611,-0.999918,0
0,0,0,0,0,5573,902,6475,2250,8725,0.00992907,-0.00979992,-0.999903,0
0,0,0,0,0,5257,904,6161,2514,8675,-0.0332163,-0.00766241,-0.999419,0
0,0,0,0,0,6132,1004,7136,2056,9192,-0.0298121,-0.00814058,-0.999522,0
0,0,0,0,0,5491,898,6389,2194,8583,-0.0327496,0.0192986,-0.999277,0
0,0,0,0,0,5378,961,6339,2546,8885,-0.0287957,-0.00039469,-0.999585,0
0,0,0,0,0,5323,907,6230,2199,8429,-0.0247108,9.74075e-05,-0.999695,0
0,0,0,0,0,5263,1067,6330,2012,8342,-0.0192016,0.00741598,-0.999788,0
0,0,0,0,0,5867,930,6797,2199,8996,-0.0204016,0.00474571,-0.999781,0
0,0,0,0,0,5302,890,6192,2046,8238,-0.0275157,0.00641341,-0.999601,0
0,0,0,0,0,6814,1115,7929,2388,10317,-0.029162,0.00818051,-0.999541,0
0,0,0,0,0,5295,925,6220,2273,8493,-0.0271653,-0.00637634,-0.999611,0
0,0,0,0,0,5637,994,6631,2118,8749,-0.032396,-0.00513339,-0.999462,0
0,0,0,0,0,5937,1024,6961,2391,9352,-0.0285161,-0.00851643,-0.999557,0
0,0,0,0,0,5335,899,6234,2627,8861,-0.0253754,0.000236236,-0.999678,0
0,0,0,0,0,3133,489,3622,1120,4742,-0.0451941,0.00926129,-0.998935,0
0,0,0,0,0,1912,323,2235,798,3033,-0.052063,-0.00800388,-0.998612,0
0,0,0,0,0,5209,825,6034,1953,7987,-0.0352746,-0.0105334,-0.999322,0
0,0,0,0,0,5657,910,6567,2476,9043,-0.0359029,-0.00844887,-0.99932,0
0,0,0,0,0,5781,938,6719,2148,8867,-0.0372495,-0.00802242,-0.999274,0
0,0,0,0,0,5569,954,6523,2216,8739,-0.0383333,0.019498,-0.999075,0
0,0,0,0,0,5731,970,6701,2320,9021,-0.0518319,0.0187934,-0.998479,0
0,0,0,0,0,5843,932,6775,2124,8899,-0.0544998,0.0206795,-0.9983,0
0,0,0,0,0,4010,656,4666,1687,6353,-0.0581239,0.0211419,-0.998085,0
0,0,0,0,0,6732,1146,7878,2528,10406,-0.0522471,0.0293528,-0.998203,0
0,0,0,0,0,7029,1041,8070,2300,10370,-0.0547798,0.0368759,-0.997817,0
0,0,0,0,0,5978,977,6955,2124,9079,-0.0448512,0.057237,-0.997353,0
0,0,0,0,0,6989,1122,8111,2192,10303,-0.0423702,0.0931078,-0.994754,0
0,0,0,0,0,6585,1033,7618,2156,9774,-0.0471446,0.13562,-0.989639,0
0,0,0,0,0,4553,712,5265,1563,6828,0.0032735,0.120231,-0.992741,0
0,0,0,0,0,6471,1073,7544,2752,10296,-0.0489086,0.13392,-0.989784,0
0,0,0,0,0,6714,1055,7769,3315,11084,-0.0799155,0.1141,-0.99025,0
0,0,0,0,0,6939,1108,8047,2268,10315,-0.100594,0.149237,-0.983671,0
0,0,0,0,0,4775,761,5536,2889,8425,-0.129904,0.18607,-0.973911,0
0,0,0,0,0,3686,591,4277,1384,5661,-0.116284,0.199337,-0.973007,0
0,0,0,0,0,7123,1253,8376,3197,11573,-0.119006,0.219611,-0.968302,0
0,0,0,0,0,7294,1142,8436,2756,11192,-0.116236,0.233748,-0.965324,0
0,0,0,0,0,3854,610,4464,1834,6298,-0.139943,0.341958,-0.929237,0
0,0,0,0,0,7437,1145,8582,2815,11397,-0.143049,0.367127,-0.919105,0
0,0,0,0,0,5089,826,5915,3258,9173,-0.150002,0.386367,-0.910066,0
0,0,0,0,0,7160,1064,8224,4238,12462,-0.0806244,0.365199,-0.927432,0
0,0,0,0,0,6125,961,7086,4064,11150,-0.0628459,0.297249,-0.952729,0
0,0,0,0,0,4424,737,5161,2669,7830,-0.0651894,0.271733,-0.960162,0
0,0,0,0,0,7372,1246,8618,8764,17382,-0.0955131,0.467852,-0.878631,0
0,0,0,0,0,4186,610,4796,3799,8595,-0.106543,0.460116,-0.881443,0
0,0,0,0,0,5321,868,6189,4467,10656,-0.138321,0.381799,-0.913836,0
0,0,0,0,0,7068,1192,8260,8920,17180,-0.0993823,0.00172808,-0.995048,0
0,0,0,0,0,7037,1194,8231,7563,15794,-0.0549158,0.284315,-0.957157,0
0,0,0,0,0,2943,497,3440,5308,8748,0.0132709,0.282037,-0.959312,0
0,0,0,0,0,7594,1217,8811,13804,22615,0.00571591,0.114958,-0.993354,0
0,0,0,0,0,3615,605,4220,6412,10632,-0.158783,-0.0492023,-0.986087,0
0,0,0,0,0,4015,673,4688,6930,11618,-0.0862115,-0.040645,-0.995447,0
0,0,0,0,0,7511,1132,8643,8377,17020,-0.171619,0.00832395,-0.985128,0
0,0,0,0,0,2763,479,3242,3199,6441,-0.125405,-0.0240963,-0.991813,0
0,0,0,0,0,7445,1137,8582,11895,20477,-0.063761,0.0681821,-0.995633,0
0,0,0,0,0,4477,740,5217,6169,11386,-0.106682,0.0948656,-0.989757,0
0,0,0,0,0,3254,570,3824,6020,9844,-0.106268,0.0998866,-0.989308,0
0,0,0,0,0,3965,699,4664,7513,12177,-0.119874,0.0527233,-0.991388,0
0,0,0,0,0,5025,851,5876,8973,14849,-0.0967887,0.244869,-0.964713,0
0,0,0,0,0,3900,637,4537,5200,9737,-0.0808205,0.0772199,-0.993733,0
0,0,0,0,0,6060,1059,7119,12055,19174,-0.0809868,0.158397,-0.984048,0
0,0,0,0,0,4201,714,4915,7055,11970,-0.10577,0.111048,-0.988171,0
0,0,0,0,0,5271,934,6205,8573,14778,-0.156741,0.276477,-0.948152,0
0,0,0,0,0,6027,1047,7074,8640,15714,-0.114153,0.174637,-0.977993,0
0,0,0,0,0,6235,1049,7284,5872,13156,-0.0891831,0.247061,-0.964887,0
0,0,0,0,0,2886,493,3379,3563,6942,-0.0659266,0.237084,-0.96925,0
0,0,0,0,0,5236,966,6202,4602,10804,-0.0936435,0.267434,-0.959015,0
0,0,0,0,0,5605,984,6589,6866,13455,-0.0598409,0.228719,-0.971651,0
0,0,0,0,0,5782,980,6762,6206,12968,-0.0773176,0.308361,-0.948122,0
0,0,0,0,0,3913,695,4608,4081,8689,-0.0923754,0.189885,-0.977451,0
0,0,0,0,0,5627,1013,6640,5125,11765,-0.0638653,0.192816,-0.979154,0
0,0,0,0,0,5569,1042,6611,5237,11848,-0.0453904,0.180325,-0.982559,0
0,0,0,0,0,5521,981,6502,5100,11602,0.0137638,0.0838679,-0.996382,0
0,0,0,0,0,5523,974,6497,4405,10902,-0.0466763,0.165107,-0.985171,0
0,0,0,0,0,5616,1015,6631,4139,10770,-0.0526009,0.109493,-0.992595,0
0,0,0,0,0,5038,886,5924,3600,9524,-0.0518359,0.132224,-0.989864,0
0,0,0,0,0,5469,1005,6474,3202,9676,-0.069171,0.149359,-0.986361,0
0,0,0,0,0,5530,961,6491,3185,9676,-0.0814333,0.155369,-0.984494,0
0,0,0,0,0,5541,942,6483,4453,10936,-0.0574916,0.0922401,-0.994076,0
0,0,0,0,0,5724,1024,6748,3544,10292,-0.00923223,0.0761121,-0.997057,0
0,0,0,0,0,5596,991,6587,3630,10217,-0.0316189,0.106706,-0.993788,0
0,0,0,0,0,6188,991,7179,3207,10386,-0.0196001,0.0923709,-0.995532,0
0,0,0,0,0,5648,984,6632,3084,9716,-0.0174281,0.0759282,-0.996961,0
0,0,0,0,0,5959,1024,6983,3317,10300,-0.0278901,0.102384,-0.994354,0
0,0,0,0,0,3934,670,4604,2655,7259,-0.0422744,0.0889685,-0.995137,0
0,0,0,0,0,5722,994,6716,3933,10649,-0.0544628,0.126724,-0.990442,0
0,0,0,0,0,5824,972,6796,10054,16850,-0.0295349,-0.0427564,-0.998649,0
0,0,0,0,0,2482,447,2929,1326,4255,-0.0690998,0.0933752,-0.99323,0
0,0,0,0,0,5641,981,6622,10193,16815,-0.0143597,0.0154483,-0.999778,0
0,0,0,0,0,3895,718,4613,2271,6884,-0.0429763,0.0321288,-0.998559,0
0,0,0,0,0,5719,1052,6771,3564,10335,-0.0427564,0.101341,-0.993933,0
0,0,0,0,0,5753,1042,6795,7672,14467,0.00438547,0.0608428,-0.998138,0
0,0,0,0,0,2988,543,3531,3393,6924,0.150434,-0.138867,-0.978818,0
0,0,0,0,0,5697,1100,6797,3861,10658,-0.0282038,0.0421606,-0.998713,0
0,0,0,0,0,5826,1079,6905,4500,11405,0.114721,-0.160417,-0.98036,0
0,0,0,0,0,5987,1033,7020,3135,10155,0.10719,-0.138997,-0.984475,0
0,0,0,0,0,3964,742,4706,1958,6664,-0.0644973,0.0907261,-0.993785,0
0,0,0,0,0,5173,942,6115,3349,9464,-0.0490521,0.150157,-0.987445,0
0,0,0,0,0,5313,978,6291,2582,8873,-0.0856804,0.150538,-0.984884,0
0,0,0,0,0,3650,700,4350,1824,6174,-0.0293019,0.14779,-0.988585,0
0,0,0,0,0,6209,1064,7273,2502,9775,-0.0317302,0.149048,-0.988321,0
0,0,0,0,0,6191,1083,7274,2261,9535,-0.0653085,0.122646,-0.990299,0
0,0,0,0,0,5912,1125,7037,2565,9602,-0.0403411,0.130621,-0.990611,0
0,0,0,0,0,6089,1404,7493,2594,10087,-0.0482291,0.0853197,-0.995186,0
0,0,0,0,0,6007,1130,7137,2258,9395,-0.0637802,0.0773282,-0.994964,0
0,0,0,0,0,6326,1194,7520,2009,9529,-0.0515517,0.099083,-0.993743,0
0,0,0,0,0,4175,762,4937,1748,6685,-0.0589047,0.101069,-0.993134,0
0,0,0,0,0,6451,1104,7555,2474,10029,-0.0566996,0.0824817,-0.994978,0
0,0,0,0,0,6083,1126,7209,2387,9596,-0.0565307,0.0929566,-0.994064,0
0,0,0,0,0,6125,1139,7264,2369,9633,-0.0490561,0.0954178,-0.994228,0
0,0,0,0,0,6807,1189,7996,2274,10270,-0.0786773,0.119818,-0.989673,0
0,0,0,0,0,4356,836,5192,1703,6895,-0.0535387,0.107696,-0.992741,0
0,0,0,0,0,6167,1126,7293,2493,9786,-0.0788336,0.153764,-0.984958,0
0,0,0,0,0,7656,1330,8986,2629,11615,-0.0578451,0.149038,-0.987138,0
0,0,0,0,0,6325,1148,7473,2735,10208,-0.0635536,0.119325,-0.990819,0
0,0,0,0,0,4111,764,4875,2830,7705,-0.0599581,0.0884017,-0.994279,0
0,0,0,0,0,4132,750,4882,2465,7347,-0.0648013,0.186028,-0.980405,0
0,0,0,0,0,3971,722,4693,2830,7523,-0.0586127,0.140778,-0.988305,0
0,0,0,0,0,5786,1046,6832,4205,11037,-0.0184366,0.0128463,-0.999748,0
0,0,0,0,0,5587,1069,6656,4509,11165,-0.025688,0.156927,-0.987276,0
0,0,0,0,0,5717,1045,6762,5241,12003,-0.0415151,0.0841731,-0.995586,0
0,0,0,0,0,3779,700,4479,4049,8528,-0.100251,0.247166,-0.963773,0
0,0,0,0,0,5468,1011,6479,6632,13111,-0.126964,0.253745,-0.958902,0
0,0,0,0,0,5349,999,6348,4762,11110,-0.0292167,0.195964,-0.980176,0
0,0,0,0,0,2268,416,2684,3759,6443,-0.0642253,0.204256,-0.976808,0
0,0,0,0,0,2622,482,3104,5150,8254,-0.113466,0.273397,-0.955186,0
0,0,0,0,0,3939,720,4659,7167,11826,-0.0600237,0.229311,-0.971501,0
0,0,0,0,0,5449,971,6420,10960,17380,-0.178834,0.423698,-0.887974,0
0,0,0,0,0,3642,677,4319,4782,9101,-0.188834,0.559446,-0.80707,0
0,0,0,0,0,2243,412,2655,4391,7046,-0.0609932,0.244171,-0.967812,0
0,0,0,0,0,6076,1018,7094,12351,19445,-0.00176381,0.120218,-0.992746,0
0,0,0,0,0,5341,979,6320,9541,15861,-0.0494514,0.133337,-0.989836,0
0,0,0,0,0,2305,481,2786,6452,9238,-0.0439005,0.113875,-0.992525,0
0,0,0,0,0,5362,1002,6364,11227,17591,-0.141412,0.455547,-0.878908,0
0,0,0,0,0,2856,509,3365,6539,9904,-0.139575,0.0574445,-0.988544,0
0,0,0,0,0,2992,527,3519,8591,12110,-0.059351,0.0487187,-0.997048,0
0,0,0,0,0,5513,1071,6584,13170,19754,-0.00864747,0.332123,-0.943196,0
0,0,0,0,0,3302,525,3827,5006,8833,-0.0312376,0.0826535,-0.996089,0
0,0,0,0,0,2710,510,3220,6194,9414,-0.115727,0.0966539,-0.988567,0
0,0,0,0,0,5548,976,6524,11866,18390,-0.137618,0.194935,-0.971114,0
0,0,0,0,0,3068,691,3759,8184,11943,-0.189289,0.279322,-0.941355,0
0,0,0,0,0,3386,618,4004,9583,13587,-0.0749398,0.088173,-0.993282,0
0,0,0,0,0,5494,1043,6537,11233,17770,-0.0846307,0.104999,-0.990865,0
0,0,0,0,0,2822,513,3335,5291,8626,-0.165845,0.225841,-0.959943,0
0,0,0,0,0,2322,433,2755,5046,7801,-0.219055,0.183532,-0.958296,0
0,0,0,0,0,4632,786,5418,8072,13490,-0.11972,0.102934,-0.987457,0
0,0,0,0,0,4070,820,4890,6528,11418,-0.0865997,0.0340152,-0.995662,0
0,0,0,0,0,5796,1169,6965,11030,17995,-0.108024,-0.0420845,-0.993257,0
0,0,0,0,0,2883,481,3364,5874,9238,-0.0750007,-0.0662479,-0.99498,0
0,0,0,0,0,5648,894,6542,7011,13553,-0.0844702,-0.000510437,-0.996426,0
0,0,0,0,0,4737,831,5568,8144,13712,-0.15318,0.0826271,-0.984738,0
0,0,0,0,0,5265,960,6225,7764,13989,-0.307914,0.14839,-0.939771,0
0,0,0,0,0,2228,435,2663,4666,7329,-0.320645,0.213017,-0.922936,0
0,0,0,0,0,5249,974,6223,10833,17056,-0.23134,0.149757,-0.961278,0
0,0,0,0,0,5291,1078,6369,6338,12707,-0.292208,0.246947,-0.923922,0
0,0,0,0,0,4724,884,5608,9636,15244,-0.311474,0.132657,-0.940949,0
0,0,0,0,0,3357,610,3967,6301,10268,-0.209986,0.439896,-0.873154,0
0,0,0,0,0,5477,1027,6504,16230,22734,-0.296691,0.183299,-0.937217,0
0,0,0,0,0,3616,681,4297,7677,11974,-0.271211,0.263556,-0.925734,0
0,0,0,0,0,2802,527,3329,5049,8378,-0.223421,0.179819,-0.957992,0
0,0,0,0,0,6080,978,7058,11378,18436,-0.21792,0.182801,-0.958694,0
0,0,0,0,0,3591,657,4248,6261,10509,-0.259963,0.199762,-0.94473,0
0,0,0,0,0,5397,965,6362,7508,13870,-0.176883,0.147476,-0.97312,0
0,0,0,0,0,5185,986,6171,8945,15116,-0.224041,0.145087,-0.96372,0
0,0,0,0,0,2840,499,3339,4544,7883,-0.300308,0.130664,-0.94485,0
0,0,0,0,0,6009,959,6968,8162,15130,-0.31614,0.211604,-0.924813,0
0,0,0,0,0,5362,973,6335,8051,14386,-0.224449,0.113445,-0.96786,0
0,0,0,0,0,4273,807,5080,8102,13182,-0.198044,0.079887,-0.976932,0
0,0,0,0,0,5298,978,6276,8578,14854,-0.231601,0.182914,-0.95546,0
0,0,0,0,0,3625,657,4282,7712,11994,-0.0837593,0.214185,-0.973195,0
0,0,0,0,0,5399,992,6391,14172,20563,-0.197595,0.447692,-0.872083,0
0,0,0,0,0,2769,514,3283,8339,11622,-0.126363,0.261102,-0.957005,0
0,0,0,0,0,5239,1003,6242,11018,17260,-0.136529,0.532139,-0.835576,0
0,0,0,0,0,3645,705,4350,6772,11122,0.00523744,0.171926,-0.985096,0
0,0,0,0,0,4708,919,5627,6891,12518,6.37369e-05,0.102969,-0.994685,0
0,0,0,0,0,5345,1025,6370,8887,15257,0.0418775,0.215143,-0.975684,0
0,0,0,0,0,3700,687,4387,6653,11040,-0.0208888,0.0579275,-0.998102,0
0,0,0,0,0,5855,968,6823,9593,16416,0.00619932,0.071643,-0.997411,0
0,0,0,0,0,3623,702,4325,4861,9186,-0.00353168,0.0425518,-0.999088,0
0,0,0,0,0,5356,946,6302,6251,12553,0.0600147,0.241033,-0.96866,0
0,0,0,0,0,4870,886,5756,6341,12097,0.0181579,0.25066,-0.967905,0
0,0,0,0,0,2711,484,3195,3328,6523,-0.00376524,0.225345,-0.974272,0
0,0,0,0,0,5651,975,6626,7347,13973,0.0216753,0.12245,-0.992238,0
0,0,0,0,0,3646,656,4302,5149,9451,0.0204714,0.151918,-0.988181,0
0,0,0,0,0,4732,854,5586,6765,12351,0.058258,0.219185,-0.973943,0
0,0,0,0,0,5536,992,6528,8899,15427,0.0960407,0.247542,-0.964105,0
0,0,0,0,0,3760,674,4434,4951,9385,8.47028e-05,0.142264,-0.989829,0
0,0,0,0,0,5356,971,6327,6860,13187,-0.0160234,0.141964,-0.989742,0
0,0,0,0,0,3721,663,4384,6782,11166,0.0146614,0.227947,-0.973563,1
0,0,0,0,0,4791,904,5695,5973,11668,0.0133928,0.230966,-0.97287,1
0,0,0,0,0,5123,928,6051,5703,11754,-0.0645032,0.140036,-0.988043,1
0,0,0,0,0,3421,607,4028,7203,11231,-0.170441,0.446054,-0.878627,1
0,0,0,0,0,4303,800,5103,9761,14864,-0.0643621,0.208489,-0.975905,1
0,0,0,0,0,4293,817,5110,11112,16222,-0.0184394,0.191133,-0.981391,1
0,0,0,0,0,4795,900,5695,7068,12763,-0.0069304,0.125213,-0.992106,1
0,0,0,0,0,4746,861,5607,7022,12629,0.0183229,0.145426,-0.989199,1
0,0,0,0,0,5256,973,6229,7090,13319,0.0302083,0.143575,-0.989178,1
0,0,0,0,0,4742,869,5611,4889,10500,-0.0403494,0.224659,-0.973602,1
0,0,0,0,0,4755,865,5620,11319,16939,-6.16024e-05,0.187644,-0.982237,1
0,0,0,0,0,4948,888,5836,8281,14117,0.000593299,0.115214,-0.993341,1
0,0,0,0,0,3333,605,3938,5933,9871,0.0383018,0.207846,-0.977411,1
0,0,0,0,0,5202,939,6141,7700,13841,-0.00118483,0.236604,-0.971605,1
0,0,0,0,0,5434,1003,6437,8522,14959,-0.0391332,0.204056,-0.978177,1
0,0,0,0,0,3434,615,4049,7202,11251,-0.028488,0.154985,-0.987506,1
0,0,0,0,0,5884,970,6854,8350,15204,-0.00201665,0.249287,-0.968427,1
0,0,0,0,0,3408,617,4025,6191,10216,0.0456655,0.153601,-0.987077,1
0,0,0,0,0,5308,951,6259,5732,11991,0.036052,0.189065,-0.981303,1
0,0,0,0,0,5470,974,6444,8066,14510,0.00811864,0.137113,-0.990522,1
0,0,0,0,0,3690,654,4344,6388,10732,-0.00952806,0.166508,-0.985994,1
0,0,0,0,0,6058,973,7031,6565,13596,-0.000908673,0.178381,-0.983961,1
0,0,0,0,0,4750,858,5608,9271,14879,0.00467461,0.139426,-0.990221,1
0,0,0,0,0,4946,881,5827,5649,11476,0.0114684,0.200287,-0.97967,1
0,0,0,0,0,3353,674,4027,5913,9940,0.0075982,0.212456,-0.977141,1
0,0,0,0,0,5343,860,6203,5413,11616,0.0228671,0.190268,-0.981466,1
0,0,0,0,0,5574,980,6554,7640,14194,0.0489624,0.212044,-0.976033,1
0,0,0,0,0,5093,962,6055,9134,15189,0.0444262,0.198489,-0.979096,1
0,0,0,0,0,3429,683,4112,4608,8720,-0.0288977,0.382482,-0.923511,1
0,0,0,0,0,1820,334,2154,3385,5539,0.0199429,0.253258,-0.967193,1
0,0,0,0,0,4368,885,5253,7565,12818,0.0481553,0.24995,-0.967061,1
0,0,0,0,0,5518,981,6499,9651,16150,0.0699654,0.224878,-0.971872,1
0,0,0,0,0,3737,707,4444,5166,9610,-0.0186794,0.179895,-0.983509,1
0,0,0,0,0,4732,868,5600,9025,14625,0.0253011,0.143169,-0.989375,1
0,0,0,0,0,4299,769,5068,5383,10451,0.0401548,0.239204,-0.970139,1
0,0,0,0,0,4641,812,5453,7475,12928,-0.112359,0.378607,-0.918712,1
0,0,0,0,0,4361,801,5162,10769,15931,-0.0214679,0.132463,-0.990955,1
0,0,0,0,0,2509,461,2970,4048,7018,0.0347985,0.118668,-0.992324,1
0,0,0,0,0,5224,1025,6249,7343,13592,0.00547688,0.242063,-0.970245,1
0,0,0,0,0,5262,962,6224,8103,14327,0.0297693,0.26997,-0.962409,1
0,0,0,0,0,5437,946,6383,7186,13569,0.00516783,0.172172,-0.985053,1
0,0,0,0,0,5297,986,6283,9055,15338,0.0489886,0.231561,-0.971586,1
0,0,0,0,0,5397,970,6367,5931,12298,-0.0159037,0.162105,-0.986645,1
0,0,0,0,0,2265,417,2682,2040,4722,0.0609771,0.161026,-0.985065,1
0,0,0,0,0,5508,955,6463,8269,14732,0.0339941,0.146993,-0.988553,1
0,0,0,0,0,3372,606,3978,3962,7940,0.0131899,0.229506,-0.973218,1
0,0,0,0,0,5371,1048,6419,7458,13877,0.00344649,0.194448,-0.980907,1
0,0,0,0,0,5409,892,6301,11037,17338,0.0328,0.279006,-0.959729,1
0,0,0,0,0,3467,613,4080,5543,9623,0.0300396,0.129656,-0.991104,1
0,0,0,0,0,4794,855,5649,7736,13385,0.0197083,0.286518,-0.957872,1
0,0,0,0,0,4824,886,5710,8094,13804,-0.0148274,0.175321,-0.9844,1
0,0,0,0,0,3338,572,3910,3611,7521,0.0262254,0.190247,-0.981386,1
0,0,0,0,0,5245,900,6145,7104,13249,0.0173062,0.239761,-0.970678,1
0,0,0,0,0,3398,626,4024,6960,10984,0.0339623,0.220464,-0.974804,1
0,0,0,0,0,4241,788,5029,7508,12537,0.00462919,0.112501,-0.993641,1
0,0,0,0,0,5190,944,6134,8049,14183,0.0105362,0.162422,-0.986665,1
0,0,0,0,0,5298,977,6275,6020,12295,0.0494377,0.192418,-0.980067,1
0,0,0,0,0,5175,937,6112,8812,14924,0.0307018,0.226696,-0.973481,1
0,0,0,0,0,5309,994,6303,8939,15242,-0.00414463,0.164377,-0.986389,1
0,0,0,0,0,4368,651,5019,4010,9029,0.00169909,0.261426,-0.965222,1
0,0,0,0,0,2227,412,2639,2525,5164,0.0297478,0.230053,-0.972723,1
0,0,0,0,0,5223,994,6217,6961,13178,0.00426732,0.22451,-0.974462,1
0,0,0,0,0,5194,959,6153,6530,12683,-0.00902252,0.214742,-0.976629,1
0,0,0,0,0,5226,972,6198,10010,16208,0.0304312,0.0993202,-0.99459,1
0,0,0,0,0,5183,944,6127,6205,12332,0.00266544,0.120043,-0.992765,1
0,0,0,0,0,3582,648,4230,7198,11428,0.0284065,0.0912905,-0.995419,1
0,0,0,0,0,5331,1102,6433,10282,16715,0.00553477,-0.0110149,-0.999924,1
0,0,0,0,0,3620,627,4247,5160,9407,0.0290639,0.0711055,-0.997045,1
0,0,0,0,0,5403,1052,6455,7168,13623,0.0418427,0.213389,-0.976071,1
0,0,0,0,0,5212,1135,6347,7947,14294,0.0571493,0.275456,-0.959614,1
0,0,0,0,0,2774,501,3275,3873,7148,0.0353983,0.261862,-0.964456,1
0,0,0,0,0,5248,997,6245,8987,15232,-0.0743775,0.395844,-0.915301,1
0,0,0,0,0,3651,667,4318,6209,10527,0.0377024,0.247068,-0.968264,1
0,0,0,0,0,5455,993,6448,9145,15593,0.0322579,0.22738,-0.973272,1
0,0,0,0,0,5282,975,6257,7029,13286,0.0544365,0.234278,-0.970644,1
0,0,0,0,0,2782,520,3302,2911,6213,0.10243,0.299345,-0.948631,1
0,0,0,0,0,5328,992,6320,4523,10843,0.0353444,0.300434,-0.953148,1
0,0,0,0,0,5333,965,6298,4336,10634,0.0178343,0.272224,-0.962069,1
0,0,0,0,0,2782,527,3309,2909,6218,0.0338968,0.226551,-0.973409,1
0,0,0,0,0,3954,722,4676,3856,8532,0.0272524,0.211545,-0.976988,1
0,0,0,0,0,5271,975,6246,4393,10639,0.0357307,0.27228,-0.961554,1
0,0,0,0,0,6248,1012,7260,5290,12550,0.0132909,0.272179,-0.962155,1
0,0,0,0,0,5248,994,6242,4833,11075,0.0256841,0.272349,-0.961856,1
0,0,0,0,0,5264,1013,6277,4406,10683,0.0291623,0.316869,-0.948021,1
0,0,0,0,0,5264,988,6252,5006,11258,-0.0335539,0.367206,-0.929534,1
0,0,0,0,0,5421,970,6391,5569,11960,0.0132464,0.30349,-0.952743,1
0,0,0,0,0,3553,658,4211,3842,8053,0.0424732,0.337022,-0.940538,1
0,0,0,0,0,5142,954,6096,4803,10899,0.0689233,0.275662,-0.958781,1
0,0,0,0,0,5147,950,6097,4484,10581,0.0127238,0.256031,-0.966585,1
0,0,0,0,0,5022,909,5931,3311,9242,0.0227148,0.248769,-0.968297,1
0,0,0,0,0,5193,925,6118,3249,9367,0.0137362,0.253863,-0.967143,1
0,0,0,0,0,5155,1018,6173,3232,9405,-0.000375683,0.279226,-0.960225,1
0,0,0,0,0,5197,996,6193,3021,9214,-0.0386759,0.228706,-0.972727,1
0,0,0,0,0,5272,909,6181,2747,8928,-0.0606161,0.228116,-0.971745,1
0,0,0,0,0,5334,942,6276,2538,8814,0.00395182,0.288982,-0.957326,1
0,0,0,0,0,5620,978,6598,4172,10770,-0.0215931,0.319386,-0.947379,1
0,0,0,0,0,5556,947,6503,4093,10596,-0.0185578,0.391686,-0.919912,1
0,0,0,0,0,3834,689,4523,3722,8245,0.0878388,0.390127,-0.916562,1
0,0,0,0,0,5715,997,6712,5495,12207,-0.00466911,0.414887,-0.909861,1
0,0,0,0,0,5535,930,6465,5204,11669,-0.0277374,0.454052,-0.890543,1
0,0,0,0,0,3862,662,4524,4827,9351,0.0414686,0.331261,-0.942627,1
0,0,0,0,0,5701,992,6693,6775,13468,0.140413,0.18145,-0.973324,1
0,0,0,0,0,6053,1076,7129,9761,16890,0.196283,-0.111652,-0.97417,1
0,0,0,0,0,3747,604,4351,6245,10596,0.0358665,0.221305,-0.974545,1
0,0,0,0,0,5119,888,6007,12330,18337,0.0383614,0.251496,-0.967098,1
0,0,0,0,0,2966,516,3482,3577,7059,0.0337456,0.263875,-0.963967,1
0,0,0,0,0,4352,755,5107,10420,15527,0.243305,0.0028613,-0.969946,1
0,0,0,0,0,4047,709,4756,6950,11706,0.197945,-0.0301064,-0.979751,1
0,0,0,0,0,10263,1511,11774,11686,23460,-0.00173019,0.367531,-0.93001,1
0,0,0,0,0,2723,478,3201,4113,7314,-0.0391557,0.362274,-0.931249,1
0,0,0,0,0,1718,303,2021,3976,5997,-0.0812549,0.362917,-0.928272,1
0,0,0,0,0,6696,1272,7968,13708,21676,-0.117851,0.632957,-0.765165,1
0,0,0,0,0,3525,592,4117,6181,10298,-0.0709105,0.557227,-0.827327,1
0,0,0,0,0,4345,679,5024,8346,13370,0.161464,0.0982616,-0.981975,1
0,0,0,0,0,5015,867,5882,11570,17452,0.100217,0.183095,-0.977974,1
0,0,0,0,0,3918,669,4587,6957,11544,0.0390658,0.146704,-0.988409,1
0,0,0,0,0,4008,695,4703,5946,10649,0.0928991,0.215685,-0.972034,1
0,0,0,0,0,6631,1120,7751,8164,15915,0.0802738,0.18239,-0.979944,1
0,0,0,0,0,3625,624,4249,5490,9739,0.0327882,0.202062,-0.978824,1
0,0,0,0,0,7427,1260,8687,8125,16812,-0.0707722,0.22724,-0.971264,1
0,0,0,0,0,3828,646,4474,5175,9649,0.0625361,0.126008,-0.990056,1
0,0,0,0,0,4285,727,5012,5570,10582,-0.0427874,0.229841,-0.972287,1
0,0,0,0,0,7032,1190,8222,8482,16704,-0.0937248,0.0908,-0.991449,1
0,0,0,0,0,3606,616,4222,4122,8344,-0.146065,0.328736,-0.933058,1
0,0,0,0,0,6747,1146,7893,7763,15656,-0.0301173,0.244636,-0.969147,1
0,0,0,0,0,6598,1133,7731,6205,13936,-0.0537624,0.107979,-0.992698,1
0,0,0,0,0,3437,651,4088,4334,8422,-0.120086,0.339146,-0.933038,1
0,0,0,0,0,6349,1093,7442,5814,13256,-0.12442,0.215747,-0.96849,1
0,0,0,0,0,6280,1076,7356,5504,12860,-0.110187,0.332987,-0.936471,1
0,0,0,0,0,4146,719,4865,4153,9018,-0.0871881,0.171963,-0.981238,1
0,0,0,0,0,6027,1077,7104,5494,12598,-0.105407,0.378097,-0.919746,1
0,0,0,0,0,5999,1536,7535,3712,11247,-0.0742625,0.318651,-0.944958,1
0,0,0,0,0,5494,914,6408,5045,11453,-0.115851,0.310098,-0.94362,1
0,0,0,0,0,5764,986,6750,4723,11473,-0.114863,0.358975,-0.926252,1
0,0,0,0,0,5633,926,6559,11719,18278,0.130072,-0.57491,-0.807812,1
0,0,0,0,0,3024,514,3538,1650,5188,0.103197,-0.542074,-0.83397,1
0,0,0,0,0,5873,942,6815,3053,9868,0.0563003,-0.488439,-0.87078,1
0,0,0,0,0,5734,905,6639,3462,10101,0.0378624,-0.417342,-0.90796,1
0,0,0,0,0,6312,952,7264,3138,10402,0.0324684,-0.355005,-0.9343,1
0,0,0,0,0,4985,844,5829,2287,8116,0.051166,-0.308659,-0.949795,1
0,0,0,0,0,5555,963,6518,3511,10029,0.0824237,-0.267061,-0.960148,1
0,0,0,0,0,5690,1293,6983,2848,9831,0.0669607,-0.202637,-0.976962,1
0,0,0,0,0,5559,1023,6582,2956,9538,0.0458088,-0.114435,-0.992374,1
0,0,0,0,0,5660,1054,6714,3368,10082,-0.0235905,0.119601,-0.992542,1
0,0,0,0,0,5618,1046,6664,3228,9892,0.0962786,-0.0214612,-0.995123,1
0,0,0,0,0,5020,957,5977,3846,9823,-0.0695084,0.192533,-0.978826,1
0,0,0,0,0,5093,952,6045,3287,9332,-0.0703037,0.266987,-0.961132,1
0,0,0,0,0,5607,1104,6711,3784,10495,-0.0501856,0.262654,-0.963584,1
0,0,0,0,0,5874,1096,6970,2947,9917,-0.0428944,0.268482,-0.962329,1
0,0,0,0,0,5856,1127,6983,2884,9867,-0.0313902,0.242801,-0.969568,1
0,0,0,0,0,6165,1132,7297,2798,10095,-0.0706579,0.240751,-0.968012,1
0,0,0,0,0,6093,1139,7232,2576,9808,-0.0333333,0.273221,-0.961374,1
0,0,0,0,0,5579,1063,6642,2419,9061,-0.0649775,0.213426,-0.974796,1
0,0,0,0,0,6271,1152,7423,2823,10246,-0.0649959,0.236295,-0.969505,1
0,0,0,0,0,6183,1142,7325,3040,10365,-0.0359207,0.217798,-0.975333,1
0,0,0,0,0,5608,1077,6685,2767,9452,-0.0284469,0.11692,-0.992734,1
0,0,0,0,0,5717,1016,6733,2248,8981,-0.0340264,0.118895,-0.992324,1
0,0,0,0,0,6245,1140,7385,3364,10749,-0.0491191,0.125852,-0.990832,1
0,0,0,0,0,6023,1185,7208,4035,11243,-0.0488091,0.0937155,-0.994402,1
0,0,0,0,0,5342,987,6329,3818,10147,-0.0305159,0.120235,-0.992276,1
0,0,0,0,0,5907,1109,7016,4758,11774,-0.0848785,0.29407,-0.952008,1
0,0,0,0,0,5951,1079,7030,5972,13002,-0.0435104,0.203238,-0.978162,1
0,0,0,0,0,6461,1080,7541,5021,12562,-0.0560454,0.104185,-0.992978,1
0,0,0,0,0,2969,564,3533,2065,5598,-0.0572614,0.0954226,-0.993789,1
0,0,0,0,0,5803,1047,6850,6276,13126,-0.0675809,0.318073,-0.945654,1
0,0,0,0,0,5420,1223,6643,6116,12759,-0.0763617,0.214664,-0.973698,1
0,0,0,0,0,3689,702,4391,4825,9216,-0.0501679,0.298854,-0.952979,1
0,0,0,0,0,5358,1055,6413,8015,14428,-0.0882912,0.300259,-0.949763,1
0,0,0,0,0,3876,685,4561,3705,8266,-0.110058,0.408366,-0.906159,1
0,0,0,0,0,2250,418,2668,3142,5810,-0.068593,0.23903,-0.968586,1
0,0,0,0,0,5387,1017,6404,7357,13761,-0.0918187,0.34327,-0.934738,1
0,0,0,0,0,5705,1001,6706,11892,18598,-0.0340591,0.284564,-0.958052,1
0,0,0,0,0,4111,777,4888,6720,11608,-0.00315024,0.460068,-0.887878,1
0,0,0,0,0,5908,1045,6953,8987,15940,-0.101117,0.0735591,-0.992151,1
0,0,0,0,0,5826,962,6788,8283,15071,-0.0735162,0.215342,-0.973767,1
0,0,0,0,0,2172,371,2543,4431,6974,0.00914519,0.277633,-0.960644,1
0,0,0,0,0,1618,301,1919,5266,7185,-0.062356,0.181308,-0.981447,1
0,0,0,0,0,4043,753,4796,13717,18513,-0.0905434,0.0788506,-0.992766,1
0,0,0,0,0,4072,851,4923,9807,14730,-0.154562,0.0433664,-0.987031,1
0,0,0,0,0,3149,551,3700,7864,11564,-0.0449338,-0.191619,-0.98044,1
0,0,0,0,0,5124,954,6078,9039,15117,-0.0643941,-0.0783518,-0.994844,1
0,0,0,0,0,3419,593,4012,5333,9345,-0.0730343,-0.0369475,-0.996645,1
0,0,0,0,0,5581,938,6519,7488,14007,-0.0980321,0.0122736,-0.995108,1
0,0,0,0,0,4021,771,4792,6312,11104,-0.0624138,0.189267,-0.97994,1
0,0,0,0,0,5374,993,6367,10953,17320,-0.085114,0.109216,-0.990367,1
0,0,0,0,0,3695,716,4411,6558,10969,-0.0986587,0.154043,-0.983126,1
0,0,0,0,0,3713,679,4392,7172,11564,-0.105775,0.147475,-0.983394,1
0,0,0,0,0,4920,920,5840,8273,14113,-0.188535,0.279817,-0.941359,1
0,0,0,0,0,3390,621,4011,9383,13394,-0.2879,0.359141,-0.887767,1
0,0,0,0,0,3601,761,4362,5185,9547,-0.183031,0.325934,-0.927506,1
0,0,0,0,0,4659,886,5545,7070,12615,-0.20324,0.348969,-0.91483,1
0,0,0,0,0,4770,897,5667,4793,10460,-0.163891,0.326165,-0.930997,1
0,0,0,0,0,4693,878,5571,4452,10023,-0.110968,0.412065,-0.904372,1
0,0,0,0,0,3487,612,4099,4162,8261,-0.128966,0.330885,-0.934817,1
0,0,0,0,0,5255,937,6192,3848,10040,-0.157843,0.314882,-0.935914,1
0,0,0,0,0,5084,973,6057,3566,9623,-0.117657,0.287761,-0.950447,1
0,0,0,0,0,5292,955,6247,2451,8698,-0.134359,0.383742,-0.913613,1
0,0,0,0,0,5011,849,5860,1734,7594,-0.135749,0.365516,-0.920853,1
0,0,0,0,0,2842,491,3333,1275,4608,-0.14519,0.450465,-0.880909,1
0,0,0,0,0,6120,905,7025,2643,9668,-0.144131,0.522778,-0.840196,1
0,0,0,0,0,5462,925,6387,2766,9153,-0.124093,0.592947,-0.795622,1
0,0,0,0,0,5705,913,6618,2597,9215,-0.103116,0.621523,-0.77658,1
0,0,0,0,0,5901,923,6824,3115,9939,-0.086854,0.658288,-0.747739,1
0,0,0,0,0,6007,949,6956,2800,9756,-0.0529237,0.673239,-0.737528,1
0,0,0,0,0,6087,943,7030,-1000,-1000,-1,-1,-1,1
0,0,0,0,0,5183,661,5844,-1000,-1000,-1,-1,-1,1
0,0,0,0,0,2790,352,3142,-1000,-1000,-1,-1,-1,1
0,0,0,0,0,2245,350,2595,-1000,-1000,-1,-1,-1,1
0,0,0,0,0,5920,923,6843,-1000,-1000,-1,-1,-1,1
0,0,0,0,0,6585,986,7571,7999,15570,-0.00970387,0.324352,-0.945887,1
0,0,0,0,0,4572,818,5390,8987,14377,-0.0441759,0.610911,-0.790466,1
0,0,0,0,0,3254,504,3758,6797,10555,0.00821483,0.209196,-0.977839,1
0,0,0,0,0,6276,1090,7366,11531,18897,-0.017118,0.093419,-0.99548,1
0,0,0,0,0,4460,779,5239,6581,11820,-0.0312933,0.191109,-0.98107,1
0,0,0,0,0,6977,1206,8183,8618,16801,-0.102574,0.393656,-0.913517,1
0,0,0,0,0,4075,631,4706,3802,8508,-7.66185e-05,0.186467,-0.982461,1
0,0,0,0,0,2279,423,2702,2764,5466,-0.0703093,0.375131,-0.924302,1
0,0,0,0,0,4322,752,5074,6187,11261,-0.0230794,0.173251,-0.984607,1
0,0,0,0,0,4202,749,4951,4289,9240,-0.0136914,0.120208,-0.992654,1
0,0,0,0,0,7027,1185,8212,6326,14538,-0.00940094,0.0592598,-0.998198,1
0,0,0,0,0,5762,1003,6765,4812,11577,-0.0364358,0.196751,-0.979776,1
0,0,0,0,0,4132,711,4843,4278,9121,-0.0489438,0.29206,-0.955147,1
0,0,0,0,0,5824,988,6812,5793,12605,-0.0426946,0.314895,-0.948166,1
0,0,0,0,0,5661,973,6634,5699,12333,-0.0477642,0.275245,-0.960187,1
0,0,0,0,0,4152,706,4858,3728,8586,-0.0326704,0.310859,-0.949894,1
0,0,0,0,0,6770,1307,8077,5774,13851,-0.0565512,0.348647,-0.935547,1
0,0,0,0,0,6189,768,6957,2897,9854,-0.0371595,0.304232,-0.951873,1
0,0,0,0,0,2695,454,3149,1918,5067,-0.0678512,0.283681,-0.956515,1
0,0,0,0,0,2541,546,3087,2053,5140,-0.0961847,0.37135,-0.923498,1
0,0,0,0,0,5477,970,6447,3548,9995,-0.0924224,0.356279,-0.929797,1
0,0,0,0,0,5369,1002,6371,3480,9851,-0.119129,0.374876,-0.919389,1
0,0,0,0,0,5329,985,6314,5233,11547,-0.104635,0.413348,-0.904541,1
0,0,0,0,0,5986,1012,6998,10741,17739,-0.0984241,0.446795,-0.889206,1
0,0,0,0,0,3082,500,3582,5145,8727,0.12413,-0.546724,-0.828061,1
0,0,0,0,0,5093,819,5912,2991,8903,0.148563,-0.555011,-0.81847,1
0,0,0,0,0,5790,890,6680,2914,9594,0.156004,-0.536091,-0.82962,1
0,0,0,0,0,5678,894,6572,3480,10052,0.148493,-0.510639,-0.846875,1
0,0,0,0,0,5666,900,6566,3211,9777,0.124883,-0.519438,-0.845333,1
0,0,0,0,0,5757,904,6661,2625,9286,0.113667,-0.517197,-0.848285,1
0,0,0,0,0,5724,926,6650,2603,9253,0.10386,-0.504451,-0.857171,1
0,0,0,0,0,5785,908,6693,2357,9050,0.0837457,-0.479632,-0.873464,1
0,0,0,0,0,5726,965,6691,2518,9209,0.0585552,-0.46968,-0.880893,1
0,0,0,0,0,5365,879,6244,2835,9079,0.0381334,-0.429095,-0.902454,1
0,0,0,0,0,5628,926,6554,3363,9917,0.0577382,-0.442071,-0.89512,1
0,0,0,0,0,5337,847,6184,2997,9181,-0.0402422,-0.467846,-0.882894,1
0,0,0,0,0,5085,872,5957,2685,8642,-0.0758859,-0.483195,-0.872218,1
0,0,0,0,0,5798,1037,6835,4349,11184,-0.0900496,-0.442727,-0.892123,1
0,0,0,0,0,5777,1071,6848,3810,10658,-0.0874272,-0.38592,-0.91838,1
0,0,0,0,0,5767,1049,6816,3350,10166,-0.0886849,-0.368181,-0.925515,1
0,0,0,0,0,5794,1087,6881,3940,10821,-0.14011,-0.349799,-0.926288,1
0,0,0,0,0,5941,1080,7021,4687,11708,-0.16416,-0.31397,-0.935133,1
0,0,0,0,0,5311,1027,6338,4047,10385,-0.187638,-0.249143,-0.950116,1
0,0,0,0,0,5218,969,6187,4556,10743,-0.269942,0.313815,-0.910303,1
0,0,0,0,0,5971,1113,7084,4209,11293,-0.283486,0.432814,-0.85575,1
0,0,0,0,0,5890,1137,7027,4304,11331,-0.284755,0.519339,-0.80573,1
0,0,0,0,0,5974,1130,7104,7398,14502,-0.294403,0.562438,-0.772652,1
0,0,0,0,0,5413,1014,6427,7152,13579,-0.263352,0.603786,-0.752388,1
0,0,0,0,0,3012,549,3561,3690,7251,-0.261715,0.611712,-0.746535,1
0,0,0,0,0,5833,1239,7072,6284,13356,-0.230686,0.601218,-0.765062,1
0,0,0,0,0,5550,998,6548,4655,11203,-0.264661,0.575952,-0.773456,1
0,0,0,0,0,5493,1010,6503,5615,12118,-0.264657,0.54829,-0.793307,1
0,0,0,0,0,5116,968,6084,3869,9953,-0.267361,0.537098,-0.800027,1
0,0,0,0,0,5075,937,6012,4129,10141,-0.236443,0.517672,-0.822259,1
0,0,0,0,0,6310,1189,7499,4924,12423,-0.217072,0.536649,-0.815406,1
0,0,0,0,0,4273,762,5035,2927,7962,-0.235975,0.50471,-0.830412,1
0,0,0,0,0,6104,1115,7219,4789,12008,-0.218552,0.522877,-0.823914,1
0,0,0,0,0,6257,1023,7280,4086,11366,-0.270643,0.496036,-0.825046,1
0,0,0,0,0,3882,719,4601,3219,7820,-0.24591,0.518395,-0.819021,1
0,0,0,0,0,5563,1023,6586,3636,10222,-0.18141,0.559533,-0.808711,1
0,0,0,0,0,5496,1021,6517,4273,10790,-0.105925,0.538705,-0.835809,1
0,0,0,0,0,5506,1021,6527,3818,10345,-0.107752,0.55361,-0.825776,1
0,0,0,0,0,3933,713,4646,3493,8139,-0.0668131,0.579258,-0.812401,1
0,0,0,0,0,6106,1104,7210,4167,11377,-0.051449,0.579955,-0.813022,1
0,0,0,0,0,6022,995,7017,4863,11880,-0.137563,0.614102,-0.777145,1
0,0,0,0,0,5454,995,6449,4291,10740,-0.168616,0.601162,-0.781136,1
0,0,0,0,0,3046,566,3612,2056,5668,-0.161628,0.604412,-0.780104,1
0,0,0,0,0,5898,994,6892,4403,11295,-0.167012,0.600055,-0.782331,1
0,0,0,0,0,5442,1035,6477,3671,10148,-0.164272,0.585864,-0.793586,1
0,0,0,0,0,5628,1034,6662,4861,11523,-0.160143,0.575499,-0.80197,1
0,0,0,0,0,5428,1015,6443,5023,11466,-0.162514,0.569962,-0.805439,1
0,0,0,0,0,5409,1059,6468,3052,9520,-0.151859,0.564403,-0.811411,1
0,0,0,0,0,5929,1029,6958,3601,10559,-0.131407,0.567819,-0.812597,1
0,0,0,0,0,3856,704,4560,2854,7414,-0.145863,0.565576,-0.811694,1
0,0,0,0,0,5577,1034,6611,4739,11350,-0.167878,0.516641,-0.839583,1
0,0,0,0,0,5395,1006,6401,4698,11099,-0.17138,0.536676,-0.826201,1
0,0,0,0,0,6171,1125,7296,3848,11144,-0.142425,0.537245,-0.831314,1
0,0,0,0,0,5458,995,6453,3840,10293,-0.142088,0.527885,-0.837346,1
0,0,0,0,0,5550,1007,6557,3500,10057,-0.13322,0.546366,-0.826884,1
0,0,0,0,0,6896,1152,8048,3559,11607,-0.145665,0.552963,-0.820374,1
0,0,0,0,0,5744,1050,6794,3276,10070,-0.157571,0.557979,-0.814758,1
0,0,0,0,0,3971,766,4737,2770,7507,-0.173356,0.581557,-0.79482,1
0,0,0,0,0,6046,1112,7158,5060,12218,-0.164666,0.579437,-0.798209,1
0,0,0,0,0,6123,1105,7228,4261,11489,-0.169677,0.597606,-0.78363,1
0,0,0,0,0,6197,1218,7415,5484,12899,-0.174404,0.541645,-0.822316,1
0,0,0,0,0,4187,771,4958,2468,7426,-0.165864,0.555386,-0.814883,1
0,0,0,0,0,6181,1141,7322,3507,10829,-0.104496,0.579011,-0.808595,1
0,0,0,0,0,5548,1039,6587,5201,11788,-0.134209,0.562365,-0.815925,1
0,0,0,0,0,5978,1001,6979,3435,10414,-0.129424,0.554364,-0.822149,1
0,0,0,0,0,5530,996,6526,4021,10547,-0.159383,0.552875,-0.817879,1
0,0,0,0,0,5537,1027,6564,3375,9939,-0.188123,0.543511,-0.81805,1
0,0,0,0,0,5522,1009,6531,2862,9393,-0.21865,0.526072,-0.821852,1
0,0,0,0,0,6228,1137,7365,4873,12238,-0.217709,0.525228,-0.822641,1
0,0,0,0,0,6249,1101,7350,3196,10546,-0.22166,0.5419,-0.810686,1
0,0,0,0,0,6572,1118,7690,4362,12052,-0.21678,0.585108,-0.781444,1
0,0,0,0,0,5732,1017,6749,3593,10342,-0.230635,0.562202,-0.794189,1
0,0,0,0,0,4334,709,5043,3573,8616,-0.232808,0.586922,-0.77545,1
0,0,0,0,0,6302,1118,7420,7274,14694,-0.258557,0.591773,-0.763514,1
0,0,0,0,0,4434,777,5211,3997,9208,-0.0920698,0.538542,-0.837554,1
0,0,0,0,0,4254,762,5016,2772,7788,-0.12219,0.556497,-0.821815,1
0,0,0,0,0,5490,1010,6500,3403,9903,-0.122909,0.563856,-0.816676,1
0,0,0,0,0,5538,995,6533,3848,10381,-0.135611,0.535521,-0.833563,1
0,0,0,0,0,5461,1022,6483,3286,9769,-0.156213,0.576208,-0.802235,1
0,0,0,0,0,6122,1069,7191,3132,10323,-0.190553,0.572486,-0.797465,1
0,0,0,0,0,7141,1115,8256,5272,13528,-0.183047,0.569518,-0.801338,1
0,0,0,0,0,3552,596,4148,2230,6378,-0.16606,0.584886,-0.793935,2
0,0,0,0,0,2188,396,2584,1453,4037,-0.223509,0.565898,-0.793601,2
0,0,0,0,0,5534,1004,6538,4054,10592,-0.221118,0.567866,-0.792865,2
0,0,0,0,0,5461,1076,6537,4697,11234,-0.213595,0.576837,-0.788439,2
0,0,0,0,0,6199,1152,7351,5069,12420,-0.166891,0.548844,-0.819095,2
0,0,0,0,0,4213,782,4995,2540,7535,-0.168007,0.550749,-0.817588,2
0,0,0,0,0,2607,485,3092,1724,4816,-0.213166,0.56713,-0.795565,2
0,0,0,0,0,6261,1140,7401,4146,11547,-0.226039,0.584222,-0.779481,2
0,0,0,0,0,6362,1102,7464,5073,12537,-0.197657,0.551993,-0.810083,2
0,0,0,0,0,4481,760,5241,1651,6892,-0.21432,0.566592,-0.795639,2
0,0,0,0,0,2598,469,3067,1575,4642,-0.203198,0.55058,-0.809674,2
0,0,0,0,0,3406,619,4025,2409,6434,-0.213643,0.534125,-0.817966,2
0,0,0,0,0,6209,1114,7323,4320,11643,-0.230889,0.533488,-0.813684,2
0,0,0,0,0,6418,1047,7465,4236,11701,-0.222077,0.531007,-0.817749,2
0,0,0,0,0,4420,916,5336,3535,8871,-0.204785,0.509235,-0.835908,2
0,0,0,0,0,6221,1132,7353,3744,11097,-0.205525,0.483618,-0.850807,2
0,0,0,0,0,6751,1127,7878,3814,11692,-0.214581,0.499678,-0.839212,2
0,0,0,0,0,6436,1142,7578,2671,10249,-0.254177,0.50805,-0.82297,2
0,0,0,0,0,4279,760,5039,3688,8727,-0.28898,0.4975,-0.817915,2
0,0,0,0,0,5985,1263,7248,5266,12514,-0.272456,0.509054,-0.816475,2
0,0,0,0,0,6077,1118,7195,3872,11067,-0.254623,0.529475,-0.809212,2
0,0,0,0,0,5490,956,6446,3626,10072,-0.217951,0.52192,-0.82468,2
0,0,0,0,0,6203,1100,7303,4071,11374,-0.212565,0.529377,-0.821326,2
0,0,0,0,0,5837,1001,6838,3422,10260,-0.237625,0.522348,-0.818955,2
0,0,0,0,0,3904,704,4608,3014,7622,-0.264215,0.538761,-0.799954,2
0,0,0,0,0,6090,1162,7252,5080,12332,-0.251857,0.558334,-0.790462,2
0,0,0,0,0,5481,1034,6515,4759,11274,-0.233861,0.560588,-0.794387,2
0,0,0,0,0,4985,899,5884,3066,8950,-0.223386,0.548513,-0.805749,2
0,0,0,0,0,6260,1115,7375,4807,12182,-0.19343,0.538029,-0.820433,2
0,0,0,0,0,4220,849,5069,3276,8345,-0.173844,0.537388,-0.825222,2
0,0,0,0,0,5599,992,6591,3500,10091,-0.187372,0.555526,-0.810113,2
0,0,0,0,0,6482,1185,7667,4947,12614,-0.224175,0.567976,-0.791927,2
0,0,0,0,0,5469,1004,6473,4264,10737,-0.21758,0.544524,-0.810032,2
0,0,0,0,0,6112,1115,7227,4321,11548,-0.176839,0.557873,-0.810867,2
0,0,0,0,0,5644,990,6634,4357,10991,-0.190088,0.568195,-0.800638,2
0,0,0,0,0,4276,734,5010,2331,7341,-0.104025,0.551706,-0.827526,2
0,0,0,0,0,5737,1134,6871,3426,10297,-0.0941653,0.54361,-0.834039,2
0,0,0,0,0,5476,1045,6521,3191,9712,-0.0872017,0.551678,-0.829486,2
0,0,0,0,0,5634,1018,6652,3622,10274,-0.0643485,0.560382,-0.825731,2
0,0,0,0,0,6790,1179,7969,4102,12071,-0.107857,0.55576,-0.824316,2
0,0,0,0,0,6267,1134,7401,2349,9750,-0.124208,0.55401,-0.823192,2
0,0,0,0,0,3230,600,3830,2567,6397,-0.0880271,0.593057,-0.800334,2
0,0,0,0,0,6217,1135,7352,4643,11995,-0.213969,0.577788,-0.787641,2
0,0,0,0,0,5552,1115,6667,3834,10501,-0.194349,0.570367,-0.798067,2
0,0,0,0,0,5614,991,6605,3805,10410,-0.170588,0.594782,-0.785579,2
0,0,0,0,0,6245,1257,7502,4165,11667,-0.143596,0.620953,-0.770583,2
0,0,0,0,0,4273,781,5054,3219,8273,-0.122315,0.630955,-0.766116,2
0,0,0,0,0,6316,1125,7441,4116,11557,-0.135352,0.645574,-0.751607,2
0,0,0,0,0,5539,1004,6543,3873,10416,-0.158552,0.650499,-0.742774,2
0,0,0,0,0,5118,894,6012,2729,8741,-0.159044,0.664685,-0.729999,2
0,0,0,0,0,6370,1087,7457,4355,11812,-0.121407,0.673497,-0.729152,2
0,0,0,0,0,6858,1284,8142,3448,11590,-0.122707,0.675487,-0.72709,2
0,0,0,0,0,6289,1107,7396,-1000,-1000,-1,-1,-1,2
0,0,0,0,0,3640,541,4181,1382,5563,0.00320137,0.0660893,-0.997809,2
0,0,0,0,0,6219,1033,7252,2449,9701,-0.0487398,0.118813,-0.99172,2
0,0,0,0,0,5865,995,6860,2043,8903,-0.0334466,0.153163,-0.987635,2
0,0,0,0,0,6434,1138,7572,2350,9922,-0.0489784,0.104734,-0.993293,2
0,0,0,0,0,6720,1138,7858,2407,10265,-0.0598964,0.145815,-0.987497,2
0,0,0,0,0,6678,1166,7844,2436,10280,-0.07321,0.167186,-0.983204,2
0,0,0,0,0,6585,1184,7769,2727,10496,-0.042323,0.131783,-0.990375,2
0,0,0,0,0,6490,1144,7634,2436,10070,-0.0701113,0.133387,-0.988581,2
0,0,0,0,0,6507,1167,7674,2582,10256,-0.0772147,0.169036,-0.982581,2
0,0,0,0,0,6545,1156,7701,2473,10174,-0.0623929,0.152942,-0.986264,2
0,0,0,0,0,4630,771,5401,2110,7511,-0.0860361,0.207829,-0.974374,2
0,0,0,0,0,5599,1032,6631,2240,8871,-0.0795229,0.204231,-0.975687,2
0,0,0,0,0,6507,1142,7649,2635,10284,-0.0777769,0.192213,-0.978266,2
0,0,0,0,0,6327,1095,7422,2986,10408,-0.0678537,0.230969,-0.970592,2
0,0,0,0,0,4153,904,5057,2440,7497,-0.0780786,0.160983,-0.983864,2
0,0,0,0,0,5968,1094,7062,3710,10772,-0.0807274,0.194761,-0.977523,2
0,0,0,0,0,6192,1063,7255,3941,11196,-0.0568612,0.259095,-0.964177,2
0,0,0,0,0,5748,1020,6768,3312,10080,-0.106771,0.264646,-0.958417,2
0,0,0,0,0,2919,532,3451,2533,5984,-0.0655802,0.262585,-0.962678,2
0,0,0,0,0,7821,1086,8907,4972,13879,-0.0876632,0.371973,-0.924095,2
0,0,0,0,0,5675,1048,6723,6181,12904,-0.057257,0.283859,-0.957155,2
0,0,0,0,0,3820,708,4528,3497,8025,-0.0937592,0.301815,-0.948745,2
0,0,0,0,0,3804,715,4519,5021,9540,-0.0886857,0.295763,-0.951136,2
0,0,0,0,0,2933,571,3504,3422,6926,-0.0732099,0.234004,-0.969475,2
0,0,0,0,0,5560,1495,7055,8316,15371,-0.105878,0.516855,-0.849501,2
0,0,0,0,0,3853,697,4550,5125,9675,-0.116095,0.357734,-0.926579,2
0,0,0,0,0,5583,1049,6632,8254,14886,-0.08562,0.309233,-0.947124,2
0,0,0,0,0,3860,682,4542,6167,10709,-0.0763304,0.264775,-0.961284,2
0,0,0,0,0,3505,654,4159,8062,12221,-0.178848,0.316179,-0.931689,2
0,0,0,0,0,4516,826,5342,9653,14995,-0.0888811,0.585016,-0.806137,2
0,0,0,0,0,3258,613,3871,6755,10626,0.0206711,0.334029,-0.942336,2
0,0,0,0,0,5504,1048,6552,9193,15745,0.000773712,0.348802,-0.937196,2
0,0,0,0,0,3845,689,4534,6928,11462,-0.0566223,0.311076,-0.948697,2
0,0,0,0,0,3045,567,3612,6941,10553,-0.123518,0.334416,-0.934296,2
0,0,0,0,0,4470,830,5300,9224,14524,-0.144052,0.377926,-0.914561,2
0,0,0,0,0,4562,815,5377,6099,11476,-0.0977021,0.379597,-0.919978,2
0,0,0,0,0,4652,857,5509,7958,13467,-0.103224,0.38112,-0.918745,2
0,0,0,0,0,4477,814,5291,6806,12097,-0.140822,0.335032,-0.931624,2
0,0,0,0,0,5389,1032,6421,8411,14832,-0.11532,0.397855,-0.910172,2
0,0,0,0,0,3763,683,4446,6633,11079,-0.128693,0.391482,-0.911142,2
0,0,0,0,0,5435,1030,6465,7875,14340,-0.162962,0.557103,-0.814297,2
0,0,0,0,0,3701,744,4445,4506,8951,-0.0681698,0.475161,-0.877254,2
0,0,0,0,0,5210,1036,6246,6331,12577,-0.0710502,0.435693,-0.897287,2
0,0,0,0,0,5189,1053,6242,4763,11005,-0.0907737,0.434158,-0.896252,2
0,0,0,0,0,5152,979,6131,4154,10285,-0.105559,0.438592,-0.892465,2
0,0,0,0,0,5303,973,6276,3396,9672,-0.149545,0.411211,-0.89919,2
0,0,0,0,0,3685,666,4351,2454,6805,-0.143496,0.427465,-0.892571,2
0,0,0,0,0,5435,957,6392,2591,8983,-0.109902,0.402409,-0.908839,2
0,0,0,0,0,5607,974,6581,2503,9084,-0.0939648,0.417297,-0.903899,2
0,0,0,0,0,5366,972,6338,3001,9339,-0.0875663,0.415317,-0.905453,2
0,0,0,0,0,5365,980,6345,2489,8834,-0.0589191,0.437344,-0.897362,2
0,0,0,0,0,6212,951,7163,3547,10710,0.015667,0.392069,-0.919803,2
0,0,0,0,0,5294,932,6226,4526,10752,0.047079,0.373713,-0.926349,2
0,0,0,0,0,5527,906,6433,5629,12062,-0.0029795,0.402251,-0.915525,2
0,0,0,0,0,5265,973,6238,7131,13369,0.00821542,0.368377,-0.92964,2
0,0,0,0,0,5299,943,6242,7822,14064,0.0606309,0.288991,-0.95541,2
0,0,0,0,0,3739,663,4402,8790,13192,-0.0714696,0.387822,-0.918959,2
0,0,0,0,0,5037,882,5919,9445,15364,0.188694,0.214032,-0.958428,2
0,0,0,0,0,3814,678,4492,8483,12975,0.18148,0.157678,-0.970671,2
0,0,0,0,0,5040,873,5913,11508,17421,0.201735,0.159718,-0.96633,2
0,0,0,0,0,3794,666,4460,10327,14787,0.114477,0.311397,-0.943359,2
0,0,0,0,0,4662,794,5456,12151,17607,-0.0743751,0.259549,-0.962862,2
0,0,0,0,0,7139,1279,8418,8014,16432,-0.11755,0.465039,-0.877451,2
0,0,0,0,0,3759,616,4375,4984,9359,-0.147767,0.485039,-0.861918,2
0,0,0,0,0,5354,749,6103,4419,10522,-0.0481338,0.239398,-0.969728,2
0,0,0,0,0,2733,478,3211,3131,6342,-0.0855365,0.47934,-0.873451,2
0,0,0,0,0,6706,1154,7860,7884,15744,-0.140051,0.41428,-0.899309,2
0,0,0,0,0,6709,1128,7837,6223,14060,-0.0768899,0.315969,-0.945649,2
0,0,0,0,0,3497,591,4088,4884,8972,-0.0533545,0.50163,-0.863436,2
0,0,0,0,0,6843,1219,8062,6707,14769,-0.118948,0.397196,-0.909993,2
0,0,0,0,0,4685,783,5468,5803,11271,-0.132046,0.491407,-0.860862,2
0,0,0,0,0,4724,828,5552,4125,9677,-0.140307,0.45328,-0.880256,2
0,0,0,0,0,5888,1015,6903,4065,10968,-0.059075,0.376816,-0.924402,2
0,0,0,0,0,6648,1174,7822,6216,14038,-0.120992,0.437774,-0.890907,2
0,0,0,0,0,6507,1129,7636,5855,13491,-0.148074,0.536364,-0.830896,2
0,0,0,0,0,6499,1121,7620,4020,11640,-0.137799,0.518689,-0.843785,2
0,0,0,0,0,2753,459,3212,1870,5082,-0.161111,0.550575,-0.819091,2
0,0,0,0,0,1952,350,2302,1674,3976,-0.0924547,0.430757,-0.89772,2
0,0,0,0,0,5159,925,6084,4420,10504,-0.114009,0.396601,-0.910884,2
0,0,0,0,0,6498,1081,7579,5079,12658,-0.0924242,0.392486,-0.915102,2
0,0,0,0,0,4479,779,5258,2496,7754,-0.091423,0.438331,-0.894152,2
0,0,0,0,0,6059,982,7041,4051,11092,-0.0964962,0.424896,-0.900084,2
0,0,0,0,0,6179,1138,7317,3070,10387,-0.0797095,0.406854,-0.910009,2
0,0,0,0,0,5723,938,6661,3756,10417,-0.10287,0.427679,-0.898058,2
0,0,0,0,0,5584,938,6522,8783,15305,0.114476,-0.31968,-0.940585,2
0,0,0,0,0,2516,410,2926,1240,4166,0.0952767,-0.274025,-0.956992,2
0,0,0,0,0,6195,1068,7263,3183,10446,0.0673891,-0.176309,-0.982025,2
0,0,0,0,0,6105,1070,7175,2765,9940,-0.0127847,-0.155144,-0.987809,2
0,0,0,0,0,6201,1104,7305,3438,10743,-0.0617291,-0.130225,-0.989561,2
0,0,0,0,0,5512,994,6506,5296,11802,-0.0965556,-0.106561,-0.989607,2
0,0,0,0,0,3802,716,4518,4197,8715,-0.242581,-0.239053,-0.940217,2
0,0,0,0,0,5852,1111,6963,6212,13175,-0.319668,-0.252318,-0.913317,2
0,0,0,0,0,4033,756,4789,7740,12529,-0.401088,-0.331998,-0.85376,2
0,0,0,0,0,5803,1108,6911,12666,19577,-0.426425,-0.352978,-0.832808,2
0,0,0,0,0,2054,397,2451,5771,8222,-0.439042,-0.224255,-0.87003,2
0,0,0,0,0,3279,606,3885,8727,12612,-0.449988,-0.0481187,-0.891737,2
0,0,0,0,0,6009,1079,7088,10822,17910,-0.436842,0.204006,-0.8761,2
0,0,0,0,0,3919,692,4611,2948,7559,-0.0706448,0.355751,-0.931907,2
0,0,0,0,0,6533,1466,7999,2427,10426,-0.0768844,0.374012,-0.924232,2
0,0,0,0,0,6481,1161,7642,2071,9713,-0.116654,0.396681,-0.910514,2
0,0,0,0,0,4571,791,5362,2155,7517,-0.0983701,0.327226,-0.939812,2
0,0,0,0,0,6816,1097,7913,2524,10437,-0.084611,0.411574,-0.90744,2
0,0,0,0,0,6087,1070,7157,2964,10121,-0.0344308,0.334218,-0.941867,2
0,0,0,0,0,6939,1193,8132,3972,12104,-0.100893,0.457855,-0.883283,2
0,0,0,0,0,6737,1203,7940,2559,10499,-0.102011,0.397454,-0.911934,2
0,0,0,0,0,2987,490,3477,1511,4988,-0.0757059,0.246677,-0.966136,2
0,0,0,0,0,2856,500,3356,1812,5168,-0.0383755,0.248647,-0.967834,2
0,0,0,0,0,6466,1102,7568,5124,12692,-0.102951,0.412674,-0.905042,2
0,0,0,0,0,4297,603,4900,2537,7437,-0.112327,0.429354,-0.896124,2
0,0,0,0,0,2343,400,2743,1733,4476,-0.103919,0.392889,-0.913695,2
0,0,0,0,0,5695,1025,6720,4654,11374,-0.101489,0.313851,-0.944033,2
0,0,0,0,0,5722,1277,6999,5104,12103,-0.104422,0.429666,-0.89693,2
0,0,0,0,0,3928,716,4644,5300,9944,-0.0842621,0.207114,-0.974681,2
0,0,0,0,0,6444,1131,7575,6511,14086,-0.0877017,0.258254,-0.962088,2
0,0,0,0,0,3750,661,4411,6084,10495,0.00506891,0.348747,-0.937203,2
0,0,0,0,0,5715,1091,6806,9461,16267,-0.0962965,0.17787,-0.979331,2
0,0,0,0,0,3612,647,4259,5338,9597,-0.124986,0.368608,-0.921144,2
0,0,0,0,0,5730,1015,6745,9770,16515,0.00339541,0.55206,-0.833798,2
0,0,0,0,0,4216,660,4876,9468,14344,0.0862375,0.466457,-0.88033,2
0,0,0,0,0,5074,936,6010,10233,16243,0.00897591,0.410863,-0.911653,2
0,0,0,0,0,5662,1000,6662,8816,15478,0.000559377,0.339341,-0.940663,2
0,0,0,0,0,3594,636,4230,9906,14136,0.00330358,0.511532,-0.859258,2
0,0,0,0,0,3278,619,3897,12702,16599,0.226358,-0.22704,-0.947214,2
0,0,0,0,0,4007,663,4670,8125,12795,0.0928977,0.303222,-0.948381,2
0,0,0,0,0,4987,908,5895,8056,13951,0.00393206,0.419563,-0.907718,2
0,0,0,0,0,3481,637,4118,6852,10970,0.0190667,0.537864,-0.842816,2
0,0,0,0,0,4895,914,5809,8705,14514,0.0888097,0.516784,-0.851497,2
0,0,0,0,0,3478,687,4165,6436,10601,0.0550771,0.426728,-0.902702,2
0,0,0,0,0,5390,1051,6441,6302,12743,0.0712134,0.448986,-0.890697,2
0,0,0,0,0,5391,1065,6456,6196,12652,0.0325005,0.489898,-0.871173,2
0,0,0,0,0,2862,544,3406,4697,8103,0.0164913,0.4809,-0.87662,2
0,0,0,0,0,5528,1025,6553,6443,12996,0.0743583,0.56096,-0.824497,2
0,0,0,0,0,5533,1132,6665,7651,14316,0.00900733,0.545809,-0.837861,2
0,0,0,0,0,2917,555,3472,3941,7413,-0.00384035,0.501553,-0.865118,2
0,0,0,0,0,5208,940,6148,4997,11145,-0.0458818,0.531741,-0.845663,2
0,0,0,0,0,5626,1019,6645,4726,11371,-0.0462422,0.600625,-0.798192,2
0,0,0,0,0,5541,1008,6549,5043,11592,-0.129181,0.45525,-0.880942,2
0,0,0,0,0,5473,937,6410,2519,8929,-0.0895993,0.486678,-0.868974,2
0,0,0,0,0,5327,946,6273,2828,9101,-0.106309,0.562459,-0.819962,2
0,0,0,0,0,5201,888,6089,5147,11236,-0.0771004,0.572764,-0.816086,2
0,0,0,0,0,7923,1318,9241,6230,15471,-0.109747,0.643725,-0.757346,2
0,0,0,0,0,4824,752,5576,2616,8192,-0.0691862,0.615686,-0.784948,2
0,0,0,0,0,5317,864,6181,5478,11659,-0.146982,0.677152,-0.721014,2
0,0,0,0,0,5525,853,6378,-1000,-1000,-1,-1,-1,2
0,0,0,0,0,5116,794,5910,-1000,-1000,-1,-1,-1,2
0,0,0,0,0,2975,485,3460,5173,8633,-0.0761515,0.362787,-0.928755,2
0,0,0,0,0,6425,1177,7602,14024,21626,-0.184416,0.12509,-0.974855,2
0,0,0,0,0,3478,599,4077,6465,10542,-0.160567,0.600071,-0.783666,2
0,0,0,0,0,3072,525,3597,5159,8756,-0.125759,0.639656,-0.758304,2
0,0,0,0,0,6653,1132,7785,10469,18254,-0.119603,0.679232,-0.724112,2
0,0,0,0,0,3347,553,3900,6272,10172,-0.0922431,0.536636,-0.838757,2
0,0,0,0,0,4965,854,5819,10712,16531,0.097172,0.207742,-0.973345,2
0,0,0,0,0,3792,649,4441,8727,13168,-0.118532,0.596338,-0.793934,2
0,0,0,0,0,3837,664,4501,6014,10515,-0.0968314,0.516705,-0.85067,2
0,0,0,0,0,7511,1213,8724,12786,21510,-0.0675032,0.213142,-0.974687,2
0,0,0,0,0,4399,644,5043,6016,11059,0.0421672,0.444071,-0.894999,2
0,0,0,0,0,1981,336,2317,3873,6190,0.0308223,0.454083,-0.890426,2
0,0,0,0,0,1693,291,1984,3467,5451,-0.0135153,0.322687,-0.946409,2
0,0,0,0,0,3632,638,4270,9188,13458,-0.0275268,0.480606,-0.876505,2
0,0,0,0,0,6989,1205,8194,14173,22367,-0.100341,0.6203,-0.77792,2
0,0,0,0,0,4125,631,4756,4993,9749,-0.0121418,0.381079,-0.924463,2
0,0,0,0,0,4380,755,5135,7451,12586,-0.0771417,0.555276,-0.828081,2
0,0,0,0,0,5476,934,6410,7668,14078,-0.0598083,0.432364,-0.899714,2
0,0,0,0,0,3862,676,4538,4540,9078,-0.0574871,0.391088,-0.918556,2
0,0,0,0,0,6469,1138,7607,6594,14201,-0.038294,0.482749,-0.874921,2
0,0,0,0,0,6464,1138,7602,4561,12163,-0.0807731,0.486539,-0.869917,2
0,0,0,0,0,5720,986,6706,5270,11976,-0.0451217,0.55221,-0.832483,2
0,0,0,0,0,5719,1006,6725,4388,11113,-0.0411477,0.479994,-0.876306,2
0,0,0,0,0,6178,1130,7308,4034,11342,-0.035624,0.544692,-0.837879,2
0,0,0,0,0,6147,1004,7151,11065,18216,0.0658368,-0.339311,-0.938367,2
0,0,0,0,0,3210,526,3736,1476,5212,0.052542,-0.290786,-0.955344,2
0,0,0,0,0,7119,930,8049,3036,11085,-0.0149335,-0.235078,-0.971862,2
0,0,0,0,0,6310,1087,7397,2896,10293,-0.0562415,-0.159123,-0.985656,2
0,0,0,0,0,6261,1095,7356,6039,13395,-0.0784008,0.129465,-0.98848,2
0,0,0,0,0,4397,789,5186,2711,7897,-0.0799376,0.38514,-0.919389,2
0,0,0,0,0,6445,1289,7734,2848,10582,-0.0777435,0.349678,-0.933639,2
0,0,0,0,0,6218,1166,7384,2667,10051,-0.0438428,0.357261,-0.932975,2
0,0,0,0,0,4362,792,5154,1845,6999,-0.0204261,0.363711,-0.931288,2
0,0,0,0,0,6438,1210,7648,2583,10231,-0.035328,0.364994,-0.930339,2
0,0,0,0,0,6627,1165,7792,2720,10512,-0.044594,0.324231,-0.944926,2
0,0,0,0,0,4530,810,5340,2054,7394,-0.100805,0.389386,-0.915542,2
0,0,0,0,0,6647,1303,7950,4192,12142,-0.0702292,0.372937,-0.925195,2
0,0,0,0,0,4970,830,5800,1632,7432,-0.0353383,0.280436,-0.959222,2
0,0,0,0,0,6975,1659,8634,3485,12119,-0.0608332,0.438273,-0.896781,2
0,0,0,0,0,4722,851,5573,3156,8729,-0.0690909,0.350092,-0.934164,2
0,0,0,0,0,6934,1073,8007,5316,13323,-0.129446,0.390443,-0.911481,2
0,0,0,0,0,4071,753,4824,4590,9414,-0.0924378,0.430176,-0.898,2
0,0,0,0,0,6257,1117,7374,6234,13608,-0.0660177,0.35917,-0.930934,2
0,0,0,0,0,4267,765,5032,5476,10508,-0.094905,0.382646,-0.919008,2
0,0,0,0,0,5957,1131,7088,7638,14726,-0.0694493,0.388858,-0.918676,2
0,0,0,0,0,3950,713,4663,5424,10087,0.0353088,0.378275,-0.92502,2
0,0,0,0,0,5691,1049,6740,11219,17959,0.0159111,0.39923,-0.916713,2
0,0,0,0,0,3860,699,4559,8054,12613,-0.0480632,0.406172,-0.912532,2
0,0,0,0,0,3511,645,4156,5129,9285,0.0982388,0.526746,-0.844327,2
0,0,0,0,0,5497,1070,6567,13277,19844,0.109009,0.438823,-0.891937,2
0,0,0,0,0,5569,1004,6573,12512,19085,0.121725,0.567188,-0.814543,2
0,0,0,0,0,2771,490,3261,4611,7872,0.16282,0.389941,-0.906331,2
0,0,0,0,0,5076,976,6052,11932,17984,0.0743455,0.500368,-0.862615,2
0,0,0,0,0,5368,967,6335,7281,13616,0.163781,0.372938,-0.913287,2
0,0,0,0,0,2812,515,3327,5140,8467,0.145482,0.663449,-0.733942,2
0,0,0,0,0,5451,939,6390,13519,19909,0.221114,0.480038,-0.848924,2
0,0,0,0,0,3675,654,4329,6874,11203,0.178226,0.432351,-0.883916,2
0,0,0,0,0,2877,530,3407,5607,9014,0.30298,0.530857,-0.791451,2
0,0,0,0,0,5807,1033,6840,12467,19307,0.266186,0.481405,-0.835101,2
0,0,0,0,0,2951,518,3469,6148,9617,0.108041,0.447923,-0.88752,2
0,0,0,0,0,5962,1053,7015,14977,21992,0.140195,0.567101,-0.811629,2
0,0,0,0,0,2933,531,3464,6494,9958,0.210811,0.546144,-0.810732,2
0,0,0,0,0,4643,839,5482,9901,15383,0.188491,0.519803,-0.833232,2
0,0,0,0,0,4294,786,5080,6658,11738,0.184766,0.608276,-0.771921,2
0,0,0,0,0,5909,1030,6939,9228,16167,0.241559,0.560046,-0.792463,2
0,0,0,0,0,3869,748,4617,7599,12216,0.169168,0.553296,-0.815626,2
0,0,0,0,0,5977,993,6970,6426,13396,0.209846,0.632588,-0.745518,2
0,0,0,0,0,6637,1140,7777,8456,16233,0.151461,0.59306,-0.790784,2
0,0,0,0,0,3136,519,3655,3019,6674,0.0730731,0.582032,-0.809876,2
0,0,0,0,0,6291,1046,7337,4561,11898,-0.079109,0.565792,-0.820744,2
0,0,0,0,0,6433,918,7351,2663,10014,-0.0815028,0.610894,-0.787506,2
0,0,0,0,0,5878,920,6798,4458,11256,-0.108406,0.663653,-0.740144,2
0,0,0,0,0,5165,857,6022,5970,11992,0.137368,0.606175,-0.783379,2
0,0,0,0,0,5815,959,6774,6996,13770,0.236369,0.541102,-0.807055,2
0,0,0,0,0,5434,919,6353,11069,17422,0.326749,0.454601,-0.828597,2
0,0,0,0,0,6265,1046,7311,17593,24904,0.29902,0.539196,-0.787309,2
0,0,0,0,0,3456,456,3912,5315,9227,0.282805,0.557408,-0.780588,2
0,0,0,0,0,1867,305,2172,3813,5985,0.488505,0.427099,-0.760887,2
0,0,0,0,0,1858,318,2176,-1000,-1000,-1,-1,-1,2
0,0,0,0,0,6296,1098,7394,14469,21863,0.116155,0.618266,-0.777338,2
0,0,0,0,0,2694,450,3144,7704,10848,0.197141,0.500291,-0.843116,2
0,0,0,0,0,3777,646,4423,9302,13725,-0.00836206,0.634232,-0.773097,2
0,0,0,0,0,4787,836,5623,-1000,-1000,-1,-1,-1,2
0,0,0,0,0,2215,369,2584,6705,9289,-0.104931,0.675852,-0.72953,2
0,0,0,0,0,7641,1247,8888,17551,26439,0.137345,0.44355,-0.885663,2
0,0,0,0,0,3161,543,3704,7649,11353,0.124863,-0.49834,-0.857943,2
0,0,0,0,0,1924,320,2244,4086,6330,-0.0671631,0.116385,-0.990931,2
0,0,0,0,0,1846,316,2162,3553,5715,0.0441352,0.479499,-0.876432,2
0,0,0,0,0,4011,683,4694,14795,19489,0.0131154,0.303413,-0.952769,2
0,0,0,0,0,4926,891,5817,12049,17866,-0.110134,0.660123,-0.74304,2
0,0,0,0,0,2929,532,3461,6806,10267,-0.064196,0.447626,-0.891914,2
0,0,0,0,0,6007,1029,7036,11086,18122,-0.110903,0.543067,-0.832333,2
0,0,0,0,0,3358,614,3972,4469,8441,-0.0597408,0.519507,-0.852375,2
0,0,0,0,0,6391,1139,7530,11477,19007,-0.0787152,0.589301,-0.80407,2
0,0,0,0,0,4123,686,4809,4560,9369,-0.116806,0.537527,-0.835118,2
0,0,0,0,0,6420,1097,7517,8508,16025,-0.122439,0.583315,-0.802964,2
0,0,0,0,0,5536,1000,6536,10169,16705,-0.0578874,0.418436,-0.9064,2
0,0,0,0,0,2521,456,2977,2327,5304,-0.037376,0.476038,-0.87863,2
0,0,0,0,0,5530,962,6492,11668,18160,-0.0352883,0.502808,-0.863677,2
0,0,0,0,0,3963,687,4650,8924,13574,0.0401104,0.310304,-0.949791,2
0,0,0,0,0,3233,629,3862,1709,5571,-0.0467005,0.40053,-0.915093,2
0,0,0,0,0,6269,1128,7397,3708,11105,-0.0633089,0.362907,-0.929672,2
0,0,0,0,0,6205,1077,7282,2624,9906,-0.049984,0.353015,-0.934282,2
0,0,0,0,0,5853,1123,6976,2644,9620,-0.0306406,0.365607,-0.930265,2
0,0,0,0,0,6155,1106,7261,2329,9590,-0.00298501,0.280829,-0.959753,2
0,0,0,0,0,5752,981,6733,2088,8821,-0.0122594,0.289956,-0.956961,2
0,0,0,0,0,6943,1086,8029,2237,10266,-0.0595324,0.329832,-0.942161,2
0,0,0,0,0,5992,1089,7081,2088,9169,-0.0396586,0.30225,-0.952403,2
0,0,0,0,0,6786,1228,8014,2794,10808,-0.0792145,0.286622,-0.954763,2
0,0,0,0,0,7107,1244,8351,2991,11342,-0.0710915,0.303378,-0.950215,2
0,0,0,0,0,6787,1239,8026,2404,10430,-0.0752925,0.333019,-0.939909,2
0,0,0,0,0,6603,1135,7738,3500,11238,-0.0690978,0.337685,-0.93872,2
0,0,0,0,0,6636,1196,7832,4064,11896,-0.0765584,0.335207,-0.939029,2
0,0,0,0,0,4435,810,5245,3152,8397,-0.045126,0.286127,-0.957129,2
0,0,0,0,0,6263,1152,7415,5665,13080,-0.0673002,0.362466,-0.929564,2
0,0,0,0,0,5453,984,6437,7233,13670,-0.0639551,0.406518,-0.911402,2
0,0,0,0,0,5868,1152,7020,9607,16627,-0.0979262,0.44063,-0.892332,2
0,0,0,0,0,3633,543,4176,5841,10017,-0.102428,0.449393,-0.887443,2
0,0,0,0,0,1777,328,2105,5457,7562,0.0471502,-0.315245,-0.947838,2
0,0,0,0,0,2523,741,3264,8300,11564,0.0634646,0.235855,-0.969714,2
0,0,0,0,0,5585,1003,6588,15406,21994,0.0186122,0.417191,-0.908628,2
0,0,0,0,0,2269,407,2676,8985,11661,0.145708,0.408186,-0.901195,2
0,0,0,0,0,6116,1020,7136,10978,18114,0.268509,0.477616,-0.836532,2
0,0,0,0,0,2702,481,3183,6899,10082,0.172426,0.429216,-0.886591,2
0,0,0,0,0,4899,912,5811,17047,22858,0.289142,0.625881,-0.724341,2
0,0,0,0,0,2725,486,3211,11465,14676,0.123889,0.231782,-0.964846,2
0,0,0,0,0,2590,466,3056,8423,11479,0.18766,0.438126,-0.879107,2
0,0,0,0,0,5701,915,6616,12739,19355,0.060753,0.432204,-0.899727,2
0,0,0,0,0,2809,517,3326,8968,12294,0.143703,0.50338,-0.852032,2
0,0,0,0,0,4263,762,5025,11640,16665,0.140905,0.631393,-0.762554,2
0,0,0,0,0,4020,721,4741,7106,11847,0.128301,0.481338,-0.867094,2
0,0,0,0,0,5353,938,6291,12568,18859,0.044708,0.381759,-0.92318,2
0,0,0,0,0,4449,664,5113,5215,10328,-0.0270348,0.42916,-0.902824,2
0,0,0,0,0,6547,1117,7664,6443,14107,-0.0222764,0.574517,-0.818189,2
0,0,0,0,0,4547,751,5298,4372,9670,-0.0720006,0.536078,-0.841092,2
0,0,0,0,0,6069,902,6971,3847,10818,-0.166063,0.521541,-0.83691,2
0,0,0,0,0,5567,881,6448,2349,8797,-0.184947,0.591895,-0.784509,2
0,0,0,0,0,6645,942,7587,2722,10309,-0.201478,0.653579,-0.729549,2
0,0,0,0,0,5772,855,6627,-1000,-1000,-1,-1,-1,2
0,0,0,0,0,6544,976,7520,-1000,-1000,-1,-1,-1,2
0,0,0,0,0,6479,877,7356,-1000,-1000,-1,-1,-1,2
0,0,0,0,0,5902,901,6803,-1000,-1000,-1,-1,-1,2
0,0,0,0,0,2378,426,2804,8609,11413,-0.143879,0.623971,-0.768088,2
0,0,0,0,0,2902,481,3383,6637,10020,-0.179341,0.659248,-0.730225,2
0,0,0,0,0,5349,868,6217,9067,15284,-0.157172,0.650674,-0.742914,2
0,0,0,0,0,5100,903,6003,9331,15334,-0.00817945,0.564514,-0.825383,2
0,0,0,0,0,4659,820,5479,8747,14226,0.0581528,0.424489,-0.903564,2
0,0,0,0,0,6367,1076,7443,9408,16851,0.0460774,0.445931,-0.893881,2
0,0,0,0,0,3436,579,4015,7342,11357,-0.0157864,0.436619,-0.899508,2
0,0,0,0,0,3264,578,3842,6745,10587,0.0618733,0.270876,-0.960624,2
0,0,0,0,0,4982,797,5779,7148,12927,-0.0200816,0.504747,-0.863034,2
0,0,0,0,0,6903,1166,8069,11232,19301,-0.182793,0.447369,-0.87547,2
0,0,0,0,0,3520,599,4119,4610,8729,-0.110115,0.443026,-0.889721,2
0,0,0,0,0,5475,1265,6740,8456,15196,0.00802622,0.227038,-0.973853,2
0,0,0,0,0,3923,664,4587,5255,9842,-0.114202,0.391577,-0.913031,2
0,0,0,0,0,6574,1130,7704,6869,14573,-0.002961,0.396617,-0.917979,2
0,0,0,0,0,6566,1105,7671,8745,16416,-0.0845367,0.458674,-0.884575,2
0,0,0,0,0,2809,490,3299,6185,9484,-0.102367,0.427298,-0.898297,2
0,0,0,0,0,4830,825,5655,12143,17798,-0.200521,0.460779,-0.864566,2
0,0,0,0,0,3550,634,4184,8238,12422,-0.0913718,0.466381,-0.879852,2
0,0,0,0,0,5640,941,6581,10875,17456,-0.104228,0.574287,-0.811992,2
0,0,0,0,0,4964,819,5783,14234,20017,0.162034,-0.328067,-0.930654,2
0,0,0,0,0,2920,467,3387,1750,5137,0.152098,-0.260782,-0.953341,2
0,0,0,0,0,6159,1023,7182,3187,10369,0.156352,-0.152885,-0.975797,2
0,0,0,0,0,6428,1055,7483,4040,11523,0.133259,-0.0472335,-0.989955,2
0,0,0,0,0,6909,1168,8077,3294,11371,-0.0178688,0.281748,-0.959322,2
0,0,0,0,0,4503,841,5344,1834,7178,-0.00410031,0.288719,-0.957405,2
0,0,0,0,0,6471,1223,7694,3390,11084,-0.0444261,0.307676,-0.950453,2
0,0,0,0,0,6996,1487,8483,2225,10708,-0.0357073,0.217242,-0.975464,2
0,0,0,0,0,6661,1211,7872,2200,10072,-0.0298091,0.206541,-0.977984,2
0,0,0,0,0,7278,1266,8544,2056,10600,-0.0386855,0.208076,-0.977347,2
0,0,0,0,0,6771,1230,8001,2456,10457,-0.0405392,0.19418,-0.980128,2
0,0,0,0,0,6581,1296,7877,2408,10285,-0.0548352,0.226736,-0.972411,2
0,0,0,0,0,5793,1087,6880,2898,9778,-0.0410402,0.210452,-0.976742,2
0,0,0,0,0,6740,1185,7925,2698,10623,-0.0267619,0.262321,-0.964609,2
0,0,0,0,0,7007,1197,8204,3863,12067,-0.0379967,0.239552,-0.97014,2
0,0,0,0,0,4193,752,4945,3420,8365,-0.0284515,0.346263,-0.937706,2
0,0,0,0,0,5901,1056,6957,4997,11954,-0.00108893,0.43573,-0.900077,2
0,0,0,0,0,5742,1038,6780,4916,11696,-0.0269407,0.394576,-0.918468,2
0,0,0,0,0,3022,543,3565,2963,6528,-0.0171694,0.309295,-0.950811,2
0,0,0,0,0,1934,371,2305,2331,4636,-0.0364067,0.257271,-0.965653,2
0,0,0,0,0,5457,1030,6487,7711,14198,-0.0172558,0.358139,-0.933509,2
0,0,0,0,0,5432,1019,6451,11247,17698,-0.0120348,0.405486,-0.914022,2
0,0,0,0,0,2868,521,3389,4344,7733,-0.0209105,0.261508,-0.964975,2
0,0,0,0,0,5511,1023,6534,12990,19524,-0.0246381,0.250194,-0.967882,2
0,0,0,0,0,2425,423,2848,7562,10410,0.0034102,0.225159,-0.974316,2
0,0,0,0,0,4068,756,4824,12479,17303,-0.0688246,0.174964,-0.982166,2
0,0,0,0,0,4095,765,4860,10026,14886,-0.0847551,0.218219,-0.972212,2
0,0,0,0,0,4063,727,4790,8496,13286,-0.0726993,0.138667,-0.987667,2
0,0,0,0,0,4094,655,4749,6620,11369,-0.0952311,0.156234,-0.983118,2
0,0,0,0,0,4784,883,5667,7320,12987,-0.118762,0.189303,-0.97471,2
0,0,0,0,0,4910,873,5783,6564,12347,-0.226931,0.310423,-0.923114,2
0,0,0,0,0,3583,637,4220,5958,10178,-0.121829,0.227569,-0.966111,2
0,0,0,0,0,5355,972,6327,7139,13466,-0.14485,0.277943,-0.949614,2
0,0,0,0,0,5888,1005,6893,8230,15123,-0.125818,0.196473,-0.972403,2
0,0,0,0,0,2377,424,2801,2969,5770,-0.160988,0.216265,-0.962971,2
0,0,0,0,0,5425,945,6370,5019,11389,-0.141839,0.230177,-0.962756,2
0,0,0,0,0,5849,1346,7195,10693,17888,-0.0819182,0.299376,-0.950612,2
0,0,0,0,0,3693,676,4369,6506,10875,-0.0847982,0.334287,-0.938649,2
0,0,0,0,0,5348,979,6327,10566,16893,0.0337657,0.54279,-0.83919,2
0,0,0,0,0,3767,700,4467,10876,15343,-0.0279175,0.305361,-0.951827,2
0,0,0,0,0,5342,968,6310,8084,14394,0.00883658,0.21152,-0.977334,2
0,0,0,0,0,6495,953,7448,4967,12415,-0.00854069,0.170921,-0.985248,2
0,0,0,0,0,2526,427,2953,3080,6033,0.0146919,0.125635,-0.991968,2
0,0,0,0,0,2093,374,2467,1186,3653,0.0200585,0.147793,-0.988815,2
0,0,0,0,0,5342,965,6307,2913,9220,0.0209382,0.135311,-0.990582,2
0,0,0,0,0,5555,971,6526,3083,9609,0.0200195,0.15054,-0.988401,2
0,0,0,0,0,6437,958,7395,4667,12062,0.0225653,0.147217,-0.988847,2
0,0,0,0,0,5488,965,6453,3018,9471,0.0150482,0.120911,-0.992549,2
0,0,0,0,0,5605,974,6579,2904,9483,0.0118402,0.131641,-0.991227,2
0,0,0,0,0,6327,1000,7327,3287,10614,-0.00708581,0.123688,-0.992296,2
0,0,0,0,0,3600,487,4087,1727,5814,0.0264023,0.148883,-0.988502,2
0,0,0,0,0,1944,337,2281,1608,3889,0.0068308,0.122291,-0.992471,2
0,0,0,0,0,4961,914,5875,2752,8627,-0.0312798,0.0946522,-0.995019,2
0,0,0,0,0,5606,972,6578,3511,10089,-0.0123439,0.120911,-0.992587,2
0,0,0,0,0,5381,916,6297,4658,10955,-0.0317914,0.0881479,-0.9956,2
0,0,0,0,0,5329,1016,6345,2736,9081,-0.0135734,0.114023,-0.993385,2
0,0,0,0,0,5291,916,6207,3619,9826,-0.0196696,0.12117,-0.992437,2
0,0,0,0,0,5699,940,6639,3883,10522,-0.0325429,0.110361,-0.993359,2
0,0,0,0,0,5804,919,6723,3487,10210,-0.0253114,0.131887,-0.990941,2
0,0,0,0,0,5336,923,6259,3802,10061,-0.0151414,0.119558,-0.992712,2
0,0,0,0,0,5507,950,6457,4001,10458,-0.0369072,0.0995143,-0.994351,2
0,0,0,0,0,3767,639,4406,2561,6967,-0.0256647,0.108551,-0.99376,2
0,0,0,0,0,5496,995,6491,3202,9693,-0.0179182,0.115594,-0.993135,2
0,0,0,0,0,6357,959,7316,3382,10698,-0.0259531,0.115303,-0.992991,2
0,0,0,0,0,3778,630,4408,2434,6842,-0.0153706,0.116972,-0.993016,2
0,0,0,0,0,5435,947,6382,2913,9295,-0.00282891,0.136965,-0.990572,2
0,0,0,0,0,5406,921,6327,4459,10786,0.0282367,0.105217,-0.994048,2
0,0,0,0,0,5413,1022,6435,2653,9088,0.0158047,0.112531,-0.993523,2
0,0,0,0,0,5444,927,6371,2758,9129,0.0134706,0.120145,-0.992665,2
0,0,0,0,0,5460,981,6441,2513,8954,0.00921842,0.138095,-0.990376,2
0,0,0,0,0,5439,942,6381,3158,9539,-0.0278515,0.103067,-0.994284,2
0,0,0,0,0,5586,933,6519,2501,9020,-0.0184239,0.116343,-0.993038,2
0,0,0,0,0,5786,932,6718,2507,9225,-0.0231468,0.10433,-0.994273,2
0,0,0,0,0,3740,860,4600,1492,6092,-0.0417231,0.126862,-0.991042,2
0,0,0,0,0,5431,997,6428,4507,10935,-0.00853204,0.125183,-0.992097,2
0,0,0,0,0,5596,957,6553,3912,10465,0.00795796,0.135059,-0.990806,2
0,0,0,0,0,5423,930,6353,3668,10021,0.00651012,0.144428,-0.989494,2
0,0,0,0,0,5687,962,6649,3597,10246,-0.00956675,0.14593,-0.989249,2
0,0,0,0,0,5432,946,6378,3893,10271,-0.0178105,0.0990433,-0.994924,2
0,0,0,0,0,5549,919,6468,2540,9008,-0.00402844,0.107523,-0.994194,2
0,0,0,0,0,5655,923,6578,2763,9341,0.012911,0.112368,-0.993583,2
0,0,0,0,0,5403,932,6335,1911,8246,0.0119907,0.112021,-0.993633,2
0,0,0,0,0,4229,645,4874,1997,6871,0.0277744,0.133308,-0.990685,2
0,0,0,0,0,5377,947,6324,3100,9424,-0.00661592,0.115298,-0.993309,2
0,0,0,0,0,5347,1015,6362,3068,9430,-0.00692986,0.111946,-0.99369,2
0,0,0,0,0,5514,940,6454,3384,9838,-0.000782153,0.119331,-0.992854,2
0,0,0,0,0,5491,920,6411,3307,9718,-0.00543255,0.117052,-0.993111,2
0,0,0,0,0,4064,657,4721,1935,6656,-0.0104388,0.10907,-0.993979,2
0,0,0,0,0,5114,899,6013,2122,8135,-0.0107484,0.108293,-0.994061,2
0,0,0,0,0,5500,919,6419,2483,8902,-0.0198669,0.116525,-0.992989,2
0,0,0,0,0,5371,1029,6400,3247,9647,-0.0173018,0.109845,-0.993798,2
0,0,0,0,0,5532,935,6467,2858,9325,-0.0199754,0.112865,-0.99341,2
0,0,0,0,0,5748,1168,6916,2534,9450,-0.0177128,0.126636,-0.991791,2
0,0,0,0,0,5389,917,6306,4321,10627,0.00759381,0.140372,-0.99007,2
0,0,0,0,0,5661,978,6639,3005,9644,0.0156409,0.147384,-0.988956,2
0,0,0,0,0,3790,643,4433,2646,7079,0.0125902,0.167102,-0.985859,2
0,0,0,0,0,5667,931,6598,4483,11081,0.0151136,0.12725,-0.991755,2
0,0,0,0,0,5392,969,6361,2785,9146,0.00876837,0.125577,-0.992045,2
0,0,0,0,0,5403,921,6324,2578,8902,0.0116418,0.120962,-0.992589,2
0,0,0,0,0,5398,1032,6430,2737,9167,0.00427666,0.146574,-0.98919,2
0,0,0,0,0,5432,946,6378,3191,9569,0.000350863,0.14014,-0.990132,2
0,0,0,0,0,5734,976,6710,3950,10660,0.00424515,0.141333,-0.989953,2
0,0,0,0,0,6160,1045,7205,3331,10536,0.00815773,0.140664,-0.990024,2
0,0,0,0,0,5484,1021,6505,2705,9210,0.0621899,0.16628,-0.984116,3
0,0,0,0,0,4464,772,5236,2581,7817,0.0354682,0.155977,-0.987124,3
0,0,0,0,0,5536,1221,6757,3377,10134,0.0466032,0.174835,-0.983494,3
0,0,0,0,0,5529,944,6473,3759,10232,0.0589518,0.171968,-0.983337,3
0,0,0,0,0,3796,670,4466,1974,6440,0.0328092,0.148542,-0.988362,3
0,0,0,0,0,6001,933,6934,3402,10336,0.000201362,0.107057,-0.994253,3
0,0,0,0,0,5439,1004,6443,2421,8864,0.00992916,0.107858,-0.994117,3
0,0,0,0,0,6060,1032,7092,2345,9437,-0.025267,0.125102,-0.991822,3
0,0,0,0,0,5512,942,6454,2874,9328,-0.0295793,0.132163,-0.990787,3
0,0,0,0,0,3126,453,3579,1189,4768,-0.0225325,0.143624,-0.989376,3
0,0,0,0,0,5567,888,6455,3033,9488,0.00317424,0.14742,-0.989069,3
0,0,0,0,0,5592,976,6568,3648,10216,-0.020409,0.129856,-0.991323,3
0,0,0,0,0,3853,658,4511,2088,6599,-0.00310748,0.136444,-0.990643,3
0,0,0,0,0,3864,646,4510,2324,6834,0.0149246,0.150806,-0.988451,3
0,0,0,0,0,3814,681,4495,1955,6450,0.0425235,0.158306,-0.986474,3
0,0,0,0,0,5833,973,6806,2551,9357,0.0199399,0.158169,-0.987211,3
0,0,0,0,0,5600,1002,6602,3520,10122,0.0158382,0.151091,-0.988393,3
0,0,0,0,0,5941,977,6918,2992,9910,0.0141491,0.181328,-0.983321,3
0,0,0,0,0,5560,947,6507,4220,10727,0.025881,0.187962,-0.981835,3
0,0,0,0,0,6007,938,6945,2698,9643,0.0211949,0.181748,-0.983117,3
0,0,0,0,0,4067,867,4934,2688,7622,0.00738704,0.122669,-0.99242,3
0,0,0,0,0,5534,991,6525,2145,8670,0.0191233,0.147687,-0.988849,3
0,0,0,0,0,5557,952,6509,2827,9336,0.00196939,0.111665,-0.993744,3
0,0,0,0,0,5553,1000,6553,2097,8650,-0.0140124,0.12965,-0.991461,3
0,0,0,0,0,6010,1023,7033,2247,9280,-0.02741,0.133591,-0.990657,3
0,0,0,0,0,3850,694,4544,1565,6109,-0.0525405,0.132073,-0.989847,3
0,0,0,0,0,6171,1201,7372,2447,9819,-0.00462486,0.110272,-0.993891,3
0,0,0,0,0,5991,1017,7008,2040,9048,-0.00603397,0.115441,-0.993296,3
0,0,0,0,0,5200,866,6066,2007,8073,-0.00551994,0.102603,-0.994707,3
0,0,0,0,0,7227,1128,8355,2056,10411,-0.00123035,0.0985644,-0.99513,3
0,0,0,0,0,5790,954,6744,1975,8719,-0.00681231,0.102788,-0.99468,3
0,0,0,0,0,6576,946,7522,2043,9565,-0.00242323,0.103785,-0.994597,3
0,0,0,0,0,5783,951,6734,2095,8829,-0.0139452,0.0946354,-0.995414,3
0,0,0,0,0,5909,969,6878,2085,8963,0.0136787,0.0876293,-0.996059,3
0,0,0,0,0,6812,1076,7888,2411,10299,-0.0263401,0.1068,-0.993932,3
0,0,0,0,0,3936,700,4636,1386,6022,-0.019253,0.104695,-0.994318,3
0,0,0,0,0,6809,937,7746,2047,9793,-0.0233091,0.110176,-0.993639,3
0,0,0,0,0,6070,963,7033,2884,9917,-0.0177624,0.119643,-0.992658,3
0,0,0,0,0,5646,1197,6843,2013,8856,-0.017712,0.126181,-0.991849,3
0,0,0,0,0,3855,635,4490,1422,5912,-0.00570306,0.116483,-0.993176,3
0,0,0,0,0,5677,929,6606,2210,8816,0.018858,0.138961,-0.990118,3
0,0,0,0,0,6193,1034,7227,2290,9517,0.0139107,0.139287,-0.990154,3
0,0,0,0,0,5836,934,6770,2199,8969,0.0107941,0.142057,-0.9898,3
0,0,0,0,0,5767,1000,6767,2396,9163,0.00412543,0.150282,-0.988635,3
0,0,0,0,0,3929,641,4570,1518,6088,0.0138705,0.160508,-0.986937,3
0,0,0,0,0,5968,978,6946,2618,9564,0.0138142,0.169772,-0.985387,3
0,0,0,0,0,6246,951,7197,2623,9820,0.0412496,0.149694,-0.987872,3
0,0,0,0,0,5880,1000,6880,2500,9380,0.0219928,0.16683,-0.98574,3
0,0,0,0,0,6191,936,7127,1932,9059,0.0352981,0.170556,-0.984716,3
0,0,0,0,0,3949,649,4598,1609,6207,0.0293787,0.161425,-0.986448,3
0,0,0,0,0,5736,948,6684,2306,8990,0.025812,0.158093,-0.987087,3
0,0,0,0,0,5940,934,6874,2472,9346,0.0247518,0.163768,-0.986188,3
0,0,0,0,0,4349,648,4997,1635,6632,0.0358544,0.174844,-0.983943,3
0,0,0,0,0,5774,1004,6778,2429,9207,0.0499852,0.17106,-0.983992,3
0,0,0,0,0,6222,1000,7222,2484,9706,0.0430462,0.154783,-0.98701,3
0,0,0,0,0,5837,957,6794,2233,9027,0.0376736,0.156706,-0.986926,3
0,0,0,0,0,5754,954,6708,2307,9015,0.0044708,0.141131,-0.989981,3
0,0,0,0,0,5934,986,6920,2031,8951,0.00865723,0.169634,-0.985469,3
0,0,0,0,0,5832,938,6770,2573,9343,-0.00124171,0.196297,-0.980544,3
0,0,0,0,0,5748,941,6689,2079,8768,-0.0162965,0.237119,-0.971344,3
0,0,0,0,0,5929,985,6914,2257,9171,-0.0031833,0.264443,-0.964396,3
0,0,0,0,0,5904,997,6901,2369,9270,-0.0285724,0.300862,-0.95324,3
0,0,0,0,0,6225,975,7200,2297,9497,-0.040085,0.352047,-0.935124,3
0,0,0,0,0,6108,983,7091,2179,9270,-0.0286234,0.324271,-0.945531,3
0,0,0,0,0,5997,1023,7020,2337,9357,-0.0260079,0.349905,-0.936424,3
0,0,0,0,0,5987,970,6957,2578,9535,-0.0496758,0.362017,-0.930847,3
0,0,0,0,0,5899,940,6839,3191,10030,-0.0286565,0.387918,-0.921248,3
0,0,0,0,0,5304,898,6202,4617,10819,-0.0157731,0.450615,-0.892579,3
0,0,0,0,0,6123,1073,7196,7301,14497,-0.0412493,0.604243,-0.795732,3
0,0,0,0,0,3810,524,4334,2554,6888,-0.0289297,0.602432,-0.797646,3
0,0,0,0,0,2189,360,2549,2667,5216,0.0860781,0.380476,-0.920776,3
0,0,0,0,0,6461,1198,7659,9613,17272,0.016396,0.48464,-0.87456,3
0,0,0,0,0,4706,806,5512,8269,13781,0.117922,0.416437,-0.901485,3
0,0,0,0,0,6354,1072,7426,7986,15412,0.0630989,0.588564,-0.805985,3
0,0,0,0,0,3714,613,4327,5793,10120,0.0755186,0.3025,-0.950153,3
0,0,0,0,0,8412,1275,9687,5219,14906,0.0347936,0.319062,-0.947095,3
0,0,0,0,0,3916,655,4571,3594,8165,0.0286012,0.305452,-0.951778,3
0,0,0,0,0,6645,1022,7667,6027,13694,-0.0457723,0.428766,-0.902255,3
0,0,0,0,0,5836,1000,6836,5604,12440,0.0226396,0.239686,-0.970586,3
0,0,0,0,0,5157,869,6026,5038,11064,0.0125393,0.143929,-0.989509,3
0,0,0,0,0,7040,1150,8190,6956,15146,-0.0170927,0.282685,-0.95906,3
0,0,0,0,0,4495,776,5271,4139,9410,-0.0524899,0.317796,-0.946705,3
0,0,0,0,0,5856,1061,6917,5359,12276,-0.073968,0.268503,-0.960435,3
0,0,0,0,0,6492,1136,7628,6546,14174,-0.10157,0.322606,-0.941068,3
0,0,0,0,0,3775,566,4341,2917,7258,-0.126207,0.50925,-0.851315,3
0,0,0,0,0,2219,356,2575,2944,5519,0.0120058,0.0447278,-0.998927,3
0,0,0,0,0,5703,1002,6705,3526,10231,-0.0759788,0.363491,-0.928494,3
0,0,0,0,0,6137,1007,7144,11776,18920,-0.0694899,0.420056,-0.904834,3
0,0,0,0,0,4062,720,4782,11626,16408,0.0955122,0.127246,-0.987262,3
0,0,0,0,0,2773,554,3327,2216,5543,-0.0683666,0.248561,-0.9662,3
0,0,0,0,0,5967,1042,7009,10401,17410,-0.0411837,0.228303,-0.972719,3
0,0,0,0,0,5915,974,6889,2032,8921,-0.0205765,0.27602,-0.960932,3
0,0,0,0,0,2890,525,3415,2650,6065,-0.00292336,0.158662,-0.987329,3
0,0,0,0,0,6192,1179,7371,3269,10640,-0.0140605,0.167213,-0.98582,3
0,0,0,0,0,6319,1286,7605,2163,9768,-0.0240054,0.1662,-0.9858,3
0,0,0,0,0,6708,1221,7929,2763,10692,-0.0451118,0.172638,-0.983952,3
0,0,0,0,0,6582,1214,7796,2741,10537,-0.0395972,0.123478,-0.991557,3
0,0,0,0,0,7458,1245,8703,1721,10424,-0.0386643,0.168843,-0.984884,3
0,0,0,0,0,4472,824,5296,1472,6768,-0.0408193,0.104982,-0.993636,3
0,0,0,0,0,6583,1228,7811,2184,9995,-0.0348171,0.157201,-0.986953,3
0,0,0,0,0,6514,1207,7721,2276,9997,-0.0263338,0.111383,-0.993429,3
0,0,0,0,0,6435,1209,7644,2105,9749,-0.0276805,0.120578,-0.992318,3
0,0,0,0,0,6526,1233,7759,2019,9778,-0.0245066,0.119431,-0.99254,3
0,0,0,0,0,6803,1232,8035,2181,10216,-0.012121,0.127646,-0.991746,3
0,0,0,0,0,4467,1070,5537,1712,7249,-0.0156864,0.141459,-0.98982,3
0,0,0,0,0,6656,1196,7852,2334,10186,0.00433697,0.119027,-0.992882,3
0,0,0,0,0,6573,1278,7851,2599,10450,-0.041453,0.114247,-0.992587,3
0,0,0,0,0,6433,1149,7582,2237,9819,-0.033846,0.0782146,-0.996362,3
0,0,0,0,0,4249,792,5041,1887,6928,-0.0159821,0.0874363,-0.996042,3
0,0,0,0,0,6041,1138,7179,2702,9881,-0.0266502,0.130456,-0.991096,3
0,0,0,0,0,5964,1166,7130,3613,10743,-0.0108861,0.127672,-0.991757,3
0,0,0,0,0,5897,1062,6959,3746,10705,0.00339676,0.192809,-0.98123,3
0,0,0,0,0,6030,1063,7093,5413,12506,-0.00521045,0.229787,-0.973227,3
0,0,0,0,0,3896,700,4596,3586,8182,-0.0161627,0.222104,-0.974889,3
0,0,0,0,0,5435,1004,6439,6782,13221,0.00593402,0.318299,-0.947972,3
0,0,0,0,0,5480,1063,6543,7049,13592,-0.0645199,0.299524,-0.951905,3
0,0,0,0,0,3713,681,4394,6277,10671,-0.0427579,0.208103,-0.977172,3
0,0,0,0,0,5507,1000,6507,8992,15499,-0.059788,0.422949,-0.904179,3
0,0,0,0,0,4065,694,4759,5826,10585,-0.0391568,0.294477,-0.954856,3
0,0,0,0,0,5348,1022,6370,11827,18197,-0.0361441,0.390356,-0.919954,3
0,0,0,0,0,3716,688,4404,8629,13033,-0.0111923,0.119282,-0.992797,3
0,0,0,0,0,3746,648,4394,5667,10061,0.0561404,0.314289,-0.947666,3
0,0,0,0,0,5703,981,6684,6352,13036,0.125692,0.396701,-0.909302,3
0,0,0,0,0,5965,1002,6967,3478,10445,0.144035,0.516186,-0.844279,3
0,0,0,0,0,3532,640,4172,4207,8379,0.0694011,0.319231,-0.945132,3
0,0,0,0,0,5657,967,6624,3644,10268,0.0492397,0.41574,-0.90815,3
0,0,0,0,0,5718,1357,7075,2570,9645,0.00695707,0.395107,-0.918609,3
0,0,0,0,0,5721,927,6648,2286,8934,-0.0244231,0.325605,-0.94519,3
0,0,0,0,0,5722,973,6695,3005,9700,-0.0125388,0.468742,-0.883246,3
0,0,0,0,0,5865,937,6802,4207,11009,-0.00670053,0.483876,-0.875111,3
0,0,0,0,0,5969,1075,7044,4705,11749,-0.0250738,0.557119,-0.830054,3
0,0,0,0,0,3155,524,3679,4187,7866,-0.0242834,0.608398,-0.79326,3
0,0,0,0,0,6634,1115,7749,7634,15383,-0.0842315,0.565226,-0.820624,3
0,0,0,0,0,5352,796,6148,7759,13907,-0.107096,0.593641,-0.797572,3
0,0,0,0,0,3618,660,4278,5389,9667,-0.0819532,0.314874,-0.945589,3
0,0,0,0,0,7076,1221,8297,9378,17675,-0.0436217,0.0655654,-0.996894,3
0,0,0,0,0,4453,763,5216,4997,10213,-0.0677866,0.278723,-0.957976,3
0,0,0,0,0,6897,1213,8110,5938,14048,-0.00195314,0.0497447,-0.99876,3
0,0,0,0,0,4646,750,5396,5731,11127,0.0332845,0.0887376,-0.995499,3
0,0,0,0,0,6249,1065,7314,7261,14575,-0.119804,0.287773,-0.950176,3
0,0,0,0,0,6028,1043,7071,3854,10925,-0.0374414,0.197544,-0.979579,3
0,0,0,0,0,4183,736,4919,3572,8491,-0.0824717,0.281822,-0.955916,3
0,0,0,0,0,5339,941,6280,2871,9151,-0.117788,0.300416,-0.946507,3
0,0,0,0,0,6113,955,7068,3751,10819,-0.113554,0.392665,-0.912644,3
0,0,0,0,0,5173,877,6050,2842,8892,-0.102103,0.302421,-0.94769,3
0,0,0,0,0,6393,1081,7474,2947,10421,-0.0968993,0.334409,-0.937433,3
0,0,0,0,0,6312,909,7221,10736,17957,-0.0249841,0.22963,-0.972957,3
0,0,0,0,0,6461,1050,7511,2803,10314,-0.0628905,0.3179,-0.946036,3
0,0,0,0,0,3235,530,3765,7454,11219,-0.056467,0.361112,-0.930811,3
0,0,0,0,0,6211,1010,7221,9772,16993,-0.187084,0.296346,-0.936578,3
0,0,0,0,0,4190,757,4947,4132,9079,-0.223399,0.311785,-0.923517,3
0,0,0,0,0,6005,1008,7013,6314,13327,-0.227023,0.483535,-0.845372,3
0,0,0,0,0,5898,1051,6949,5807,12756,-0.216509,0.610052,-0.762207,3
0,0,0,0,0,5527,971,6498,12323,18821,-0.166905,0.610897,-0.773917,3
0,0,0,0,0,3038,570,3608,4316,7924,-0.141675,0.674659,-0.724406,3
0,0,0,0,0,5917,1016,6933,9659,16592,0.0074621,0.177166,-0.984153,3
0,0,0,0,0,4292,785,5077,1612,6689,0.0252439,0.0883532,-0.995769,3
0,0,0,0,0,6475,1143,7618,2412,10030,-0.0164949,0.13669,-0.990477,3
0,0,0,0,0,6529,1226,7755,2614,10369,0.0152348,0.0897211,-0.99585,3
0,0,0,0,0,6364,1147,7511,2551,10062,-0.0531911,0.190703,-0.980206,3
0,0,0,0,0,4312,765,5077,2472,7549,-0.0241569,0.00497959,-0.999696,3
0,0,0,0,0,6054,1083,7137,2998,10135,-0.0306307,0.188646,-0.981567,3
0,0,0,0,0,5968,1078,7046,4443,11489,-0.0172896,0.0969137,-0.995143,3
0,0,0,0,0,5688,1050,6738,5331,12069,-0.0357135,0.175438,-0.983842,3
0,0,0,0,0,3802,720,4522,5112,9634,-0.0363239,0.394053,-0.918369,3
0,0,0,0,0,5436,1034,6470,8176,14646,-0.0793097,0.457406,-0.885714,3
0,0,0,0,0,3803,730,4533,8289,12822,-0.0687267,0.232222,-0.970232,3
0,0,0,0,0,4917,903,5820,13772,19592,-0.131671,0.215097,-0.967676,3
0,0,0,0,0,2714,499,3213,8093,11306,-0.152623,0.219746,-0.963544,3
0,0,0,0,0,5484,1016,6500,12037,18537,-0.17111,0.385178,-0.90684,3
0,0,0,0,0,3842,687,4529,6136,10665,-0.173341,0.321687,-0.930844,3
0,0,0,0,0,3455,630,4085,8581,12666,-0.154416,0.381976,-0.911181,3
0,0,0,0,0,4508,800,5308,8314,13622,-0.0976436,0.560817,-0.822162,3
0,0,0,0,0,4638,776,5414,7472,12886,0.0725094,0.592866,-0.80203,3
0,0,0,0,0,4985,765,5750,2978,8728,0.117963,0.474095,-0.872536,3
0,0,0,0,0,5775,1073,6848,3589,10437,0.121745,0.459949,-0.879559,3
0,0,0,0,0,2940,501,3441,3980,7421,0.137551,0.496146,-0.857274,3
0,0,0,0,0,4685,763,5448,5382,10830,0.0391921,0.639458,-0.767826,3
0,0,0,0,0,6015,984,6999,12975,19974,0.000279551,0.483417,-0.87539,3
0,0,0,0,0,3642,481,4123,5656,9779,-0.0350172,0.495851,-0.867701,3
0,0,0,0,0,1652,276,1928,2733,4661,-0.0801674,0.640894,-0.763432,3
0,0,0,0,0,7973,1278,9251,10515,19766,0.106841,0.2536,-0.961391,3
0,0,0,0,0,3161,542,3703,7606,11309,-0.123657,0.503829,-0.854907,3
0,0,0,0,0,4254,653,4907,5636,10543,-0.0881805,0.313949,-0.945336,3
0,0,0,0,0,4466,761,5227,7368,12595,-0.153884,0.387441,-0.90896,3
0,0,0,0,0,7277,1220,8497,7912,16409,-0.0742632,0.240442,-0.967818,3
0,0,0,0,0,6866,1174,8040,7161,15201,-0.0224283,0.264412,-0.964149,3
0,0,0,0,0,3665,609,4274,3373,7647,-0.0400782,0.144809,-0.988648,3
0,0,0,0,0,6730,1187,7917,6922,14839,0.00600668,0.215415,-0.976504,3
0,0,0,0,0,6640,1131,7771,4282,12053,-0.0329,0.221733,-0.974552,3
0,0,0,0,0,3464,576,4040,2892,6932,0.00181715,0.210923,-0.977501,3
0,0,0,0,0,6502,1086,7588,7530,15118,-0.0132858,0.344111,-0.938835,3
0,0,0,0,0,4733,808,5541,6853,12394,-0.00606278,0.357523,-0.933885,3
0,0,0,0,0,6909,1048,7957,14226,22183,0.0383424,0.137159,-0.989807,3
0,0,0,0,0,6516,1119,7635,4317,11952,-0.0586827,0.258641,-0.964189,3
0,0,0,0,0,6839,986,7825,11055,18880,0.29172,-0.459851,-0.838711,3
0,0,0,0,0,2763,413,3176,2330,5506,0.388415,-0.452955,-0.802474,3
0,0,0,0,0,1889,305,2194,2900,5094,0.380251,-0.438112,-0.814535,3
0,0,0,0,0,6070,1013,7083,8657,15740,0.389688,-0.281303,-0.876933,3
0,0,0,0,0,5476,947,6423,4862,11285,0.407235,-0.170248,-0.897316,3
0,0,0,0,0,3910,716,4626,3131,7757,0.103193,0.0955047,-0.990066,3
0,0,0,0,0,6599,1640,8239,2588,10827,0.0402318,0.150186,-0.987839,3
0,0,0,0,0,6367,1200,7567,2228,9795,0.0360364,0.121863,-0.991893,3
0,0,0,0,0,6580,1225,7805,2119,9924,0.0134268,0.119933,-0.992691,3
0,0,0,0,0,7115,1620,8735,2050,10785,-0.047858,0.193836,-0.979866,3
0,0,0,0,0,3623,640,4263,958,5221,-0.0247285,0.115436,-0.993007,3
0,0,0,0,0,2430,430,2860,774,3634,0.00836778,0.0399089,-0.999168,3
0,0,0,0,0,6948,1223,8171,2195,10366,-0.0174938,0.146312,-0.989084,3
0,0,0,0,0,6026,1081,7107,2278,9385,-0.0132192,0.115487,-0.993221,3
0,0,0,0,0,6620,1209,7829,2659,10488,-0.00963102,0.0626591,-0.997989,3
0,0,0,0,0,6483,1230,7713,3618,11331,-0.0325926,0.348974,-0.936565,3
0,0,0,0,0,3995,615,4610,1676,6286,0.0010696,0.190039,-0.981776,3
0,0,0,0,0,2233,420,2653,1678,4331,-0.00444644,0.0672345,-0.997727,3
0,0,0,0,0,5318,998,6316,6676,12992,-0.0448806,0.287538,-0.956717,3
0,0,0,0,0,5877,1067,6944,7009,13953,-0.0532174,0.296658,-0.9535,3
0,0,0,0,0,5800,1078,6878,7294,14172,-0.0211657,0.341575,-0.939616,3
0,0,0,0,0,2351,418,2769,4875,7644,-0.0564982,0.271829,-0.960686,3
0,0,0,0,0,4058,737,4795,8069,12864,-0.0511391,0.321592,-0.945496,3
0,0,0,0,0,5686,1008,6694,11428,18122,-0.0935126,0.509141,-0.855588,3
0,0,0,0,0,2906,528,3434,5656,9090,-0.0790672,0.488976,-0.868707,3
0,0,0,0,0,2323,420,2743,3301,6044,-0.0503775,0.490502,-0.869983,3
0,0,0,0,0,5475,1005,6480,6904,13384,-0.012319,0.525758,-0.850545,3
0,0,0,0,0,3967,685,4652,2502,7154,-0.0277114,0.396083,-0.917796,3
0,0,0,0,0,2297,419,2716,1499,4215,0.0117837,0.352775,-0.935634,3
0,0,0,0,0,5580,1033,6613,3059,9672,0.00202289,0.295469,-0.95535,3
0,0,0,0,0,5549,1016,6565,2917,9482,-0.0212561,0.247954,-0.968539,3
0,0,0,0,0,5516,961,6477,2379,8856,-0.0309311,0.209987,-0.977215,3
0,0,0,0,0,5689,1001,6690,2204,8894,-0.0230535,0.185186,-0.982433,3
0,0,0,0,0,5829,1062,6891,2086,8977,-0.0237848,0.185194,-0.982414,3
0,0,0,0,0,5710,981,6691,1599,8290,-0.0238021,0.207615,-0.977921,3
0,0,0,0,0,3874,668,4542,1661,6203,-0.025544,0.175355,-0.984174,3
0,0,0,0,0,5617,968,6585,2227,8812,-0.0344438,0.142605,-0.98918,3
0,0,0,0,0,5546,1035,6581,2390,8971,-0.0715558,0.12785,-0.989209,3
0,0,0,0,0,4410,689,5099,1279,6378,-0.0408554,0.101244,-0.994022,3
0,0,0,0,0,2471,430,2901,1019,3920,-0.0482635,0.0904524,-0.994731,3
0,0,0,0,0,3836,688,4524,1792,6316,-0.0393669,0.0737366,-0.9965,3
0,0,0,0,0,5578,1028,6606,2701,9307,-0.0336478,0.0843322,-0.995869,3
0,0,0,0,0,5607,1000,6607,2723,9330,-0.0242413,0.0797325,-0.996521,3
0,0,0,0,0,5707,1021,6728,3006,9734,-0.00658102,0.0852132,-0.996341,3
0,0,0,0,0,5684,1005,6689,2402,9091,-0.0162865,0.06089,-0.998012,3
0,0,0,0,0,5624,1036,6660,2552,9212,-0.00992953,0.0623936,-0.998002,3
0,0,0,0,0,5734,1002,6736,2559,9295,0.000823439,0.0762631,-0.997087,3
0,0,0,0,0,6194,1137,7331,2619,9950,0.0134327,0.075672,-0.997042,3
0,0,0,0,0,5472,973,6445,3467,9912,0.0314255,0.0762238,-0.996595,3
0,0,0,0,0,6403,1023,7426,3383,10809,0.011474,0.0828118,-0.996499,3
0,0,0,0,0,5598,976,6574,3637,10211,0.015945,0.158074,-0.987298,3
0,0,0,0,0,5464,953,6417,2296,8713,0.0196832,0.155072,-0.987707,3
0,0,0,0,0,6347,953,7300,2449,9749,0.0124613,0.154467,-0.987919,3
0,0,0,0,0,5650,964,6614,2098,8712,0.0116583,0.144326,-0.989461,3
0,0,0,0,0,6326,953,7279,2385,9664,0.0202891,0.152456,-0.988102,3
0,0,0,0,0,6237,1062,7299,2474,9773,0.0103108,0.150412,-0.98857,3
0,0,0,0,0,3081,537,3618,913,4531,0.00663838,0.147205,-0.989084,3
0,0,0,0,0,4523,776,5299,1712,7011,0.00691626,0.144017,-0.989551,3
0,0,0,0,0,5589,999,6588,2327,8915,0.0213416,0.149269,-0.988566,3
0,0,0,0,0,5473,994,6467,2620,9087,0.0469316,0.154032,-0.986951,3
0,0,0,0,0,5494,941,6435,2294,8729,0.0363739,0.168968,-0.98495,3
0,0,0,0,0,6106,945,7051,2289,9340,0.03624,0.172654,-0.984316,3
0,0,0,0,0,5820,951,6771,2053,8824,0.0379454,0.17921,-0.983079,3
0,0,0,0,0,5591,952,6543,2051,8594,0.0372055,0.161946,-0.986098,3
0,0,0,0,0,6296,958,7254,2023,9277,0.0468473,0.157058,-0.986478,3
0,0,0,0,0,5602,939,6541,2104,8645,0.0680808,0.147233,-0.986756,3
0,0,0,0,0,5724,1112,6836,2662,9498,0.0470072,0.148226,-0.987836,3
0,0,0,0,0,5627,955,6582,2760,9342,0.0270848,0.198,-0.979828,3
0,0,0,0,0,5493,954,6447,1951,8398,0.0213972,0.170917,-0.985053,3
0,0,0,0,0,5598,954,6552,2138,8690,0.031471,0.168921,-0.985127,3
0,0,0,0,0,5580,947,6527,2090,8617,0.0297016,0.175085,-0.984105,3
0,0,0,0,0,4559,665,5224,1082,6306,0.0300421,0.167864,-0.985352,3
0,0,0,0,0,2814,475,3289,968,4257,0.0299881,0.161409,-0.986432,3
0,0,0,0,0,5621,947,6568,2065,8633,0.0211349,0.151475,-0.988235,3
0,0,0,0,0,6321,951,7272,2220,9492,0.0216605,0.146849,-0.988922,3
0,0,0,0,0,5555,962,6517,2379,8896,0.0326655,0.145431,-0.988829,3
0,0,0,0,0,5510,967,6477,2492,8969,0.0409942,0.156907,-0.986762,3
0,0,0,0,0,6174,936,7110,2685,9795,0.0199952,0.154813,-0.987742,3
0,0,0,0,0,6348,952,7300,2079,9379,0.0216792,0.152925,-0.988,3
0,0,0,0,0,5685,948,6633,2210,8843,0.0381897,0.154167,-0.987306,3
0,0,0,0,0,5684,944,6628,2240,8868,0.0419655,0.158073,-0.986535,3
0,0,0,0,0,5998,1161,7159,2093,9252,0.0286341,0.157779,-0.987059,3
0,0,0,0,0,5606,947,6553,2069,8622,0.0153933,0.158588,-0.987225,3
0,0,0,0,0,5704,1006,6710,1990,8700,0.0139218,0.151921,-0.988295,3
0,0,0,0,0,6024,948,6972,2362,9334,0.00124619,0.141728,-0.989905,3
0,0,0,0,0,5968,1052,7020,1689,8709,-0.00215997,0.139808,-0.990176,3
0,0,0,0,0,5459,865,6324,2523,8847,0.00674265,0.130873,-0.991376,3
0,0,0,0,0,5216,885,6101,2409,8510,0.00751813,0.124496,-0.992192,3
0,0,0,0,0,5729,958,6687,3496,10183,-0.00551597,0.103122,-0.994653,3
0,0,0,0,0,6026,1001,7027,2918,9945,-0.00440232,0.0872985,-0.996172,3
0,0,0,0,0,5021,976,5997,2962,8959,-0.0182737,0.0797335,-0.996649,3
0,0,0,0,0,5614,1040,6654,2524,9178,-0.0289071,0.0779601,-0.996537,3
0,0,0,0,0,5587,992,6579,2680,9259,-0.0167736,0.0820298,-0.996489,3
0,0,0,0,0,5710,1001,6711,2375,9086,-0.0101644,0.0865068,-0.996199,3
0,0,0,0,0,5694,1006,6700,3096,9796,-0.0114647,0.0819613,-0.99657,3
0,0,0,0,0,5937,1006,6943,2650,9593,-0.00805757,0.117253,-0.993069,3
0,0,0,0,0,6010,991,7001,3019,10020,0.00301196,0.120847,-0.992667,3
0,0,0,0,0,5687,1034,6721,3372,10093,0.00611524,0.0798883,-0.996785,3
0,0,0,0,0,6132,1116,7248,3689,10937,0.00449586,0.0674691,-0.997711,3
0,0,0,0,0,3823,733,4556,1790,6346,0.0015739,0.0672066,-0.997738,3
0,0,0,0,0,5884,1083,6967,2642,9609,-0.00205274,0.0637314,-0.997965,3
0,0,0,0,0,5735,1017,6752,2465,9217,-0.0166306,0.062516,-0.997905,3
0,0,0,0,0,5804,1010,6814,2807,9621,-0.0117698,0.0585656,-0.998214,3
0,0,0,0,0,5630,1012,6642,3106,9748,-0.0195414,0.0726116,-0.997169,3
0,0,0,0,0,5852,1015,6867,2727,9594,-0.0410281,0.0735645,-0.996446,3
0,0,0,0,0,6336,1030,7366,2395,9761,-0.0069196,0.096856,-0.995274,3
0,0,0,0,0,3918,676,4594,2164,6758,-0.0162652,0.085157,-0.996235,3
0,0,0,0,0,5904,1013,6917,2638,9555,-0.0243075,0.0923208,-0.995433,3
0,0,0,0,0,5714,1222,6936,2280,9216,-0.0436416,0.0877075,-0.99519,3
0,0,0,0,0,5967,1037,7004,2810,9814,-0.0169956,0.0727686,-0.997204,3
0,0,0,0,0,4254,734,4988,1779,6767,-0.0138062,0.0761472,-0.997001,3
0,0,0,0,0,5769,987,6756,2616,9372,-0.0416291,0.0770688,-0.996156,3
0,0,0,0,0,5894,1012,6906,2539,9445,-0.0458443,0.0707521,-0.99644,3
0,0,0,0,0,5651,1004,6655,2415,9070,-0.0289613,0.0794427,-0.996419,3
0,0,0,0,0,5686,999,6685,2560,9245,-0.0226465,0.0797602,-0.996557,3
0,0,0,0,0,6013,1094,7107,2676,9783,-0.0212712,0.0859299,-0.996074,3
